txn_date,provinceEn,inflection,inflection_total,density,density_male,density_female,tourist,tourist_thai,tourist_foreign,pm25,pm10,update_date
1/4/2021,Krabi,0,27,478376,237526,240850,100764,99754,1010,,,19/1/2022 7:23
1/4/2021,Bangkok,11,4855,5574497,2617639,2956858,1115611,1063854,51757,79,22,19/1/2022 7:23
1/4/2021,Kanchanaburi,0,16,892843,448201,444642,243519,243308,211,73,22,19/1/2022 7:23
1/4/2021,Kalasin,0,4,976734,482933,493801,12687,12687,0,,,19/1/2022 7:23
1/4/2021,Kamphaeng Phet,0,2,713471,352392,361079,39769,39688,81,,,19/1/2022 7:23
1/4/2021,Khon Kaen,0,20,1793256,881683,911573,57354,57291,63,149,58,19/1/2022 7:23
1/4/2021,Chanthaburi,0,224,535634,261945,273689,116001,115931,70,,,19/1/2022 7:23
1/4/2021,Chachoengsao,0,45,721596,353738,367858,29877,29877,0,61,36,19/1/2022 7:23
1/4/2021,Chon Buri,1,1495,1572004,766532,805472,156392,155350,1042,47,30,19/1/2022 7:23
1/4/2021,Chai Nat,0,11,321758,154645,167113,31521,31521,0,,,19/1/2022 7:23
1/4/2021,Chaiyaphum,0,11,1123903,555222,568681,40561,40512,49,,,19/1/2022 7:23
1/4/2021,Chumphon,0,21,509518,251414,258104,61047,60995,52,,,19/1/2022 7:23
1/4/2021,Trang,0,12,640411,313222,327189,40640,40547,93,,,19/1/2022 7:23
1/4/2021,Trat,0,33,228569,113072,115497,137616,137392,224,,,19/1/2022 7:23
1/4/2021,Tak,0,322,672976,340316,332660,59385,59312,73,,,19/1/2022 7:23
1/4/2021,Nakhon Nayok,0,18,259750,128155,131595,76708,76708,0,,,19/1/2022 7:23
1/4/2021,Nakhon Pathom,0,193,922448,443178,479270,98319,98268,51,90,40,19/1/2022 7:23
1/4/2021,Nakhon Phanom,0,3,716791,357234,359557,27584,27557,27,,,19/1/2022 7:23
1/4/2021,Nakhon Ratchasima,0,32,2633610,1294642,1338968,314682,313761,921,92,31,19/1/2022 7:23
1/4/2021,Nakhon Si Thammarat,0,16,1550947,765252,785695,108124,107604,520,,,19/1/2022 7:23
1/4/2021,Nakhon Sawan,0,15,1038712,506804,531908,115116,115001,115,131,49,19/1/2022 7:23
1/4/2021,Nonthaburi,0,460,1281245,596307,684938,33945,33820,125,55,14,19/1/2022 7:23
1/4/2021,Narathiwat,0,68,806698,398996,407702,12366,12366,0,43,18,19/1/2022 7:23
1/4/2021,Nan,0,1,476372,238449,237923,60575,60465,110,,,19/1/2022 7:23
1/4/2021,Bueng Kan,0,0,422066,211554,210512,5420,5420,0,,,19/1/2022 7:23
1/4/2021,Buri Ram,0,15,1580079,784198,795881,38966,38860,106,,,19/1/2022 7:23
1/4/2021,Pathum Thani,0,815,1180730,559573,621157,17584,17443,141,70,21,19/1/2022 7:23
1/4/2021,Prachuap Khiri Khan,0,25,551205,272975,278230,275365,275243,122,,,19/1/2022 7:23
1/4/2021,Prachin Buri,0,21,494574,244431,250143,62857,62857,0,77,32,19/1/2022 7:23
1/4/2021,Pattani,0,97,727686,359470,368216,11318,11318,0,,,19/1/2022 7:23
1/4/2021,Phra Nakhon Si Ayutthaya,0,68,819654,393768,425886,230549,229807,742,80,51,19/1/2022 7:23
1/4/2021,Phayao,0,4,466174,226975,239199,34541,34442,99,175,103,19/1/2022 7:23
1/4/2021,Phang-nga,0,2,268508,133879,134629,132253,130614,1639,,,19/1/2022 7:23
1/4/2021,Phatthalung,0,17,523116,254885,268231,50714,50714,0,,,19/1/2022 7:23
1/4/2021,Phichit,0,10,531541,259263,272278,52325,52325,0,,,19/1/2022 7:23
1/4/2021,Phitsanulok,0,7,848043,415270,432773,150029,149890,139,,,19/1/2022 7:23
1/4/2021,Phuket,0,231,413242,195176,218066,185057,183877,1180,49,28,19/1/2022 7:23
1/4/2021,Maha Sarakham,0,22,951507,466454,485053,12276,12276,0,,,19/1/2022 7:23
1/4/2021,Mukdahan,0,6,350834,175233,175601,29874,29874,0,,,19/1/2022 7:23
1/4/2021,Yala,0,147,539921,268685,271236,29789,29789,0,58,24,19/1/2022 7:23
1/4/2021,Yasothon,0,2,534065,266640,267425,23761,23761,0,,,19/1/2022 7:23
1/4/2021,Ranong,0,1,194741,98300,96441,52522,52361,161,,,19/1/2022 7:23
1/4/2021,Rayong,0,602,744962,365850,379112,102268,101970,298,45,22,19/1/2022 7:23
1/4/2021,Ratchaburi,0,59,869447,422955,446492,42340,42325,15,,,19/1/2022 7:23
1/4/2021,Roi Et,0,4,1297612,643180,654432,9529,9529,0,,,19/1/2022 7:23
1/4/2021,Lop Buri,0,24,741974,370517,371457,54769,54707,62,,,19/1/2022 7:23
1/4/2021,Lampang,0,7,727166,354266,372900,88127,87577,550,172,97,19/1/2022 7:23
1/4/2021,Lamphun,0,6,401750,193199,208551,70522,70337,185,,,19/1/2022 7:23
1/4/2021,Si Sa Ket,0,9,1457730,725631,732099,15523,15523,0,,,19/1/2022 7:23
1/4/2021,Sakon Nakhon,0,1,1146692,569813,576879,27390,27375,15,,,19/1/2022 7:23
1/4/2021,Songkhla,0,149,1429058,696568,732490,69929,69891,38,58,34,19/1/2022 7:23
1/4/2021,Satun,0,24,324321,161388,162933,73143,72554,589,32,29,19/1/2022 7:23
1/4/2021,Samut Prakarn,3,816,1354390,645522,708868,27501,27263,238,,,19/1/2022 7:23
1/4/2021,Samut Songkhram,0,75,191749,91610,100139,126386,126314,72,47,9,19/1/2022 7:23
1/4/2021,Samut Sakhon,11,17134,586317,282574,303743,6690,6639,51,93,24,19/1/2022 7:23
1/4/2021,Saraburi,0,23,644230,316852,327378,96839,96724,115,79,50,19/1/2022 7:23
1/4/2021,Sa kaeo,0,15,561071,280075,280996,23441,23441,0,35,17,19/1/2022 7:23
1/4/2021,Sing Buri,0,17,205427,97606,107821,17847,17847,0,,,19/1/2022 7:23
1/4/2021,Suphan Buri,0,39,837370,404033,433337,72907,72907,0,,,19/1/2022 7:23
1/4/2021,Surat Thani,0,30,1068273,526182,542091,65669,65132,537,64,32,19/1/2022 7:23
1/4/2021,Surin,0,14,1377326,685192,692134,24004,23993,11,,,19/1/2022 7:23
1/4/2021,Sukhothai,0,5,586830,284310,302520,56642,55966,676,,,19/1/2022 7:23
1/4/2021,Nong Khai,0,5,517147,256546,260601,20943,20864,79,126,48,19/1/2022 7:23
1/4/2021,Nong Bua Lam Phu,0,5,509129,253956,255173,4947,4947,0,,,19/1/2022 7:23
1/4/2021,Amnat Charoen,0,4,376158,187258,188900,7354,7354,0,,,19/1/2022 7:23
1/4/2021,Udon Thani,0,11,1567503,776622,790881,39172,39152,20,,,19/1/2022 7:23
1/4/2021,Uttaradit,0,6,447754,218285,229469,47493,47493,0,,,19/1/2022 7:23
1/4/2021,Uthai Thani,0,1,325542,159106,166436,61633,61633,0,,,19/1/2022 7:23
1/4/2021,Ubon Ratchathani,0,19,1866247,931793,934454,115331,115317,14,102,43,19/1/2022 7:23
1/4/2021,Ang Thong,0,124,275944,132088,143856,35544,35544,0,,,19/1/2022 7:23
1/4/2021,Chiang Rai,0,74,1295958,630131,665827,132092,131542,550,177,119,19/1/2022 7:23
1/4/2021,Chiang Mai,0,67,1785706,863274,922432,396241,392204,4037,169,102,19/1/2022 7:23
1/4/2021,Phetchaburi,0,92,482292,232840,249452,385714,385488,226,,,19/1/2022 7:23
1/4/2021,Phetchabun,0,4,980662,483966,496696,95174,94812,362,,,19/1/2022 7:23
1/4/2021,Loei,0,12,638441,319953,318488,50148,50126,22,112,79,19/1/2022 7:23
1/4/2021,Phrae,0,1,436290,210317,225973,62210,62067,143,173,83,19/1/2022 7:23
1/4/2021,Mae Hong Son,0,5,285552,144717,140835,42084,41573,511,200,98,19/1/2022 7:23
1/4/2021,,0,12,,,,,,,,,19/1/2022 7:23
2/4/2021,Krabi,0,27,478376,237526,240850,100764,99754,1010,,,19/1/2022 7:23
2/4/2021,Bangkok,24,4879,5574497,2617639,2956858,1115611,1063854,51757,47,28,19/1/2022 7:23
2/4/2021,Kanchanaburi,0,16,892843,448201,444642,243519,243308,211,40,19,19/1/2022 7:23
2/4/2021,Kalasin,0,4,976734,482933,493801,12687,12687,0,,,19/1/2022 7:23
2/4/2021,Kamphaeng Phet,0,2,713471,352392,361079,39769,39688,81,,,19/1/2022 7:23
2/4/2021,Khon Kaen,0,20,1793256,881683,911573,57354,57291,63,101,57,19/1/2022 7:23
2/4/2021,Chanthaburi,0,224,535634,261945,273689,116001,115931,70,,,19/1/2022 7:23
2/4/2021,Chachoengsao,0,45,721596,353738,367858,29877,29877,0,50,38,19/1/2022 7:23
2/4/2021,Chon Buri,6,1501,1572004,766532,805472,156392,155350,1042,36,22,19/1/2022 7:23
2/4/2021,Chai Nat,0,11,321758,154645,167113,31521,31521,0,,,19/1/2022 7:23
2/4/2021,Chaiyaphum,0,11,1123903,555222,568681,40561,40512,49,,,19/1/2022 7:23
2/4/2021,Chumphon,0,21,509518,251414,258104,61047,60995,52,,,19/1/2022 7:23
2/4/2021,Trang,0,12,640411,313222,327189,40640,40547,93,,,19/1/2022 7:23
2/4/2021,Trat,0,33,228569,113072,115497,137616,137392,224,,,19/1/2022 7:23
2/4/2021,Tak,2,324,672976,340316,332660,59385,59312,73,,,19/1/2022 7:23
2/4/2021,Nakhon Nayok,0,18,259750,128155,131595,76708,76708,0,,,19/1/2022 7:23
2/4/2021,Nakhon Pathom,0,193,922448,443178,479270,98319,98268,51,95,41,19/1/2022 7:23
2/4/2021,Nakhon Phanom,0,3,716791,357234,359557,27584,27557,27,,,19/1/2022 7:23
2/4/2021,Nakhon Ratchasima,0,32,2633610,1294642,1338968,314682,313761,921,60,43,19/1/2022 7:23
2/4/2021,Nakhon Si Thammarat,0,16,1550947,765252,785695,108124,107604,520,,,19/1/2022 7:23
2/4/2021,Nakhon Sawan,0,15,1038712,506804,531908,115116,115001,115,86,45,19/1/2022 7:23
2/4/2021,Nonthaburi,5,465,1281245,596307,684938,33945,33820,125,28,21,19/1/2022 7:23
2/4/2021,Narathiwat,0,68,806698,398996,407702,12366,12366,0,33,20,19/1/2022 7:23
2/4/2021,Nan,0,1,476372,238449,237923,60575,60465,110,,,19/1/2022 7:23
2/4/2021,Bueng Kan,0,0,422066,211554,210512,5420,5420,0,,,19/1/2022 7:23
2/4/2021,Buri Ram,0,15,1580079,784198,795881,38966,38860,106,,,19/1/2022 7:23
2/4/2021,Pathum Thani,0,815,1180730,559573,621157,17584,17443,141,50,30,19/1/2022 7:23
2/4/2021,Prachuap Khiri Khan,0,25,551205,272975,278230,275365,275243,122,,,19/1/2022 7:23
2/4/2021,Prachin Buri,0,21,494574,244431,250143,62857,62857,0,63,31,19/1/2022 7:23
2/4/2021,Pattani,0,97,727686,359470,368216,11318,11318,0,,,19/1/2022 7:23
2/4/2021,Phra Nakhon Si Ayutthaya,0,68,819654,393768,425886,230549,229807,742,58,49,19/1/2022 7:23
2/4/2021,Phayao,0,4,466174,226975,239199,34541,34442,99,172,75,19/1/2022 7:23
2/4/2021,Phang-nga,0,2,268508,133879,134629,132253,130614,1639,,,19/1/2022 7:23
2/4/2021,Phatthalung,0,17,523116,254885,268231,50714,50714,0,,,19/1/2022 7:23
2/4/2021,Phichit,0,10,531541,259263,272278,52325,52325,0,,,19/1/2022 7:23
2/4/2021,Phitsanulok,0,7,848043,415270,432773,150029,149890,139,,,19/1/2022 7:23
2/4/2021,Phuket,0,231,413242,195176,218066,185057,183877,1180,57,33,19/1/2022 7:23
2/4/2021,Maha Sarakham,0,22,951507,466454,485053,12276,12276,0,,,19/1/2022 7:23
2/4/2021,Mukdahan,0,6,350834,175233,175601,29874,29874,0,,,19/1/2022 7:23
2/4/2021,Yala,0,147,539921,268685,271236,29789,29789,0,50,25,19/1/2022 7:23
2/4/2021,Yasothon,0,2,534065,266640,267425,23761,23761,0,,,19/1/2022 7:23
2/4/2021,Ranong,0,1,194741,98300,96441,52522,52361,161,,,19/1/2022 7:23
2/4/2021,Rayong,0,602,744962,365850,379112,102268,101970,298,35,25,19/1/2022 7:23
2/4/2021,Ratchaburi,0,59,869447,422955,446492,42340,42325,15,,,19/1/2022 7:23
2/4/2021,Roi Et,0,4,1297612,643180,654432,9529,9529,0,,,19/1/2022 7:23
2/4/2021,Lop Buri,0,24,741974,370517,371457,54769,54707,62,,,19/1/2022 7:23
2/4/2021,Lampang,0,7,727166,354266,372900,88127,87577,550,178,77,19/1/2022 7:23
2/4/2021,Lamphun,0,6,401750,193199,208551,70522,70337,185,,,19/1/2022 7:23
2/4/2021,Si Sa Ket,0,9,1457730,725631,732099,15523,15523,0,,,19/1/2022 7:23
2/4/2021,Sakon Nakhon,0,1,1146692,569813,576879,27390,27375,15,,,19/1/2022 7:23
2/4/2021,Songkhla,0,149,1429058,696568,732490,69929,69891,38,60,40,19/1/2022 7:23
2/4/2021,Satun,0,24,324321,161388,162933,73143,72554,589,34,21,19/1/2022 7:23
2/4/2021,Samut Prakarn,6,822,1354390,645522,708868,27501,27263,238,,,19/1/2022 7:23
2/4/2021,Samut Songkhram,0,75,191749,91610,100139,126386,126314,72,20,11,19/1/2022 7:23
2/4/2021,Samut Sakhon,14,17148,586317,282574,303743,6690,6639,51,56,24,19/1/2022 7:23
2/4/2021,Saraburi,0,23,644230,316852,327378,96839,96724,115,58,57,19/1/2022 7:23
2/4/2021,Sa kaeo,0,15,561071,280075,280996,23441,23441,0,25,25,19/1/2022 7:23
2/4/2021,Sing Buri,0,17,205427,97606,107821,17847,17847,0,,,19/1/2022 7:23
2/4/2021,Suphan Buri,0,39,837370,404033,433337,72907,72907,0,,,19/1/2022 7:23
2/4/2021,Surat Thani,0,30,1068273,526182,542091,65669,65132,537,51,35,19/1/2022 7:23
2/4/2021,Surin,0,14,1377326,685192,692134,24004,23993,11,,,19/1/2022 7:23
2/4/2021,Sukhothai,0,5,586830,284310,302520,56642,55966,676,,,19/1/2022 7:23
2/4/2021,Nong Khai,0,5,517147,256546,260601,20943,20864,79,101,27,19/1/2022 7:23
2/4/2021,Nong Bua Lam Phu,0,5,509129,253956,255173,4947,4947,0,,,19/1/2022 7:23
2/4/2021,Amnat Charoen,0,4,376158,187258,188900,7354,7354,0,,,19/1/2022 7:23
2/4/2021,Udon Thani,0,11,1567503,776622,790881,39172,39152,20,,,19/1/2022 7:23
2/4/2021,Uttaradit,0,6,447754,218285,229469,47493,47493,0,,,19/1/2022 7:23
2/4/2021,Uthai Thani,0,1,325542,159106,166436,61633,61633,0,,,19/1/2022 7:23
2/4/2021,Ubon Ratchathani,0,19,1866247,931793,934454,115331,115317,14,88,55,19/1/2022 7:23
2/4/2021,Ang Thong,0,124,275944,132088,143856,35544,35544,0,,,19/1/2022 7:23
2/4/2021,Chiang Rai,0,74,1295958,630131,665827,132092,131542,550,214,159,19/1/2022 7:23
2/4/2021,Chiang Mai,0,67,1785706,863274,922432,396241,392204,4037,183,98,19/1/2022 7:23
2/4/2021,Phetchaburi,0,92,482292,232840,249452,385714,385488,226,,,19/1/2022 7:23
2/4/2021,Phetchabun,0,4,980662,483966,496696,95174,94812,362,,,19/1/2022 7:23
2/4/2021,Loei,1,13,638441,319953,318488,50148,50126,22,124,59,19/1/2022 7:23
2/4/2021,Phrae,0,1,436290,210317,225973,62210,62067,143,163,59,19/1/2022 7:23
2/4/2021,Mae Hong Son,0,5,285552,144717,140835,42084,41573,511,205,163,19/1/2022 7:23
2/4/2021,,0,12,,,,,,,,,19/1/2022 7:23
3/4/2021,Krabi,0,27,478376,237526,240850,100764,99754,1010,,,19/1/2022 7:23
3/4/2021,Bangkok,41,4920,5574497,2617639,2956858,1115611,1063854,51757,55,30,19/1/2022 7:23
3/4/2021,Kanchanaburi,0,16,892843,448201,444642,243519,243308,211,26,19,19/1/2022 7:23
3/4/2021,Kalasin,0,4,976734,482933,493801,12687,12687,0,,,19/1/2022 7:23
3/4/2021,Kamphaeng Phet,0,2,713471,352392,361079,39769,39688,81,,,19/1/2022 7:23
3/4/2021,Khon Kaen,0,20,1793256,881683,911573,57354,57291,63,107,46,19/1/2022 7:23
3/4/2021,Chanthaburi,0,224,535634,261945,273689,116001,115931,70,,,19/1/2022 7:23
3/4/2021,Chachoengsao,0,45,721596,353738,367858,29877,29877,0,49,37,19/1/2022 7:23
3/4/2021,Chon Buri,1,1502,1572004,766532,805472,156392,155350,1042,36,24,19/1/2022 7:23
3/4/2021,Chai Nat,0,11,321758,154645,167113,31521,31521,0,,,19/1/2022 7:23
3/4/2021,Chaiyaphum,0,11,1123903,555222,568681,40561,40512,49,,,19/1/2022 7:23
3/4/2021,Chumphon,0,21,509518,251414,258104,61047,60995,52,,,19/1/2022 7:23
3/4/2021,Trang,0,12,640411,313222,327189,40640,40547,93,,,19/1/2022 7:23
3/4/2021,Trat,0,33,228569,113072,115497,137616,137392,224,,,19/1/2022 7:23
3/4/2021,Tak,1,325,672976,340316,332660,59385,59312,73,,,19/1/2022 7:23
3/4/2021,Nakhon Nayok,0,18,259750,128155,131595,76708,76708,0,,,19/1/2022 7:23
3/4/2021,Nakhon Pathom,5,198,922448,443178,479270,98319,98268,51,83,34,19/1/2022 7:23
3/4/2021,Nakhon Phanom,0,3,716791,357234,359557,27584,27557,27,,,19/1/2022 7:23
3/4/2021,Nakhon Ratchasima,0,32,2633610,1294642,1338968,314682,313761,921,85,34,19/1/2022 7:23
3/4/2021,Nakhon Si Thammarat,0,16,1550947,765252,785695,108124,107604,520,,,19/1/2022 7:23
3/4/2021,Nakhon Sawan,0,15,1038712,506804,531908,115116,115001,115,102,156,19/1/2022 7:23
3/4/2021,Nonthaburi,4,469,1281245,596307,684938,33945,33820,125,41,30,19/1/2022 7:23
3/4/2021,Narathiwat,1,69,806698,398996,407702,12366,12366,0,39,24,19/1/2022 7:23
3/4/2021,Nan,0,1,476372,238449,237923,60575,60465,110,,,19/1/2022 7:23
3/4/2021,Bueng Kan,0,0,422066,211554,210512,5420,5420,0,,,19/1/2022 7:23
3/4/2021,Buri Ram,0,15,1580079,784198,795881,38966,38860,106,,,19/1/2022 7:23
3/4/2021,Pathum Thani,3,818,1180730,559573,621157,17584,17443,141,66,27,19/1/2022 7:23
3/4/2021,Prachuap Khiri Khan,0,25,551205,272975,278230,275365,275243,122,,,19/1/2022 7:23
3/4/2021,Prachin Buri,0,21,494574,244431,250143,62857,62857,0,67,33,19/1/2022 7:23
3/4/2021,Pattani,0,97,727686,359470,368216,11318,11318,0,,,19/1/2022 7:23
3/4/2021,Phra Nakhon Si Ayutthaya,0,68,819654,393768,425886,230549,229807,742,59,44,19/1/2022 7:23
3/4/2021,Phayao,0,4,466174,226975,239199,34541,34442,99,156,56,19/1/2022 7:23
3/4/2021,Phang-nga,0,2,268508,133879,134629,132253,130614,1639,,,19/1/2022 7:23
3/4/2021,Phatthalung,0,17,523116,254885,268231,50714,50714,0,,,19/1/2022 7:23
3/4/2021,Phichit,0,10,531541,259263,272278,52325,52325,0,,,19/1/2022 7:23
3/4/2021,Phitsanulok,0,7,848043,415270,432773,150029,149890,139,,,19/1/2022 7:23
3/4/2021,Phuket,0,231,413242,195176,218066,185057,183877,1180,66,36,19/1/2022 7:23
3/4/2021,Maha Sarakham,0,22,951507,466454,485053,12276,12276,0,,,19/1/2022 7:23
3/4/2021,Mukdahan,0,6,350834,175233,175601,29874,29874,0,,,19/1/2022 7:23
3/4/2021,Yala,2,149,539921,268685,271236,29789,29789,0,56,25,19/1/2022 7:23
3/4/2021,Yasothon,0,2,534065,266640,267425,23761,23761,0,,,19/1/2022 7:23
3/4/2021,Ranong,0,1,194741,98300,96441,52522,52361,161,,,19/1/2022 7:23
3/4/2021,Rayong,0,602,744962,365850,379112,102268,101970,298,32,21,19/1/2022 7:23
3/4/2021,Ratchaburi,0,59,869447,422955,446492,42340,42325,15,,,19/1/2022 7:23
3/4/2021,Roi Et,0,4,1297612,643180,654432,9529,9529,0,,,19/1/2022 7:23
3/4/2021,Lop Buri,0,24,741974,370517,371457,54769,54707,62,,,19/1/2022 7:23
3/4/2021,Lampang,0,7,727166,354266,372900,88127,87577,550,149,63,19/1/2022 7:23
3/4/2021,Lamphun,0,6,401750,193199,208551,70522,70337,185,,,19/1/2022 7:23
3/4/2021,Si Sa Ket,0,9,1457730,725631,732099,15523,15523,0,,,19/1/2022 7:23
3/4/2021,Sakon Nakhon,0,1,1146692,569813,576879,27390,27375,15,,,19/1/2022 7:23
3/4/2021,Songkhla,0,149,1429058,696568,732490,69929,69891,38,73,35,19/1/2022 7:23
3/4/2021,Satun,0,24,324321,161388,162933,73143,72554,589,43,29,19/1/2022 7:23
3/4/2021,Samut Prakarn,5,827,1354390,645522,708868,27501,27263,238,,,19/1/2022 7:23
3/4/2021,Samut Songkhram,0,75,191749,91610,100139,126386,126314,72,24,16,19/1/2022 7:23
3/4/2021,Samut Sakhon,12,17160,586317,282574,303743,6690,6639,51,57,21,19/1/2022 7:23
3/4/2021,Saraburi,0,23,644230,316852,327378,96839,96724,115,73,65,19/1/2022 7:23
3/4/2021,Sa kaeo,0,15,561071,280075,280996,23441,23441,0,37,16,19/1/2022 7:23
3/4/2021,Sing Buri,0,17,205427,97606,107821,17847,17847,0,,,19/1/2022 7:23
3/4/2021,Suphan Buri,9,48,837370,404033,433337,72907,72907,0,,,19/1/2022 7:23
3/4/2021,Surat Thani,0,30,1068273,526182,542091,65669,65132,537,66,39,19/1/2022 7:23
3/4/2021,Surin,0,14,1377326,685192,692134,24004,23993,11,,,19/1/2022 7:23
3/4/2021,Sukhothai,0,5,586830,284310,302520,56642,55966,676,,,19/1/2022 7:23
3/4/2021,Nong Khai,0,5,517147,256546,260601,20943,20864,79,54,9,19/1/2022 7:23
3/4/2021,Nong Bua Lam Phu,0,5,509129,253956,255173,4947,4947,0,,,19/1/2022 7:23
3/4/2021,Amnat Charoen,0,4,376158,187258,188900,7354,7354,0,,,19/1/2022 7:23
3/4/2021,Udon Thani,0,11,1567503,776622,790881,39172,39152,20,,,19/1/2022 7:23
3/4/2021,Uttaradit,0,6,447754,218285,229469,47493,47493,0,,,19/1/2022 7:23
3/4/2021,Uthai Thani,0,1,325542,159106,166436,61633,61633,0,,,19/1/2022 7:23
3/4/2021,Ubon Ratchathani,0,19,1866247,931793,934454,115331,115317,14,126,43,19/1/2022 7:23
3/4/2021,Ang Thong,0,124,275944,132088,143856,35544,35544,0,,,19/1/2022 7:23
3/4/2021,Chiang Rai,0,74,1295958,630131,665827,132092,131542,550,306,105,19/1/2022 7:23
3/4/2021,Chiang Mai,0,67,1785706,863274,922432,396241,392204,4037,179,74,19/1/2022 7:23
3/4/2021,Phetchaburi,0,92,482292,232840,249452,385714,385488,226,,,19/1/2022 7:23
3/4/2021,Phetchabun,0,4,980662,483966,496696,95174,94812,362,,,19/1/2022 7:23
3/4/2021,Loei,0,13,638441,319953,318488,50148,50126,22,107,33,19/1/2022 7:23
3/4/2021,Phrae,0,1,436290,210317,225973,62210,62067,143,129,44,19/1/2022 7:23
3/4/2021,Mae Hong Son,0,5,285552,144717,140835,42084,41573,511,321,192,19/1/2022 7:23
3/4/2021,,0,12,,,,,,,,,19/1/2022 7:23
4/4/2021,Krabi,0,27,478376,237526,240850,100764,99754,1010,,,19/1/2022 7:23
4/4/2021,Bangkok,41,4961,5574497,2617639,2956858,1115611,1063854,51757,59,47,19/1/2022 7:23
4/4/2021,Kanchanaburi,0,16,892843,448201,444642,243519,243308,211,27,24,19/1/2022 7:23
4/4/2021,Kalasin,0,4,976734,482933,493801,12687,12687,0,,,19/1/2022 7:23
4/4/2021,Kamphaeng Phet,0,2,713471,352392,361079,39769,39688,81,,,19/1/2022 7:23
4/4/2021,Khon Kaen,2,22,1793256,881683,911573,57354,57291,63,104,43,19/1/2022 7:23
4/4/2021,Chanthaburi,0,224,535634,261945,273689,116001,115931,70,,,19/1/2022 7:23
4/4/2021,Chachoengsao,0,45,721596,353738,367858,29877,29877,0,61,38,19/1/2022 7:23
4/4/2021,Chon Buri,8,1510,1572004,766532,805472,156392,155350,1042,43,31,19/1/2022 7:23
4/4/2021,Chai Nat,0,11,321758,154645,167113,31521,31521,0,,,19/1/2022 7:23
4/4/2021,Chaiyaphum,0,11,1123903,555222,568681,40561,40512,49,,,19/1/2022 7:23
4/4/2021,Chumphon,0,21,509518,251414,258104,61047,60995,52,,,19/1/2022 7:23
4/4/2021,Trang,0,12,640411,313222,327189,40640,40547,93,,,19/1/2022 7:23
4/4/2021,Trat,0,33,228569,113072,115497,137616,137392,224,,,19/1/2022 7:23
4/4/2021,Tak,0,325,672976,340316,332660,59385,59312,73,,,19/1/2022 7:23
4/4/2021,Nakhon Nayok,0,18,259750,128155,131595,76708,76708,0,,,19/1/2022 7:23
4/4/2021,Nakhon Pathom,3,201,922448,443178,479270,98319,98268,51,70,30,19/1/2022 7:23
4/4/2021,Nakhon Phanom,0,3,716791,357234,359557,27584,27557,27,,,19/1/2022 7:23
4/4/2021,Nakhon Ratchasima,0,32,2633610,1294642,1338968,314682,313761,921,73,33,19/1/2022 7:23
4/4/2021,Nakhon Si Thammarat,0,16,1550947,765252,785695,108124,107604,520,,,19/1/2022 7:23
4/4/2021,Nakhon Sawan,0,15,1038712,506804,531908,115116,115001,115,153,31,19/1/2022 7:23
4/4/2021,Nonthaburi,2,471,1281245,596307,684938,33945,33820,125,39,40,19/1/2022 7:23
4/4/2021,Narathiwat,1,70,806698,398996,407702,12366,12366,0,51,23,19/1/2022 7:23
4/4/2021,Nan,0,1,476372,238449,237923,60575,60465,110,,,19/1/2022 7:23
4/4/2021,Bueng Kan,0,0,422066,211554,210512,5420,5420,0,,,19/1/2022 7:23
4/4/2021,Buri Ram,0,15,1580079,784198,795881,38966,38860,106,,,19/1/2022 7:23
4/4/2021,Pathum Thani,2,820,1180730,559573,621157,17584,17443,141,62,29,19/1/2022 7:23
4/4/2021,Prachuap Khiri Khan,0,25,551205,272975,278230,275365,275243,122,,,19/1/2022 7:23
4/4/2021,Prachin Buri,0,21,494574,244431,250143,62857,62857,0,68,30,19/1/2022 7:23
4/4/2021,Pattani,0,97,727686,359470,368216,11318,11318,0,,,19/1/2022 7:23
4/4/2021,Phra Nakhon Si Ayutthaya,1,69,819654,393768,425886,230549,229807,742,44,53,19/1/2022 7:23
4/4/2021,Phayao,0,4,466174,226975,239199,34541,34442,99,147,59,19/1/2022 7:23
4/4/2021,Phang-nga,0,2,268508,133879,134629,132253,130614,1639,,,19/1/2022 7:23
4/4/2021,Phatthalung,0,17,523116,254885,268231,50714,50714,0,,,19/1/2022 7:23
4/4/2021,Phichit,0,10,531541,259263,272278,52325,52325,0,,,19/1/2022 7:23
4/4/2021,Phitsanulok,0,7,848043,415270,432773,150029,149890,139,,,19/1/2022 7:23
4/4/2021,Phuket,0,231,413242,195176,218066,185057,183877,1180,76,45,19/1/2022 7:23
4/4/2021,Maha Sarakham,0,22,951507,466454,485053,12276,12276,0,,,19/1/2022 7:23
4/4/2021,Mukdahan,0,6,350834,175233,175601,29874,29874,0,,,19/1/2022 7:23
4/4/2021,Yala,2,151,539921,268685,271236,29789,29789,0,52,33,19/1/2022 7:23
4/4/2021,Yasothon,0,2,534065,266640,267425,23761,23761,0,,,19/1/2022 7:23
4/4/2021,Ranong,0,1,194741,98300,96441,52522,52361,161,,,19/1/2022 7:23
4/4/2021,Rayong,0,602,744962,365850,379112,102268,101970,298,39,35,19/1/2022 7:23
4/4/2021,Ratchaburi,0,59,869447,422955,446492,42340,42325,15,,,19/1/2022 7:23
4/4/2021,Roi Et,0,4,1297612,643180,654432,9529,9529,0,,,19/1/2022 7:23
4/4/2021,Lop Buri,0,24,741974,370517,371457,54769,54707,62,,,19/1/2022 7:23
4/4/2021,Lampang,0,7,727166,354266,372900,88127,87577,550,153,52,19/1/2022 7:23
4/4/2021,Lamphun,0,6,401750,193199,208551,70522,70337,185,,,19/1/2022 7:23
4/4/2021,Si Sa Ket,0,9,1457730,725631,732099,15523,15523,0,,,19/1/2022 7:23
4/4/2021,Sakon Nakhon,0,1,1146692,569813,576879,27390,27375,15,,,19/1/2022 7:23
4/4/2021,Songkhla,0,149,1429058,696568,732490,69929,69891,38,66,35,19/1/2022 7:23
4/4/2021,Satun,0,24,324321,161388,162933,73143,72554,589,55,24,19/1/2022 7:23
4/4/2021,Samut Prakarn,9,836,1354390,645522,708868,27501,27263,238,,,19/1/2022 7:23
4/4/2021,Samut Songkhram,0,75,191749,91610,100139,126386,126314,72,33,12,19/1/2022 7:23
4/4/2021,Samut Sakhon,13,17173,586317,282574,303743,6690,6639,51,59,33,19/1/2022 7:23
4/4/2021,Saraburi,0,23,644230,316852,327378,96839,96724,115,69,77,19/1/2022 7:23
4/4/2021,Sa kaeo,0,15,561071,280075,280996,23441,23441,0,28,18,19/1/2022 7:23
4/4/2021,Sing Buri,0,17,205427,97606,107821,17847,17847,0,,,19/1/2022 7:23
4/4/2021,Suphan Buri,5,53,837370,404033,433337,72907,72907,0,,,19/1/2022 7:23
4/4/2021,Surat Thani,6,36,1068273,526182,542091,65669,65132,537,73,39,19/1/2022 7:23
4/4/2021,Surin,0,14,1377326,685192,692134,24004,23993,11,,,19/1/2022 7:23
4/4/2021,Sukhothai,0,5,586830,284310,302520,56642,55966,676,,,19/1/2022 7:23
4/4/2021,Nong Khai,0,5,517147,256546,260601,20943,20864,79,23,13,19/1/2022 7:23
4/4/2021,Nong Bua Lam Phu,0,5,509129,253956,255173,4947,4947,0,,,19/1/2022 7:23
4/4/2021,Amnat Charoen,0,4,376158,187258,188900,7354,7354,0,,,19/1/2022 7:23
4/4/2021,Udon Thani,1,12,1567503,776622,790881,39172,39152,20,,,19/1/2022 7:23
4/4/2021,Uttaradit,0,6,447754,218285,229469,47493,47493,0,,,19/1/2022 7:23
4/4/2021,Uthai Thani,0,1,325542,159106,166436,61633,61633,0,,,19/1/2022 7:23
4/4/2021,Ubon Ratchathani,0,19,1866247,931793,934454,115331,115317,14,99,49,19/1/2022 7:23
4/4/2021,Ang Thong,0,124,275944,132088,143856,35544,35544,0,,,19/1/2022 7:23
4/4/2021,Chiang Rai,0,74,1295958,630131,665827,132092,131542,550,222,62,19/1/2022 7:23
4/4/2021,Chiang Mai,0,67,1785706,863274,922432,396241,392204,4037,167,70,19/1/2022 7:23
4/4/2021,Phetchaburi,0,92,482292,232840,249452,385714,385488,226,,,19/1/2022 7:23
4/4/2021,Phetchabun,0,4,980662,483966,496696,95174,94812,362,,,19/1/2022 7:23
4/4/2021,Loei,0,13,638441,319953,318488,50148,50126,22,56,30,19/1/2022 7:23
4/4/2021,Phrae,0,1,436290,210317,225973,62210,62067,143,116,38,19/1/2022 7:23
4/4/2021,Mae Hong Son,0,5,285552,144717,140835,42084,41573,511,347,89,19/1/2022 7:23
4/4/2021,,0,12,,,,,,,,,19/1/2022 7:23
5/4/2021,Krabi,0,27,478376,237526,240850,100764,99754,1010,,,19/1/2022 7:23
5/4/2021,Bangkok,55,5016,5574497,2617639,2956858,1115611,1063854,51757,91,46,19/1/2022 7:23
5/4/2021,Kanchanaburi,0,16,892843,448201,444642,243519,243308,211,23,29,19/1/2022 7:23
5/4/2021,Kalasin,0,4,976734,482933,493801,12687,12687,0,,,19/1/2022 7:23
5/4/2021,Kamphaeng Phet,0,2,713471,352392,361079,39769,39688,81,,,19/1/2022 7:23
5/4/2021,Khon Kaen,0,22,1793256,881683,911573,57354,57291,63,80,54,19/1/2022 7:23
5/4/2021,Chanthaburi,0,224,535634,261945,273689,116001,115931,70,,,19/1/2022 7:23
5/4/2021,Chachoengsao,0,45,721596,353738,367858,29877,29877,0,66,53,19/1/2022 7:23
5/4/2021,Chon Buri,8,1518,1572004,766532,805472,156392,155350,1042,60,35,19/1/2022 7:23
5/4/2021,Chai Nat,0,11,321758,154645,167113,31521,31521,0,,,19/1/2022 7:23
5/4/2021,Chaiyaphum,2,13,1123903,555222,568681,40561,40512,49,,,19/1/2022 7:23
5/4/2021,Chumphon,2,23,509518,251414,258104,61047,60995,52,,,19/1/2022 7:23
5/4/2021,Trang,0,12,640411,313222,327189,40640,40547,93,,,19/1/2022 7:23
5/4/2021,Trat,0,33,228569,113072,115497,137616,137392,224,,,19/1/2022 7:23
5/4/2021,Tak,1,326,672976,340316,332660,59385,59312,73,,,19/1/2022 7:23
5/4/2021,Nakhon Nayok,0,18,259750,128155,131595,76708,76708,0,,,19/1/2022 7:23
5/4/2021,Nakhon Pathom,0,201,922448,443178,479270,98319,98268,51,65,33,19/1/2022 7:23
5/4/2021,Nakhon Phanom,0,3,716791,357234,359557,27584,27557,27,,,19/1/2022 7:23
5/4/2021,Nakhon Ratchasima,0,32,2633610,1294642,1338968,314682,313761,921,68,45,19/1/2022 7:23
5/4/2021,Nakhon Si Thammarat,0,16,1550947,765252,785695,108124,107604,520,,,19/1/2022 7:23
5/4/2021,Nakhon Sawan,0,15,1038712,506804,531908,115116,115001,115,61,178,19/1/2022 7:23
5/4/2021,Nonthaburi,4,475,1281245,596307,684938,33945,33820,125,65,42,19/1/2022 7:23
5/4/2021,Narathiwat,94,164,806698,398996,407702,12366,12366,0,48,26,19/1/2022 7:23
5/4/2021,Nan,0,1,476372,238449,237923,60575,60465,110,,,19/1/2022 7:23
5/4/2021,Bueng Kan,0,0,422066,211554,210512,5420,5420,0,,,19/1/2022 7:23
5/4/2021,Buri Ram,0,15,1580079,784198,795881,38966,38860,106,,,19/1/2022 7:23
5/4/2021,Pathum Thani,2,822,1180730,559573,621157,17584,17443,141,78,34,19/1/2022 7:23
5/4/2021,Prachuap Khiri Khan,2,27,551205,272975,278230,275365,275243,122,,,19/1/2022 7:23
5/4/2021,Prachin Buri,0,21,494574,244431,250143,62857,62857,0,70,49,19/1/2022 7:23
5/4/2021,Pattani,0,97,727686,359470,368216,11318,11318,0,,,19/1/2022 7:23
5/4/2021,Phra Nakhon Si Ayutthaya,0,69,819654,393768,425886,230549,229807,742,60,56,19/1/2022 7:23
5/4/2021,Phayao,0,4,466174,226975,239199,34541,34442,99,151,19,19/1/2022 7:23
5/4/2021,Phang-nga,0,2,268508,133879,134629,132253,130614,1639,,,19/1/2022 7:23
5/4/2021,Phatthalung,0,17,523116,254885,268231,50714,50714,0,,,19/1/2022 7:23
5/4/2021,Phichit,0,10,531541,259263,272278,52325,52325,0,,,19/1/2022 7:23
5/4/2021,Phitsanulok,0,7,848043,415270,432773,150029,149890,139,,,19/1/2022 7:23
5/4/2021,Phuket,0,231,413242,195176,218066,185057,183877,1180,85,33,19/1/2022 7:23
5/4/2021,Maha Sarakham,0,22,951507,466454,485053,12276,12276,0,,,19/1/2022 7:23
5/4/2021,Mukdahan,0,6,350834,175233,175601,29874,29874,0,,,19/1/2022 7:23
5/4/2021,Yala,1,152,539921,268685,271236,29789,29789,0,58,28,19/1/2022 7:23
5/4/2021,Yasothon,0,2,534065,266640,267425,23761,23761,0,,,19/1/2022 7:23
5/4/2021,Ranong,0,1,194741,98300,96441,52522,52361,161,,,19/1/2022 7:23
5/4/2021,Rayong,0,602,744962,365850,379112,102268,101970,298,65,32,19/1/2022 7:23
5/4/2021,Ratchaburi,0,59,869447,422955,446492,42340,42325,15,,,19/1/2022 7:23
5/4/2021,Roi Et,0,4,1297612,643180,654432,9529,9529,0,,,19/1/2022 7:23
5/4/2021,Lop Buri,0,24,741974,370517,371457,54769,54707,62,,,19/1/2022 7:23
5/4/2021,Lampang,0,7,727166,354266,372900,88127,87577,550,116,26,19/1/2022 7:23
5/4/2021,Lamphun,0,6,401750,193199,208551,70522,70337,185,,,19/1/2022 7:23
5/4/2021,Si Sa Ket,0,9,1457730,725631,732099,15523,15523,0,,,19/1/2022 7:23
5/4/2021,Sakon Nakhon,0,1,1146692,569813,576879,27390,27375,15,,,19/1/2022 7:23
5/4/2021,Songkhla,0,149,1429058,696568,732490,69929,69891,38,60,26,19/1/2022 7:23
5/4/2021,Satun,0,24,324321,161388,162933,73143,72554,589,61,17,19/1/2022 7:23
5/4/2021,Samut Prakarn,10,846,1354390,645522,708868,27501,27263,238,,,19/1/2022 7:23
5/4/2021,Samut Songkhram,1,76,191749,91610,100139,126386,126314,72,33,14,19/1/2022 7:23
5/4/2021,Samut Sakhon,4,17177,586317,282574,303743,6690,6639,51,84,39,19/1/2022 7:23
5/4/2021,Saraburi,0,23,644230,316852,327378,96839,96724,115,81,123,19/1/2022 7:23
5/4/2021,Sa kaeo,1,16,561071,280075,280996,23441,23441,0,38,29,19/1/2022 7:23
5/4/2021,Sing Buri,0,17,205427,97606,107821,17847,17847,0,,,19/1/2022 7:23
5/4/2021,Suphan Buri,7,60,837370,404033,433337,72907,72907,0,,,19/1/2022 7:23
5/4/2021,Surat Thani,0,36,1068273,526182,542091,65669,65132,537,62,39,19/1/2022 7:23
5/4/2021,Surin,0,14,1377326,685192,692134,24004,23993,11,,,19/1/2022 7:23
5/4/2021,Sukhothai,0,5,586830,284310,302520,56642,55966,676,,,19/1/2022 7:23
5/4/2021,Nong Khai,0,5,517147,256546,260601,20943,20864,79,32,14,19/1/2022 7:23
5/4/2021,Nong Bua Lam Phu,0,5,509129,253956,255173,4947,4947,0,,,19/1/2022 7:23
5/4/2021,Amnat Charoen,0,4,376158,187258,188900,7354,7354,0,,,19/1/2022 7:23
5/4/2021,Udon Thani,0,12,1567503,776622,790881,39172,39152,20,,,19/1/2022 7:23
5/4/2021,Uttaradit,0,6,447754,218285,229469,47493,47493,0,,,19/1/2022 7:23
5/4/2021,Uthai Thani,0,1,325542,159106,166436,61633,61633,0,,,19/1/2022 7:23
5/4/2021,Ubon Ratchathani,0,19,1866247,931793,934454,115331,115317,14,108,54,19/1/2022 7:23
5/4/2021,Ang Thong,0,124,275944,132088,143856,35544,35544,0,,,19/1/2022 7:23
5/4/2021,Chiang Rai,0,74,1295958,630131,665827,132092,131542,550,145,17,19/1/2022 7:23
5/4/2021,Chiang Mai,0,67,1785706,863274,922432,396241,392204,4037,162,24,19/1/2022 7:23
5/4/2021,Phetchaburi,0,92,482292,232840,249452,385714,385488,226,,,19/1/2022 7:23
5/4/2021,Phetchabun,0,4,980662,483966,496696,95174,94812,362,,,19/1/2022 7:23
5/4/2021,Loei,0,13,638441,319953,318488,50148,50126,22,42,41,19/1/2022 7:23
5/4/2021,Phrae,0,1,436290,210317,225973,62210,62067,143,105,17,19/1/2022 7:23
5/4/2021,Mae Hong Son,0,5,285552,144717,140835,42084,41573,511,188,18,19/1/2022 7:23
5/4/2021,,0,12,,,,,,,,,19/1/2022 7:23
6/4/2021,Krabi,0,27,478376,237526,240850,100764,99754,1010,,,19/1/2022 7:23
6/4/2021,Bangkok,157,5173,5574497,2617639,2956858,1115611,1063854,51757,86,47,19/1/2022 7:23
6/4/2021,Kanchanaburi,1,17,892843,448201,444642,243519,243308,211,41,26,19/1/2022 7:23
6/4/2021,Kalasin,0,4,976734,482933,493801,12687,12687,0,,,19/1/2022 7:23
6/4/2021,Kamphaeng Phet,0,2,713471,352392,361079,39769,39688,81,,,19/1/2022 7:23
6/4/2021,Khon Kaen,0,22,1793256,881683,911573,57354,57291,63,102,48,19/1/2022 7:23
6/4/2021,Chanthaburi,0,224,535634,261945,273689,116001,115931,70,,,19/1/2022 7:23
6/4/2021,Chachoengsao,0,45,721596,353738,367858,29877,29877,0,111,49,19/1/2022 7:23
6/4/2021,Chon Buri,21,1539,1572004,766532,805472,156392,155350,1042,66,45,19/1/2022 7:23
6/4/2021,Chai Nat,0,11,321758,154645,167113,31521,31521,0,,,19/1/2022 7:23
6/4/2021,Chaiyaphum,1,14,1123903,555222,568681,40561,40512,49,,,19/1/2022 7:23
6/4/2021,Chumphon,0,23,509518,251414,258104,61047,60995,52,,,19/1/2022 7:23
6/4/2021,Trang,0,12,640411,313222,327189,40640,40547,93,,,19/1/2022 7:23
6/4/2021,Trat,0,33,228569,113072,115497,137616,137392,224,,,19/1/2022 7:23
6/4/2021,Tak,1,327,672976,340316,332660,59385,59312,73,,,19/1/2022 7:23
6/4/2021,Nakhon Nayok,0,18,259750,128155,131595,76708,76708,0,,,19/1/2022 7:23
6/4/2021,Nakhon Pathom,1,202,922448,443178,479270,98319,98268,51,66,27,19/1/2022 7:23
6/4/2021,Nakhon Phanom,0,3,716791,357234,359557,27584,27557,27,,,19/1/2022 7:23
6/4/2021,Nakhon Ratchasima,0,32,2633610,1294642,1338968,314682,313761,921,88,44,19/1/2022 7:23
6/4/2021,Nakhon Si Thammarat,0,16,1550947,765252,785695,108124,107604,520,,,19/1/2022 7:23
6/4/2021,Nakhon Sawan,0,15,1038712,506804,531908,115116,115001,115,146,23,19/1/2022 7:23
6/4/2021,Nonthaburi,1,476,1281245,596307,684938,33945,33820,125,72,71,19/1/2022 7:23
6/4/2021,Narathiwat,30,194,806698,398996,407702,12366,12366,0,52,27,19/1/2022 7:23
6/4/2021,Nan,0,1,476372,238449,237923,60575,60465,110,,,19/1/2022 7:23
6/4/2021,Bueng Kan,0,0,422066,211554,210512,5420,5420,0,,,19/1/2022 7:23
6/4/2021,Buri Ram,0,15,1580079,784198,795881,38966,38860,106,,,19/1/2022 7:23
6/4/2021,Pathum Thani,2,824,1180730,559573,621157,17584,17443,141,87,28,19/1/2022 7:23
6/4/2021,Prachuap Khiri Khan,0,27,551205,272975,278230,275365,275243,122,,,19/1/2022 7:23
6/4/2021,Prachin Buri,1,22,494574,244431,250143,62857,62857,0,114,41,19/1/2022 7:23
6/4/2021,Pattani,0,97,727686,359470,368216,11318,11318,0,,,19/1/2022 7:23
6/4/2021,Phra Nakhon Si Ayutthaya,1,70,819654,393768,425886,230549,229807,742,68,51,19/1/2022 7:23
6/4/2021,Phayao,0,4,466174,226975,239199,34541,34442,99,55,19,19/1/2022 7:23
6/4/2021,Phang-nga,0,2,268508,133879,134629,132253,130614,1639,,,19/1/2022 7:23
6/4/2021,Phatthalung,0,17,523116,254885,268231,50714,50714,0,,,19/1/2022 7:23
6/4/2021,Phichit,0,10,531541,259263,272278,52325,52325,0,,,19/1/2022 7:23
6/4/2021,Phitsanulok,0,7,848043,415270,432773,150029,149890,139,,,19/1/2022 7:23
6/4/2021,Phuket,0,231,413242,195176,218066,185057,183877,1180,71,27,19/1/2022 7:23
6/4/2021,Maha Sarakham,0,22,951507,466454,485053,12276,12276,0,,,19/1/2022 7:23
6/4/2021,Mukdahan,0,6,350834,175233,175601,29874,29874,0,,,19/1/2022 7:23
6/4/2021,Yala,0,152,539921,268685,271236,29789,29789,0,53,30,19/1/2022 7:23
6/4/2021,Yasothon,0,2,534065,266640,267425,23761,23761,0,,,19/1/2022 7:23
6/4/2021,Ranong,0,1,194741,98300,96441,52522,52361,161,,,19/1/2022 7:23
6/4/2021,Rayong,0,602,744962,365850,379112,102268,101970,298,70,52,19/1/2022 7:23
6/4/2021,Ratchaburi,0,59,869447,422955,446492,42340,42325,15,,,19/1/2022 7:23
6/4/2021,Roi Et,0,4,1297612,643180,654432,9529,9529,0,,,19/1/2022 7:23
6/4/2021,Lop Buri,1,25,741974,370517,371457,54769,54707,62,,,19/1/2022 7:23
6/4/2021,Lampang,0,7,727166,354266,372900,88127,87577,550,47,26,19/1/2022 7:23
6/4/2021,Lamphun,0,6,401750,193199,208551,70522,70337,185,,,19/1/2022 7:23
6/4/2021,Si Sa Ket,0,9,1457730,725631,732099,15523,15523,0,,,19/1/2022 7:23
6/4/2021,Sakon Nakhon,0,1,1146692,569813,576879,27390,27375,15,,,19/1/2022 7:23
6/4/2021,Songkhla,0,149,1429058,696568,732490,69929,69891,38,47,30,19/1/2022 7:23
6/4/2021,Satun,0,24,324321,161388,162933,73143,72554,589,41,17,19/1/2022 7:23
6/4/2021,Samut Prakarn,21,867,1354390,645522,708868,27501,27263,238,,,19/1/2022 7:23
6/4/2021,Samut Songkhram,0,76,191749,91610,100139,126386,126314,72,37,19,19/1/2022 7:23
6/4/2021,Samut Sakhon,7,17184,586317,282574,303743,6690,6639,51,92,32,19/1/2022 7:23
6/4/2021,Saraburi,0,23,644230,316852,327378,96839,96724,115,115,91,19/1/2022 7:23
6/4/2021,Sa kaeo,2,18,561071,280075,280996,23441,23441,0,63,29,19/1/2022 7:23
6/4/2021,Sing Buri,0,17,205427,97606,107821,17847,17847,0,,,19/1/2022 7:23
6/4/2021,Suphan Buri,0,60,837370,404033,433337,72907,72907,0,,,19/1/2022 7:23
6/4/2021,Surat Thani,0,36,1068273,526182,542091,65669,65132,537,64,43,19/1/2022 7:23
6/4/2021,Surin,0,14,1377326,685192,692134,24004,23993,11,,,19/1/2022 7:23
6/4/2021,Sukhothai,0,5,586830,284310,302520,56642,55966,676,,,19/1/2022 7:23
6/4/2021,Nong Khai,0,5,517147,256546,260601,20943,20864,79,37,16,19/1/2022 7:23
6/4/2021,Nong Bua Lam Phu,0,5,509129,253956,255173,4947,4947,0,,,19/1/2022 7:23
6/4/2021,Amnat Charoen,0,4,376158,187258,188900,7354,7354,0,,,19/1/2022 7:23
6/4/2021,Udon Thani,0,12,1567503,776622,790881,39172,39152,20,,,19/1/2022 7:23
6/4/2021,Uttaradit,0,6,447754,218285,229469,47493,47493,0,,,19/1/2022 7:23
6/4/2021,Uthai Thani,0,1,325542,159106,166436,61633,61633,0,,,19/1/2022 7:23
6/4/2021,Ubon Ratchathani,0,19,1866247,931793,934454,115331,115317,14,124,53,19/1/2022 7:23
6/4/2021,Ang Thong,0,124,275944,132088,143856,35544,35544,0,,,19/1/2022 7:23
6/4/2021,Chiang Rai,0,74,1295958,630131,665827,132092,131542,550,53,19,19/1/2022 7:23
6/4/2021,Chiang Mai,2,69,1785706,863274,922432,396241,392204,4037,62,30,19/1/2022 7:23
6/4/2021,Phetchaburi,0,92,482292,232840,249452,385714,385488,226,,,19/1/2022 7:23
6/4/2021,Phetchabun,0,4,980662,483966,496696,95174,94812,362,,,19/1/2022 7:23
6/4/2021,Loei,0,13,638441,319953,318488,50148,50126,22,71,27,19/1/2022 7:23
6/4/2021,Phrae,0,1,436290,210317,225973,62210,62067,143,55,17,19/1/2022 7:23
6/4/2021,Mae Hong Son,0,5,285552,144717,140835,42084,41573,511,60,27,19/1/2022 7:23
6/4/2021,,0,12,,,,,,,,,19/1/2022 7:23
7/4/2021,Krabi,0,27,478376,237526,240850,100764,99754,1010,,,19/1/2022 7:23
7/4/2021,Bangkok,221,5394,5574497,2617639,2956858,1115611,1063854,51757,89,46,19/1/2022 7:23
7/4/2021,Kanchanaburi,0,17,892843,448201,444642,243519,243308,211,23,18,19/1/2022 7:23
7/4/2021,Kalasin,0,4,976734,482933,493801,12687,12687,0,,,19/1/2022 7:23
7/4/2021,Kamphaeng Phet,0,2,713471,352392,361079,39769,39688,81,,,19/1/2022 7:23
7/4/2021,Khon Kaen,2,24,1793256,881683,911573,57354,57291,63,90,45,19/1/2022 7:23
7/4/2021,Chanthaburi,1,225,535634,261945,273689,116001,115931,70,,,19/1/2022 7:23
7/4/2021,Chachoengsao,0,45,721596,353738,367858,29877,29877,0,85,49,19/1/2022 7:23
7/4/2021,Chon Buri,12,1551,1572004,766532,805472,156392,155350,1042,78,41,19/1/2022 7:23
7/4/2021,Chai Nat,0,11,321758,154645,167113,31521,31521,0,,,19/1/2022 7:23
7/4/2021,Chaiyaphum,0,14,1123903,555222,568681,40561,40512,49,,,19/1/2022 7:23
7/4/2021,Chumphon,0,23,509518,251414,258104,61047,60995,52,,,19/1/2022 7:23
7/4/2021,Trang,0,12,640411,313222,327189,40640,40547,93,,,19/1/2022 7:23
7/4/2021,Trat,0,33,228569,113072,115497,137616,137392,224,,,19/1/2022 7:23
7/4/2021,Tak,0,327,672976,340316,332660,59385,59312,73,,,19/1/2022 7:23
7/4/2021,Nakhon Nayok,0,18,259750,128155,131595,76708,76708,0,,,19/1/2022 7:23
7/4/2021,Nakhon Pathom,1,203,922448,443178,479270,98319,98268,51,52,27,19/1/2022 7:23
7/4/2021,Nakhon Phanom,0,3,716791,357234,359557,27584,27557,27,,,19/1/2022 7:23
7/4/2021,Nakhon Ratchasima,0,32,2633610,1294642,1338968,314682,313761,921,89,50,19/1/2022 7:23
7/4/2021,Nakhon Si Thammarat,0,16,1550947,765252,785695,108124,107604,520,,,19/1/2022 7:23
7/4/2021,Nakhon Sawan,0,15,1038712,506804,531908,115116,115001,115,62,73,19/1/2022 7:23
7/4/2021,Nonthaburi,8,484,1281245,596307,684938,33945,33820,125,66,29,19/1/2022 7:23
7/4/2021,Narathiwat,1,195,806698,398996,407702,12366,12366,0,61,30,19/1/2022 7:23
7/4/2021,Nan,0,1,476372,238449,237923,60575,60465,110,,,19/1/2022 7:23
7/4/2021,Bueng Kan,0,0,422066,211554,210512,5420,5420,0,,,19/1/2022 7:23
7/4/2021,Buri Ram,0,15,1580079,784198,795881,38966,38860,106,,,19/1/2022 7:23
7/4/2021,Pathum Thani,3,827,1180730,559573,621157,17584,17443,141,67,30,19/1/2022 7:23
7/4/2021,Prachuap Khiri Khan,6,33,551205,272975,278230,275365,275243,122,,,19/1/2022 7:23
7/4/2021,Prachin Buri,0,22,494574,244431,250143,62857,62857,0,86,45,19/1/2022 7:23
7/4/2021,Pattani,0,97,727686,359470,368216,11318,11318,0,,,19/1/2022 7:23
7/4/2021,Phra Nakhon Si Ayutthaya,1,71,819654,393768,425886,230549,229807,742,58,61,19/1/2022 7:23
7/4/2021,Phayao,0,4,466174,226975,239199,34541,34442,99,43,26,19/1/2022 7:23
7/4/2021,Phang-nga,0,2,268508,133879,134629,132253,130614,1639,,,19/1/2022 7:23
7/4/2021,Phatthalung,0,17,523116,254885,268231,50714,50714,0,,,19/1/2022 7:23
7/4/2021,Phichit,0,10,531541,259263,272278,52325,52325,0,,,19/1/2022 7:23
7/4/2021,Phitsanulok,0,7,848043,415270,432773,150029,149890,139,,,19/1/2022 7:23
7/4/2021,Phuket,1,232,413242,195176,218066,185057,183877,1180,53,33,19/1/2022 7:23
7/4/2021,Maha Sarakham,0,22,951507,466454,485053,12276,12276,0,,,19/1/2022 7:23
7/4/2021,Mukdahan,0,6,350834,175233,175601,29874,29874,0,,,19/1/2022 7:23
7/4/2021,Yala,0,152,539921,268685,271236,29789,29789,0,58,34,19/1/2022 7:23
7/4/2021,Yasothon,0,2,534065,266640,267425,23761,23761,0,,,19/1/2022 7:23
7/4/2021,Ranong,0,1,194741,98300,96441,52522,52361,161,,,19/1/2022 7:23
7/4/2021,Rayong,1,603,744962,365850,379112,102268,101970,298,84,37,19/1/2022 7:23
7/4/2021,Ratchaburi,0,59,869447,422955,446492,42340,42325,15,,,19/1/2022 7:23
7/4/2021,Roi Et,0,4,1297612,643180,654432,9529,9529,0,,,19/1/2022 7:23
7/4/2021,Lop Buri,0,25,741974,370517,371457,54769,54707,62,,,19/1/2022 7:23
7/4/2021,Lampang,1,8,727166,354266,372900,88127,87577,550,37,35,19/1/2022 7:23
7/4/2021,Lamphun,0,6,401750,193199,208551,70522,70337,185,,,19/1/2022 7:23
7/4/2021,Si Sa Ket,0,9,1457730,725631,732099,15523,15523,0,,,19/1/2022 7:23
7/4/2021,Sakon Nakhon,0,1,1146692,569813,576879,27390,27375,15,,,19/1/2022 7:23
7/4/2021,Songkhla,1,150,1429058,696568,732490,69929,69891,38,56,36,19/1/2022 7:23
7/4/2021,Satun,0,24,324321,161388,162933,73143,72554,589,36,33,19/1/2022 7:23
7/4/2021,Samut Prakarn,31,898,1354390,645522,708868,27501,27263,238,,,19/1/2022 7:23
7/4/2021,Samut Songkhram,0,76,191749,91610,100139,126386,126314,72,48,16,19/1/2022 7:23
7/4/2021,Samut Sakhon,12,17196,586317,282574,303743,6690,6639,51,83,44,19/1/2022 7:23
7/4/2021,Saraburi,0,23,644230,316852,327378,96839,96724,115,100,89,19/1/2022 7:23
7/4/2021,Sa kaeo,20,38,561071,280075,280996,23441,23441,0,61,33,19/1/2022 7:23
7/4/2021,Sing Buri,0,17,205427,97606,107821,17847,17847,0,,,19/1/2022 7:23
7/4/2021,Suphan Buri,8,68,837370,404033,433337,72907,72907,0,,,19/1/2022 7:23
7/4/2021,Surat Thani,0,36,1068273,526182,542091,65669,65132,537,72,43,19/1/2022 7:23
7/4/2021,Surin,0,14,1377326,685192,692134,24004,23993,11,,,19/1/2022 7:23
7/4/2021,Sukhothai,0,5,586830,284310,302520,56642,55966,676,,,19/1/2022 7:23
7/4/2021,Nong Khai,0,5,517147,256546,260601,20943,20864,79,39,16,19/1/2022 7:23
7/4/2021,Nong Bua Lam Phu,0,5,509129,253956,255173,4947,4947,0,,,19/1/2022 7:23
7/4/2021,Amnat Charoen,0,4,376158,187258,188900,7354,7354,0,,,19/1/2022 7:23
7/4/2021,Udon Thani,1,13,1567503,776622,790881,39172,39152,20,,,19/1/2022 7:23
7/4/2021,Uttaradit,0,6,447754,218285,229469,47493,47493,0,,,19/1/2022 7:23
7/4/2021,Uthai Thani,0,1,325542,159106,166436,61633,61633,0,,,19/1/2022 7:23
7/4/2021,Ubon Ratchathani,0,19,1866247,931793,934454,115331,115317,14,109,66,19/1/2022 7:23
7/4/2021,Ang Thong,0,124,275944,132088,143856,35544,35544,0,,,19/1/2022 7:23
7/4/2021,Chiang Rai,0,74,1295958,630131,665827,132092,131542,550,44,24,19/1/2022 7:23
7/4/2021,Chiang Mai,2,71,1785706,863274,922432,396241,392204,4037,64,34,19/1/2022 7:23
7/4/2021,Phetchaburi,0,92,482292,232840,249452,385714,385488,226,,,19/1/2022 7:23
7/4/2021,Phetchabun,0,4,980662,483966,496696,95174,94812,362,,,19/1/2022 7:23
7/4/2021,Loei,0,13,638441,319953,318488,50148,50126,22,46,27,19/1/2022 7:23
7/4/2021,Phrae,0,1,436290,210317,225973,62210,62067,143,47,24,19/1/2022 7:23
7/4/2021,Mae Hong Son,0,5,285552,144717,140835,42084,41573,511,84,36,19/1/2022 7:23
7/4/2021,,0,12,,,,,,,,,19/1/2022 7:23
8/4/2021,Krabi,0,27,478376,237526,240850,100764,99754,1010,,,19/1/2022 7:23
8/4/2021,Bangkok,104,5498,5574497,2617639,2956858,1115611,1063854,51757,86,38,19/1/2022 7:23
8/4/2021,Kanchanaburi,0,17,892843,448201,444642,243519,243308,211,29,21,19/1/2022 7:23
8/4/2021,Kalasin,0,4,976734,482933,493801,12687,12687,0,,,19/1/2022 7:23
8/4/2021,Kamphaeng Phet,0,2,713471,352392,361079,39769,39688,81,,,19/1/2022 7:23
8/4/2021,Khon Kaen,3,27,1793256,881683,911573,57354,57291,63,81,54,19/1/2022 7:23
8/4/2021,Chanthaburi,0,225,535634,261945,273689,116001,115931,70,,,19/1/2022 7:23
8/4/2021,Chachoengsao,1,46,721596,353738,367858,29877,29877,0,89,45,19/1/2022 7:23
8/4/2021,Chon Buri,16,1567,1572004,766532,805472,156392,155350,1042,75,42,19/1/2022 7:23
8/4/2021,Chai Nat,0,11,321758,154645,167113,31521,31521,0,,,19/1/2022 7:23
8/4/2021,Chaiyaphum,2,16,1123903,555222,568681,40561,40512,49,,,19/1/2022 7:23
8/4/2021,Chumphon,3,26,509518,251414,258104,61047,60995,52,,,19/1/2022 7:23
8/4/2021,Trang,0,12,640411,313222,327189,40640,40547,93,,,19/1/2022 7:23
8/4/2021,Trat,0,33,228569,113072,115497,137616,137392,224,,,19/1/2022 7:23
8/4/2021,Tak,0,327,672976,340316,332660,59385,59312,73,,,19/1/2022 7:23
8/4/2021,Nakhon Nayok,0,18,259750,128155,131595,76708,76708,0,,,19/1/2022 7:23
8/4/2021,Nakhon Pathom,6,209,922448,443178,479270,98319,98268,51,60,28,19/1/2022 7:23
8/4/2021,Nakhon Phanom,0,3,716791,357234,359557,27584,27557,27,,,19/1/2022 7:23
8/4/2021,Nakhon Ratchasima,0,32,2633610,1294642,1338968,314682,313761,921,98,49,19/1/2022 7:23
8/4/2021,Nakhon Si Thammarat,1,17,1550947,765252,785695,108124,107604,520,,,19/1/2022 7:23
8/4/2021,Nakhon Sawan,0,15,1038712,506804,531908,115116,115001,115,96,122,19/1/2022 7:23
8/4/2021,Nonthaburi,20,504,1281245,596307,684938,33945,33820,125,61,31,19/1/2022 7:23
8/4/2021,Narathiwat,146,341,806698,398996,407702,12366,12366,0,59,29,19/1/2022 7:23
8/4/2021,Nan,0,1,476372,238449,237923,60575,60465,110,,,19/1/2022 7:23
8/4/2021,Bueng Kan,0,0,422066,211554,210512,5420,5420,0,,,19/1/2022 7:23
8/4/2021,Buri Ram,2,17,1580079,784198,795881,38966,38860,106,,,19/1/2022 7:23
8/4/2021,Pathum Thani,8,835,1180730,559573,621157,17584,17443,141,77,31,19/1/2022 7:23
8/4/2021,Prachuap Khiri Khan,14,47,551205,272975,278230,275365,275243,122,,,19/1/2022 7:23
8/4/2021,Prachin Buri,0,22,494574,244431,250143,62857,62857,0,95,41,19/1/2022 7:23
8/4/2021,Pattani,0,97,727686,359470,368216,11318,11318,0,,,19/1/2022 7:23
8/4/2021,Phra Nakhon Si Ayutthaya,2,73,819654,393768,425886,230549,229807,742,86,56,19/1/2022 7:23
8/4/2021,Phayao,0,4,466174,226975,239199,34541,34442,99,51,38,19/1/2022 7:23
8/4/2021,Phang-nga,0,2,268508,133879,134629,132253,130614,1639,,,19/1/2022 7:23
8/4/2021,Phatthalung,0,17,523116,254885,268231,50714,50714,0,,,19/1/2022 7:23
8/4/2021,Phichit,0,10,531541,259263,272278,52325,52325,0,,,19/1/2022 7:23
8/4/2021,Phitsanulok,4,11,848043,415270,432773,150029,149890,139,,,19/1/2022 7:23
8/4/2021,Phuket,3,235,413242,195176,218066,185057,183877,1180,66,34,19/1/2022 7:23
8/4/2021,Maha Sarakham,0,22,951507,466454,485053,12276,12276,0,,,19/1/2022 7:23
8/4/2021,Mukdahan,0,6,350834,175233,175601,29874,29874,0,,,19/1/2022 7:23
8/4/2021,Yala,0,152,539921,268685,271236,29789,29789,0,61,37,19/1/2022 7:23
8/4/2021,Yasothon,1,3,534065,266640,267425,23761,23761,0,,,19/1/2022 7:23
8/4/2021,Ranong,0,1,194741,98300,96441,52522,52361,161,,,19/1/2022 7:23
8/4/2021,Rayong,1,604,744962,365850,379112,102268,101970,298,78,33,19/1/2022 7:23
8/4/2021,Ratchaburi,0,59,869447,422955,446492,42340,42325,15,,,19/1/2022 7:23
8/4/2021,Roi Et,0,4,1297612,643180,654432,9529,9529,0,,,19/1/2022 7:23
8/4/2021,Lop Buri,0,25,741974,370517,371457,54769,54707,62,,,19/1/2022 7:23
8/4/2021,Lampang,1,9,727166,354266,372900,88127,87577,550,57,39,19/1/2022 7:23
8/4/2021,Lamphun,0,6,401750,193199,208551,70522,70337,185,,,19/1/2022 7:23
8/4/2021,Si Sa Ket,0,9,1457730,725631,732099,15523,15523,0,,,19/1/2022 7:23
8/4/2021,Sakon Nakhon,0,1,1146692,569813,576879,27390,27375,15,,,19/1/2022 7:23
8/4/2021,Songkhla,2,152,1429058,696568,732490,69929,69891,38,68,40,19/1/2022 7:23
8/4/2021,Satun,0,24,324321,161388,162933,73143,72554,589,59,28,19/1/2022 7:23
8/4/2021,Samut Prakarn,24,922,1354390,645522,708868,27501,27263,238,,,19/1/2022 7:23
8/4/2021,Samut Songkhram,0,76,191749,91610,100139,126386,126314,72,42,15,19/1/2022 7:23
8/4/2021,Samut Sakhon,9,17205,586317,282574,303743,6690,6639,51,101,37,19/1/2022 7:23
8/4/2021,Saraburi,1,24,644230,316852,327378,96839,96724,115,107,91,19/1/2022 7:23
8/4/2021,Sa kaeo,14,52,561071,280075,280996,23441,23441,0,67,25,19/1/2022 7:23
8/4/2021,Sing Buri,0,17,205427,97606,107821,17847,17847,0,,,19/1/2022 7:23
8/4/2021,Suphan Buri,2,70,837370,404033,433337,72907,72907,0,,,19/1/2022 7:23
8/4/2021,Surat Thani,0,36,1068273,526182,542091,65669,65132,537,66,48,19/1/2022 7:23
8/4/2021,Surin,0,14,1377326,685192,692134,24004,23993,11,,,19/1/2022 7:23
8/4/2021,Sukhothai,0,5,586830,284310,302520,56642,55966,676,,,19/1/2022 7:23
8/4/2021,Nong Khai,0,5,517147,256546,260601,20943,20864,79,41,14,19/1/2022 7:23
8/4/2021,Nong Bua Lam Phu,1,6,509129,253956,255173,4947,4947,0,,,19/1/2022 7:23
8/4/2021,Amnat Charoen,0,4,376158,187258,188900,7354,7354,0,,,19/1/2022 7:23
8/4/2021,Udon Thani,7,20,1567503,776622,790881,39172,39152,20,,,19/1/2022 7:23
8/4/2021,Uttaradit,0,6,447754,218285,229469,47493,47493,0,,,19/1/2022 7:23
8/4/2021,Uthai Thani,0,1,325542,159106,166436,61633,61633,0,,,19/1/2022 7:23
8/4/2021,Ubon Ratchathani,0,19,1866247,931793,934454,115331,115317,14,151,56,19/1/2022 7:23
8/4/2021,Ang Thong,0,124,275944,132088,143856,35544,35544,0,,,19/1/2022 7:23
8/4/2021,Chiang Rai,1,75,1295958,630131,665827,132092,131542,550,62,36,19/1/2022 7:23
8/4/2021,Chiang Mai,6,77,1785706,863274,922432,396241,392204,4037,68,46,19/1/2022 7:23
8/4/2021,Phetchaburi,0,92,482292,232840,249452,385714,385488,226,,,19/1/2022 7:23
8/4/2021,Phetchabun,0,4,980662,483966,496696,95174,94812,362,,,19/1/2022 7:23
8/4/2021,Loei,0,13,638441,319953,318488,50148,50126,22,40,36,19/1/2022 7:23
8/4/2021,Phrae,0,1,436290,210317,225973,62210,62067,143,55,29,19/1/2022 7:23
8/4/2021,Mae Hong Son,0,5,285552,144717,140835,42084,41573,511,101,48,19/1/2022 7:23
8/4/2021,,0,12,,,,,,,,,19/1/2022 7:23
9/4/2021,Krabi,0,27,478376,237526,240850,100764,99754,1010,,,19/1/2022 7:23
9/4/2021,Bangkok,272,5770,5574497,2617639,2956858,1115611,1063854,51757,74,49,19/1/2022 7:23
9/4/2021,Kanchanaburi,1,18,892843,448201,444642,243519,243308,211,31,20,19/1/2022 7:23
9/4/2021,Kalasin,0,4,976734,482933,493801,12687,12687,0,,,19/1/2022 7:23
9/4/2021,Kamphaeng Phet,0,2,713471,352392,361079,39769,39688,81,,,19/1/2022 7:23
9/4/2021,Khon Kaen,6,33,1793256,881683,911573,57354,57291,63,102,53,19/1/2022 7:23
9/4/2021,Chanthaburi,5,230,535634,261945,273689,116001,115931,70,,,19/1/2022 7:23
9/4/2021,Chachoengsao,2,48,721596,353738,367858,29877,29877,0,80,42,19/1/2022 7:23
9/4/2021,Chon Buri,48,1615,1572004,766532,805472,156392,155350,1042,74,39,19/1/2022 7:23
9/4/2021,Chai Nat,0,11,321758,154645,167113,31521,31521,0,,,19/1/2022 7:23
9/4/2021,Chaiyaphum,2,18,1123903,555222,568681,40561,40512,49,,,19/1/2022 7:23
9/4/2021,Chumphon,5,31,509518,251414,258104,61047,60995,52,,,19/1/2022 7:23
9/4/2021,Trang,0,12,640411,313222,327189,40640,40547,93,,,19/1/2022 7:23
9/4/2021,Trat,1,34,228569,113072,115497,137616,137392,224,,,19/1/2022 7:23
9/4/2021,Tak,0,327,672976,340316,332660,59385,59312,73,,,19/1/2022 7:23
9/4/2021,Nakhon Nayok,0,18,259750,128155,131595,76708,76708,0,,,19/1/2022 7:23
9/4/2021,Nakhon Pathom,1,210,922448,443178,479270,98319,98268,51,54,29,19/1/2022 7:23
9/4/2021,Nakhon Phanom,0,3,716791,357234,359557,27584,27557,27,,,19/1/2022 7:23
9/4/2021,Nakhon Ratchasima,6,38,2633610,1294642,1338968,314682,313761,921,98,51,19/1/2022 7:23
9/4/2021,Nakhon Si Thammarat,0,17,1550947,765252,785695,108124,107604,520,,,19/1/2022 7:23
9/4/2021,Nakhon Sawan,1,16,1038712,506804,531908,115116,115001,115,128,46,19/1/2022 7:23
9/4/2021,Nonthaburi,7,511,1281245,596307,684938,33945,33820,125,64,39,19/1/2022 7:23
9/4/2021,Narathiwat,0,341,806698,398996,407702,12366,12366,0,66,34,19/1/2022 7:23
9/4/2021,Nan,1,2,476372,238449,237923,60575,60465,110,,,19/1/2022 7:23
9/4/2021,Bueng Kan,0,0,422066,211554,210512,5420,5420,0,,,19/1/2022 7:23
9/4/2021,Buri Ram,8,25,1580079,784198,795881,38966,38860,106,,,19/1/2022 7:23
9/4/2021,Pathum Thani,10,845,1180730,559573,621157,17584,17443,141,81,35,19/1/2022 7:23
9/4/2021,Prachuap Khiri Khan,30,77,551205,272975,278230,275365,275243,122,,,19/1/2022 7:23
9/4/2021,Prachin Buri,0,22,494574,244431,250143,62857,62857,0,81,38,19/1/2022 7:23
9/4/2021,Pattani,0,97,727686,359470,368216,11318,11318,0,,,19/1/2022 7:23
9/4/2021,Phra Nakhon Si Ayutthaya,1,74,819654,393768,425886,230549,229807,742,78,64,19/1/2022 7:23
9/4/2021,Phayao,0,4,466174,226975,239199,34541,34442,99,72,27,19/1/2022 7:23
9/4/2021,Phang-nga,0,2,268508,133879,134629,132253,130614,1639,,,19/1/2022 7:23
9/4/2021,Phatthalung,0,17,523116,254885,268231,50714,50714,0,,,19/1/2022 7:23
9/4/2021,Phichit,0,10,531541,259263,272278,52325,52325,0,,,19/1/2022 7:23
9/4/2021,Phitsanulok,2,13,848043,415270,432773,150029,149890,139,,,19/1/2022 7:23
9/4/2021,Phuket,6,241,413242,195176,218066,185057,183877,1180,73,38,19/1/2022 7:23
9/4/2021,Maha Sarakham,1,23,951507,466454,485053,12276,12276,0,,,19/1/2022 7:23
9/4/2021,Mukdahan,0,6,350834,175233,175601,29874,29874,0,,,19/1/2022 7:23
9/4/2021,Yala,0,152,539921,268685,271236,29789,29789,0,68,40,19/1/2022 7:23
9/4/2021,Yasothon,0,3,534065,266640,267425,23761,23761,0,,,19/1/2022 7:23
9/4/2021,Ranong,0,1,194741,98300,96441,52522,52361,161,,,19/1/2022 7:23
9/4/2021,Rayong,6,610,744962,365850,379112,102268,101970,298,70,36,19/1/2022 7:23
9/4/2021,Ratchaburi,4,63,869447,422955,446492,42340,42325,15,,,19/1/2022 7:23
9/4/2021,Roi Et,0,4,1297612,643180,654432,9529,9529,0,,,19/1/2022 7:23
9/4/2021,Lop Buri,3,28,741974,370517,371457,54769,54707,62,,,19/1/2022 7:23
9/4/2021,Lampang,1,10,727166,354266,372900,88127,87577,550,60,31,19/1/2022 7:23
9/4/2021,Lamphun,0,6,401750,193199,208551,70522,70337,185,,,19/1/2022 7:23
9/4/2021,Si Sa Ket,0,9,1457730,725631,732099,15523,15523,0,,,19/1/2022 7:23
9/4/2021,Sakon Nakhon,0,1,1146692,569813,576879,27390,27375,15,,,19/1/2022 7:23
9/4/2021,Songkhla,5,157,1429058,696568,732490,69929,69891,38,72,40,19/1/2022 7:23
9/4/2021,Satun,0,24,324321,161388,162933,73143,72554,589,69,35,19/1/2022 7:23
9/4/2021,Samut Prakarn,51,973,1354390,645522,708868,27501,27263,238,,,19/1/2022 7:23
9/4/2021,Samut Songkhram,2,78,191749,91610,100139,126386,126314,72,39,13,19/1/2022 7:23
9/4/2021,Samut Sakhon,9,17214,586317,282574,303743,6690,6639,51,84,40,19/1/2022 7:23
9/4/2021,Saraburi,2,26,644230,316852,327378,96839,96724,115,107,106,19/1/2022 7:23
9/4/2021,Sa kaeo,16,68,561071,280075,280996,23441,23441,0,56,36,19/1/2022 7:23
9/4/2021,Sing Buri,0,17,205427,97606,107821,17847,17847,0,,,19/1/2022 7:23
9/4/2021,Suphan Buri,0,70,837370,404033,433337,72907,72907,0,,,19/1/2022 7:23
9/4/2021,Surat Thani,4,40,1068273,526182,542091,65669,65132,537,92,45,19/1/2022 7:23
9/4/2021,Surin,0,14,1377326,685192,692134,24004,23993,11,,,19/1/2022 7:23
9/4/2021,Sukhothai,0,5,586830,284310,302520,56642,55966,676,,,19/1/2022 7:23
9/4/2021,Nong Khai,0,5,517147,256546,260601,20943,20864,79,39,15,19/1/2022 7:23
9/4/2021,Nong Bua Lam Phu,0,6,509129,253956,255173,4947,4947,0,,,19/1/2022 7:23
9/4/2021,Amnat Charoen,0,4,376158,187258,188900,7354,7354,0,,,19/1/2022 7:23
9/4/2021,Udon Thani,10,30,1567503,776622,790881,39172,39152,20,,,19/1/2022 7:23
9/4/2021,Uttaradit,0,6,447754,218285,229469,47493,47493,0,,,19/1/2022 7:23
9/4/2021,Uthai Thani,0,1,325542,159106,166436,61633,61633,0,,,19/1/2022 7:23
9/4/2021,Ubon Ratchathani,6,25,1866247,931793,934454,115331,115317,14,127,49,19/1/2022 7:23
9/4/2021,Ang Thong,0,124,275944,132088,143856,35544,35544,0,,,19/1/2022 7:23
9/4/2021,Chiang Rai,2,77,1295958,630131,665827,132092,131542,550,92,34,19/1/2022 7:23
9/4/2021,Chiang Mai,16,93,1785706,863274,922432,396241,392204,4037,89,40,19/1/2022 7:23
9/4/2021,Phetchaburi,4,96,482292,232840,249452,385714,385488,226,,,19/1/2022 7:23
9/4/2021,Phetchabun,2,6,980662,483966,496696,95174,94812,362,,,19/1/2022 7:23
9/4/2021,Loei,0,13,638441,319953,318488,50148,50126,22,62,49,19/1/2022 7:23
9/4/2021,Phrae,0,1,436290,210317,225973,62210,62067,143,64,29,19/1/2022 7:23
9/4/2021,Mae Hong Son,0,5,285552,144717,140835,42084,41573,511,122,45,19/1/2022 7:23
9/4/2021,,0,12,,,,,,,,,19/1/2022 7:23
10/4/2021,Krabi,2,29,478376,237526,240850,100764,99754,1010,,,19/1/2022 7:23
10/4/2021,Bangkok,188,5958,5574497,2617639,2956858,1115611,1063854,51757,90,42,19/1/2022 7:23
10/4/2021,Kanchanaburi,1,19,892843,448201,444642,243519,243308,211,32,23,19/1/2022 7:23
10/4/2021,Kalasin,0,4,976734,482933,493801,12687,12687,0,,,19/1/2022 7:23
10/4/2021,Kamphaeng Phet,2,4,713471,352392,361079,39769,39688,81,,,19/1/2022 7:23
10/4/2021,Khon Kaen,5,38,1793256,881683,911573,57354,57291,63,98,43,19/1/2022 7:23
10/4/2021,Chanthaburi,3,233,535634,261945,273689,116001,115931,70,,,19/1/2022 7:23
10/4/2021,Chachoengsao,6,54,721596,353738,367858,29877,29877,0,70,42,19/1/2022 7:23
10/4/2021,Chon Buri,103,1718,1572004,766532,805472,156392,155350,1042,78,35,19/1/2022 7:23
10/4/2021,Chai Nat,0,11,321758,154645,167113,31521,31521,0,,,19/1/2022 7:23
10/4/2021,Chaiyaphum,0,18,1123903,555222,568681,40561,40512,49,,,19/1/2022 7:23
10/4/2021,Chumphon,3,34,509518,251414,258104,61047,60995,52,,,19/1/2022 7:23
10/4/2021,Trang,0,12,640411,313222,327189,40640,40547,93,,,19/1/2022 7:23
10/4/2021,Trat,3,37,228569,113072,115497,137616,137392,224,,,19/1/2022 7:23
10/4/2021,Tak,1,328,672976,340316,332660,59385,59312,73,,,19/1/2022 7:23
10/4/2021,Nakhon Nayok,3,21,259750,128155,131595,76708,76708,0,,,19/1/2022 7:23
10/4/2021,Nakhon Pathom,15,225,922448,443178,479270,98319,98268,51,66,33,19/1/2022 7:23
10/4/2021,Nakhon Phanom,1,4,716791,357234,359557,27584,27557,27,,,19/1/2022 7:23
10/4/2021,Nakhon Ratchasima,10,48,2633610,1294642,1338968,314682,313761,921,110,47,19/1/2022 7:23
10/4/2021,Nakhon Si Thammarat,3,20,1550947,765252,785695,108124,107604,520,,,19/1/2022 7:23
10/4/2021,Nakhon Sawan,2,18,1038712,506804,531908,115116,115001,115,86,44,19/1/2022 7:23
10/4/2021,Nonthaburi,3,514,1281245,596307,684938,33945,33820,125,75,31,19/1/2022 7:23
10/4/2021,Narathiwat,18,359,806698,398996,407702,12366,12366,0,74,35,19/1/2022 7:23
10/4/2021,Nan,3,5,476372,238449,237923,60575,60465,110,,,19/1/2022 7:23
10/4/2021,Bueng Kan,0,0,422066,211554,210512,5420,5420,0,,,19/1/2022 7:23
10/4/2021,Buri Ram,1,26,1580079,784198,795881,38966,38860,106,,,19/1/2022 7:23
10/4/2021,Pathum Thani,11,856,1180730,559573,621157,17584,17443,141,88,30,19/1/2022 7:23
10/4/2021,Prachuap Khiri Khan,40,117,551205,272975,278230,275365,275243,122,,,19/1/2022 7:23
10/4/2021,Prachin Buri,3,25,494574,244431,250143,62857,62857,0,85,43,19/1/2022 7:23
10/4/2021,Pattani,0,97,727686,359470,368216,11318,11318,0,,,19/1/2022 7:23
10/4/2021,Phra Nakhon Si Ayutthaya,3,77,819654,393768,425886,230549,229807,742,94,63,19/1/2022 7:23
10/4/2021,Phayao,3,7,466174,226975,239199,34541,34442,99,60,31,19/1/2022 7:23
10/4/2021,Phang-nga,0,2,268508,133879,134629,132253,130614,1639,,,19/1/2022 7:23
10/4/2021,Phatthalung,0,17,523116,254885,268231,50714,50714,0,,,19/1/2022 7:23
10/4/2021,Phichit,1,11,531541,259263,272278,52325,52325,0,,,19/1/2022 7:23
10/4/2021,Phitsanulok,0,13,848043,415270,432773,150029,149890,139,,,19/1/2022 7:23
10/4/2021,Phuket,4,245,413242,195176,218066,185057,183877,1180,83,37,19/1/2022 7:23
10/4/2021,Maha Sarakham,0,23,951507,466454,485053,12276,12276,0,,,19/1/2022 7:23
10/4/2021,Mukdahan,1,7,350834,175233,175601,29874,29874,0,,,19/1/2022 7:23
10/4/2021,Yala,0,152,539921,268685,271236,29789,29789,0,73,38,19/1/2022 7:23
10/4/2021,Yasothon,2,5,534065,266640,267425,23761,23761,0,,,19/1/2022 7:23
10/4/2021,Ranong,0,1,194741,98300,96441,52522,52361,161,,,19/1/2022 7:23
10/4/2021,Rayong,10,620,744962,365850,379112,102268,101970,298,76,32,19/1/2022 7:23
10/4/2021,Ratchaburi,2,65,869447,422955,446492,42340,42325,15,,,19/1/2022 7:23
10/4/2021,Roi Et,3,7,1297612,643180,654432,9529,9529,0,,,19/1/2022 7:23
10/4/2021,Lop Buri,1,29,741974,370517,371457,54769,54707,62,,,19/1/2022 7:23
10/4/2021,Lampang,6,16,727166,354266,372900,88127,87577,550,49,73,19/1/2022 7:23
10/4/2021,Lamphun,2,8,401750,193199,208551,70522,70337,185,,,19/1/2022 7:23
10/4/2021,Si Sa Ket,0,9,1457730,725631,732099,15523,15523,0,,,19/1/2022 7:23
10/4/2021,Sakon Nakhon,1,2,1146692,569813,576879,27390,27375,15,,,19/1/2022 7:23
10/4/2021,Songkhla,10,167,1429058,696568,732490,69929,69891,38,76,41,19/1/2022 7:23
10/4/2021,Satun,0,24,324321,161388,162933,73143,72554,589,75,23,19/1/2022 7:23
10/4/2021,Samut Prakarn,75,1048,1354390,645522,708868,27501,27263,238,,,19/1/2022 7:23
10/4/2021,Samut Songkhram,1,79,191749,91610,100139,126386,126314,72,35,16,19/1/2022 7:23
10/4/2021,Samut Sakhon,8,17222,586317,282574,303743,6690,6639,51,96,26,19/1/2022 7:23
10/4/2021,Saraburi,2,28,644230,316852,327378,96839,96724,115,115,85,19/1/2022 7:23
10/4/2021,Sa kaeo,11,79,561071,280075,280996,23441,23441,0,75,30,19/1/2022 7:23
10/4/2021,Sing Buri,0,17,205427,97606,107821,17847,17847,0,,,19/1/2022 7:23
10/4/2021,Suphan Buri,4,74,837370,404033,433337,72907,72907,0,,,19/1/2022 7:23
10/4/2021,Surat Thani,4,44,1068273,526182,542091,65669,65132,537,86,48,19/1/2022 7:23
10/4/2021,Surin,1,15,1377326,685192,692134,24004,23993,11,,,19/1/2022 7:23
10/4/2021,Sukhothai,0,5,586830,284310,302520,56642,55966,676,,,19/1/2022 7:23
10/4/2021,Nong Khai,1,6,517147,256546,260601,20943,20864,79,39,15,19/1/2022 7:23
10/4/2021,Nong Bua Lam Phu,1,7,509129,253956,255173,4947,4947,0,,,19/1/2022 7:23
10/4/2021,Amnat Charoen,2,6,376158,187258,188900,7354,7354,0,,,19/1/2022 7:23
10/4/2021,Udon Thani,1,31,1567503,776622,790881,39172,39152,20,,,19/1/2022 7:23
10/4/2021,Uttaradit,1,7,447754,218285,229469,47493,47493,0,,,19/1/2022 7:23
10/4/2021,Uthai Thani,5,6,325542,159106,166436,61633,61633,0,,,19/1/2022 7:23
10/4/2021,Ubon Ratchathani,2,27,1866247,931793,934454,115331,115317,14,105,38,19/1/2022 7:23
10/4/2021,Ang Thong,0,124,275944,132088,143856,35544,35544,0,,,19/1/2022 7:23
10/4/2021,Chiang Rai,10,87,1295958,630131,665827,132092,131542,550,86,25,19/1/2022 7:23
10/4/2021,Chiang Mai,168,261,1785706,863274,922432,396241,392204,4037,83,29,19/1/2022 7:23
10/4/2021,Phetchaburi,4,100,482292,232840,249452,385714,385488,226,,,19/1/2022 7:23
10/4/2021,Phetchabun,2,8,980662,483966,496696,95174,94812,362,,,19/1/2022 7:23
10/4/2021,Loei,2,15,638441,319953,318488,50148,50126,22,75,55,19/1/2022 7:23
10/4/2021,Phrae,5,6,436290,210317,225973,62210,62067,143,63,37,19/1/2022 7:23
10/4/2021,Mae Hong Son,0,5,285552,144717,140835,42084,41573,511,116,37,19/1/2022 7:23
10/4/2021,,0,12,,,,,,,,,19/1/2022 7:23
11/4/2021,Krabi,1,30,478376,237526,240850,100764,99754,1010,,,19/1/2022 7:23
11/4/2021,Bangkok,236,6194,5574497,2617639,2956858,1115611,1063854,51757,85,44,19/1/2022 7:23
11/4/2021,Kanchanaburi,1,20,892843,448201,444642,243519,243308,211,58,18,19/1/2022 7:23
11/4/2021,Kalasin,0,4,976734,482933,493801,12687,12687,0,,,19/1/2022 7:23
11/4/2021,Kamphaeng Phet,1,5,713471,352392,361079,39769,39688,81,,,19/1/2022 7:23
11/4/2021,Khon Kaen,6,44,1793256,881683,911573,57354,57291,63,81,54,19/1/2022 7:23
11/4/2021,Chanthaburi,1,234,535634,261945,273689,116001,115931,70,,,19/1/2022 7:23
11/4/2021,Chachoengsao,2,56,721596,353738,367858,29877,29877,0,74,41,19/1/2022 7:23
11/4/2021,Chon Buri,181,1899,1572004,766532,805472,156392,155350,1042,67,32,19/1/2022 7:23
11/4/2021,Chai Nat,2,13,321758,154645,167113,31521,31521,0,,,19/1/2022 7:23
11/4/2021,Chaiyaphum,0,18,1123903,555222,568681,40561,40512,49,,,19/1/2022 7:23
11/4/2021,Chumphon,1,35,509518,251414,258104,61047,60995,52,,,19/1/2022 7:23
11/4/2021,Trang,1,13,640411,313222,327189,40640,40547,93,,,19/1/2022 7:23
11/4/2021,Trat,5,42,228569,113072,115497,137616,137392,224,,,19/1/2022 7:23
11/4/2021,Tak,1,329,672976,340316,332660,59385,59312,73,,,19/1/2022 7:23
11/4/2021,Nakhon Nayok,2,23,259750,128155,131595,76708,76708,0,,,19/1/2022 7:23
11/4/2021,Nakhon Pathom,10,235,922448,443178,479270,98319,98268,51,78,33,19/1/2022 7:23
11/4/2021,Nakhon Phanom,0,4,716791,357234,359557,27584,27557,27,,,19/1/2022 7:23
11/4/2021,Nakhon Ratchasima,0,48,2633610,1294642,1338968,314682,313761,921,99,42,19/1/2022 7:23
11/4/2021,Nakhon Si Thammarat,1,21,1550947,765252,785695,108124,107604,520,,,19/1/2022 7:23
11/4/2021,Nakhon Sawan,4,22,1038712,506804,531908,115116,115001,115,72,50,19/1/2022 7:23
11/4/2021,Nonthaburi,19,533,1281245,596307,684938,33945,33820,125,68,29,19/1/2022 7:23
11/4/2021,Narathiwat,4,363,806698,398996,407702,12366,12366,0,74,32,19/1/2022 7:23
11/4/2021,Nan,0,5,476372,238449,237923,60575,60465,110,,,19/1/2022 7:23
11/4/2021,Bueng Kan,1,1,422066,211554,210512,5420,5420,0,,,19/1/2022 7:23
11/4/2021,Buri Ram,4,30,1580079,784198,795881,38966,38860,106,,,19/1/2022 7:23
11/4/2021,Pathum Thani,26,882,1180730,559573,621157,17584,17443,141,80,26,19/1/2022 7:23
11/4/2021,Prachuap Khiri Khan,49,166,551205,272975,278230,275365,275243,122,,,19/1/2022 7:23
11/4/2021,Prachin Buri,2,27,494574,244431,250143,62857,62857,0,90,39,19/1/2022 7:23
11/4/2021,Pattani,0,97,727686,359470,368216,11318,11318,0,,,19/1/2022 7:23
11/4/2021,Phra Nakhon Si Ayutthaya,5,82,819654,393768,425886,230549,229807,742,102,56,19/1/2022 7:23
11/4/2021,Phayao,1,8,466174,226975,239199,34541,34442,99,74,39,19/1/2022 7:23
11/4/2021,Phang-nga,0,2,268508,133879,134629,132253,130614,1639,,,19/1/2022 7:23
11/4/2021,Phatthalung,2,19,523116,254885,268231,50714,50714,0,,,19/1/2022 7:23
11/4/2021,Phichit,0,11,531541,259263,272278,52325,52325,0,,,19/1/2022 7:23
11/4/2021,Phitsanulok,1,14,848043,415270,432773,150029,149890,139,,,19/1/2022 7:23
11/4/2021,Phuket,29,274,413242,195176,218066,185057,183877,1180,82,33,19/1/2022 7:23
11/4/2021,Maha Sarakham,3,26,951507,466454,485053,12276,12276,0,,,19/1/2022 7:23
11/4/2021,Mukdahan,0,7,350834,175233,175601,29874,29874,0,,,19/1/2022 7:23
11/4/2021,Yala,0,152,539921,268685,271236,29789,29789,0,72,32,19/1/2022 7:23
11/4/2021,Yasothon,1,6,534065,266640,267425,23761,23761,0,,,19/1/2022 7:23
11/4/2021,Ranong,0,1,194741,98300,96441,52522,52361,161,,,19/1/2022 7:23
11/4/2021,Rayong,9,629,744962,365850,379112,102268,101970,298,69,35,19/1/2022 7:23
11/4/2021,Ratchaburi,5,70,869447,422955,446492,42340,42325,15,,,19/1/2022 7:23
11/4/2021,Roi Et,0,7,1297612,643180,654432,9529,9529,0,,,19/1/2022 7:23
11/4/2021,Lop Buri,1,30,741974,370517,371457,54769,54707,62,,,19/1/2022 7:23
11/4/2021,Lampang,0,16,727166,354266,372900,88127,87577,550,64,39,19/1/2022 7:23
11/4/2021,Lamphun,0,8,401750,193199,208551,70522,70337,185,,,19/1/2022 7:23
11/4/2021,Si Sa Ket,1,10,1457730,725631,732099,15523,15523,0,,,19/1/2022 7:23
11/4/2021,Sakon Nakhon,2,4,1146692,569813,576879,27390,27375,15,,,19/1/2022 7:23
11/4/2021,Songkhla,6,173,1429058,696568,732490,69929,69891,38,79,29,19/1/2022 7:23
11/4/2021,Satun,0,24,324321,161388,162933,73143,72554,589,67,24,19/1/2022 7:23
11/4/2021,Samut Prakarn,49,1097,1354390,645522,708868,27501,27263,238,,,19/1/2022 7:23
11/4/2021,Samut Songkhram,1,80,191749,91610,100139,126386,126314,72,43,16,19/1/2022 7:23
11/4/2021,Samut Sakhon,8,17230,586317,282574,303743,6690,6639,51,83,27,19/1/2022 7:23
11/4/2021,Saraburi,23,51,644230,316852,327378,96839,96724,115,114,66,19/1/2022 7:23
11/4/2021,Sa kaeo,12,91,561071,280075,280996,23441,23441,0,70,25,19/1/2022 7:23
11/4/2021,Sing Buri,0,17,205427,97606,107821,17847,17847,0,,,19/1/2022 7:23
11/4/2021,Suphan Buri,6,80,837370,404033,433337,72907,72907,0,,,19/1/2022 7:23
11/4/2021,Surat Thani,3,47,1068273,526182,542091,65669,65132,537,82,43,19/1/2022 7:23
11/4/2021,Surin,0,15,1377326,685192,692134,24004,23993,11,,,19/1/2022 7:23
11/4/2021,Sukhothai,2,7,586830,284310,302520,56642,55966,676,,,19/1/2022 7:23
11/4/2021,Nong Khai,2,8,517147,256546,260601,20943,20864,79,37,13,19/1/2022 7:23
11/4/2021,Nong Bua Lam Phu,1,8,509129,253956,255173,4947,4947,0,,,19/1/2022 7:23
11/4/2021,Amnat Charoen,0,6,376158,187258,188900,7354,7354,0,,,19/1/2022 7:23
11/4/2021,Udon Thani,6,37,1567503,776622,790881,39172,39152,20,,,19/1/2022 7:23
11/4/2021,Uttaradit,3,10,447754,218285,229469,47493,47493,0,,,19/1/2022 7:23
11/4/2021,Uthai Thani,1,7,325542,159106,166436,61633,61633,0,,,19/1/2022 7:23
11/4/2021,Ubon Ratchathani,8,35,1866247,931793,934454,115331,115317,14,84,45,19/1/2022 7:23
11/4/2021,Ang Thong,4,128,275944,132088,143856,35544,35544,0,,,19/1/2022 7:23
11/4/2021,Chiang Rai,6,93,1295958,630131,665827,132092,131542,550,73,31,19/1/2022 7:23
11/4/2021,Chiang Mai,189,450,1785706,863274,922432,396241,392204,4037,65,35,19/1/2022 7:23
11/4/2021,Phetchaburi,10,110,482292,232840,249452,385714,385488,226,,,19/1/2022 7:23
11/4/2021,Phetchabun,3,11,980662,483966,496696,95174,94812,362,,,19/1/2022 7:23
11/4/2021,Loei,1,16,638441,319953,318488,50148,50126,22,81,46,19/1/2022 7:23
11/4/2021,Phrae,0,6,436290,210317,225973,62210,62067,143,75,37,19/1/2022 7:23
11/4/2021,Mae Hong Son,2,7,285552,144717,140835,42084,41573,511,101,33,19/1/2022 7:23
11/4/2021,,0,12,,,,,,,,,19/1/2022 7:23
12/4/2021,Krabi,1,31,478376,237526,240850,100764,99754,1010,,,19/1/2022 7:23
12/4/2021,Bangkok,142,6336,5574497,2617639,2956858,1115611,1063854,51757,86,34,19/1/2022 7:23
12/4/2021,Kanchanaburi,13,33,892843,448201,444642,243519,243308,211,42,15,19/1/2022 7:23
12/4/2021,Kalasin,1,5,976734,482933,493801,12687,12687,0,,,19/1/2022 7:23
12/4/2021,Kamphaeng Phet,2,7,713471,352392,361079,39769,39688,81,,,19/1/2022 7:23
12/4/2021,Khon Kaen,9,53,1793256,881683,911573,57354,57291,63,105,51,19/1/2022 7:23
12/4/2021,Chanthaburi,8,242,535634,261945,273689,116001,115931,70,,,19/1/2022 7:23
12/4/2021,Chachoengsao,10,66,721596,353738,367858,29877,29877,0,66,38,19/1/2022 7:23
12/4/2021,Chon Buri,92,1991,1572004,766532,805472,156392,155350,1042,62,30,19/1/2022 7:23
12/4/2021,Chai Nat,0,13,321758,154645,167113,31521,31521,0,,,19/1/2022 7:23
12/4/2021,Chaiyaphum,0,18,1123903,555222,568681,40561,40512,49,,,19/1/2022 7:23
12/4/2021,Chumphon,1,36,509518,251414,258104,61047,60995,52,,,19/1/2022 7:23
12/4/2021,Trang,1,14,640411,313222,327189,40640,40547,93,,,19/1/2022 7:23
12/4/2021,Trat,1,43,228569,113072,115497,137616,137392,224,,,19/1/2022 7:23
12/4/2021,Tak,2,331,672976,340316,332660,59385,59312,73,,,19/1/2022 7:23
12/4/2021,Nakhon Nayok,1,24,259750,128155,131595,76708,76708,0,,,19/1/2022 7:23
12/4/2021,Nakhon Pathom,17,252,922448,443178,479270,98319,98268,51,69,25,19/1/2022 7:23
12/4/2021,Nakhon Phanom,0,4,716791,357234,359557,27584,27557,27,,,19/1/2022 7:23
12/4/2021,Nakhon Ratchasima,1,49,2633610,1294642,1338968,314682,313761,921,94,41,19/1/2022 7:23
12/4/2021,Nakhon Si Thammarat,1,22,1550947,765252,785695,108124,107604,520,,,19/1/2022 7:23
12/4/2021,Nakhon Sawan,8,30,1038712,506804,531908,115116,115001,115,73,44,19/1/2022 7:23
12/4/2021,Nonthaburi,2,535,1281245,596307,684938,33945,33820,125,60,24,19/1/2022 7:23
12/4/2021,Narathiwat,1,364,806698,398996,407702,12366,12366,0,72,28,19/1/2022 7:23
12/4/2021,Nan,0,5,476372,238449,237923,60575,60465,110,,,19/1/2022 7:23
12/4/2021,Bueng Kan,1,2,422066,211554,210512,5420,5420,0,,,19/1/2022 7:23
12/4/2021,Buri Ram,7,37,1580079,784198,795881,38966,38860,106,,,19/1/2022 7:23
12/4/2021,Pathum Thani,36,918,1180730,559573,621157,17584,17443,141,69,20,19/1/2022 7:23
12/4/2021,Prachuap Khiri Khan,52,218,551205,272975,278230,275365,275243,122,,,19/1/2022 7:23
12/4/2021,Prachin Buri,6,33,494574,244431,250143,62857,62857,0,84,31,19/1/2022 7:23
12/4/2021,Pattani,3,100,727686,359470,368216,11318,11318,0,,,19/1/2022 7:23
12/4/2021,Phra Nakhon Si Ayutthaya,18,100,819654,393768,425886,230549,229807,742,79,46,19/1/2022 7:23
12/4/2021,Phayao,0,8,466174,226975,239199,34541,34442,99,87,33,19/1/2022 7:23
12/4/2021,Phang-nga,4,6,268508,133879,134629,132253,130614,1639,,,19/1/2022 7:23
12/4/2021,Phatthalung,0,19,523116,254885,268231,50714,50714,0,,,19/1/2022 7:23
12/4/2021,Phichit,2,13,531541,259263,272278,52325,52325,0,,,19/1/2022 7:23
12/4/2021,Phitsanulok,6,20,848043,415270,432773,150029,149890,139,,,19/1/2022 7:23
12/4/2021,Phuket,16,290,413242,195176,218066,185057,183877,1180,75,29,19/1/2022 7:23
12/4/2021,Maha Sarakham,2,28,951507,466454,485053,12276,12276,0,,,19/1/2022 7:23
12/4/2021,Mukdahan,1,8,350834,175233,175601,29874,29874,0,,,19/1/2022 7:23
12/4/2021,Yala,0,152,539921,268685,271236,29789,29789,0,62,25,19/1/2022 7:23
12/4/2021,Yasothon,1,7,534065,266640,267425,23761,23761,0,,,19/1/2022 7:23
12/4/2021,Ranong,0,1,194741,98300,96441,52522,52361,161,,,19/1/2022 7:23
12/4/2021,Rayong,31,660,744962,365850,379112,102268,101970,298,73,30,19/1/2022 7:23
12/4/2021,Ratchaburi,7,77,869447,422955,446492,42340,42325,15,,,19/1/2022 7:23
12/4/2021,Roi Et,3,10,1297612,643180,654432,9529,9529,0,,,19/1/2022 7:23
12/4/2021,Lop Buri,6,36,741974,370517,371457,54769,54707,62,,,19/1/2022 7:23
12/4/2021,Lampang,0,16,727166,354266,372900,88127,87577,550,73,35,19/1/2022 7:23
12/4/2021,Lamphun,8,16,401750,193199,208551,70522,70337,185,,,19/1/2022 7:23
12/4/2021,Si Sa Ket,2,12,1457730,725631,732099,15523,15523,0,,,19/1/2022 7:23
12/4/2021,Sakon Nakhon,1,5,1146692,569813,576879,27390,27375,15,,,19/1/2022 7:23
12/4/2021,Songkhla,4,177,1429058,696568,732490,69929,69891,38,58,30,19/1/2022 7:23
12/4/2021,Satun,0,24,324321,161388,162933,73143,72554,589,61,24,19/1/2022 7:23
12/4/2021,Samut Prakarn,83,1180,1354390,645522,708868,27501,27263,238,,,19/1/2022 7:23
12/4/2021,Samut Songkhram,0,80,191749,91610,100139,126386,126314,72,46,13,19/1/2022 7:23
12/4/2021,Samut Sakhon,25,17255,586317,282574,303743,6690,6639,51,81,19,19/1/2022 7:23
12/4/2021,Saraburi,4,55,644230,316852,327378,96839,96724,115,86,44,19/1/2022 7:23
12/4/2021,Sa kaeo,18,109,561071,280075,280996,23441,23441,0,58,16,19/1/2022 7:23
12/4/2021,Sing Buri,0,17,205427,97606,107821,17847,17847,0,,,19/1/2022 7:23
12/4/2021,Suphan Buri,15,95,837370,404033,433337,72907,72907,0,,,19/1/2022 7:23
12/4/2021,Surat Thani,7,54,1068273,526182,542091,65669,65132,537,79,39,19/1/2022 7:23
12/4/2021,Surin,2,17,1377326,685192,692134,24004,23993,11,,,19/1/2022 7:23
12/4/2021,Sukhothai,1,8,586830,284310,302520,56642,55966,676,,,19/1/2022 7:23
12/4/2021,Nong Khai,2,10,517147,256546,260601,20943,20864,79,35,12,19/1/2022 7:23
12/4/2021,Nong Bua Lam Phu,1,9,509129,253956,255173,4947,4947,0,,,19/1/2022 7:23
12/4/2021,Amnat Charoen,2,8,376158,187258,188900,7354,7354,0,,,19/1/2022 7:23
12/4/2021,Udon Thani,10,47,1567503,776622,790881,39172,39152,20,,,19/1/2022 7:23
12/4/2021,Uttaradit,0,10,447754,218285,229469,47493,47493,0,,,19/1/2022 7:23
12/4/2021,Uthai Thani,0,7,325542,159106,166436,61633,61633,0,,,19/1/2022 7:23
12/4/2021,Ubon Ratchathani,6,41,1866247,931793,934454,115331,115317,14,98,55,19/1/2022 7:23
12/4/2021,Ang Thong,4,132,275944,132088,143856,35544,35544,0,,,19/1/2022 7:23
12/4/2021,Chiang Rai,10,103,1295958,630131,665827,132092,131542,550,84,26,19/1/2022 7:23
12/4/2021,Chiang Mai,246,696,1785706,863274,922432,396241,392204,4037,73,34,19/1/2022 7:23
12/4/2021,Phetchaburi,13,123,482292,232840,249452,385714,385488,226,,,19/1/2022 7:23
12/4/2021,Phetchabun,1,12,980662,483966,496696,95174,94812,362,,,19/1/2022 7:23
12/4/2021,Loei,1,17,638441,319953,318488,50148,50126,22,86,42,19/1/2022 7:23
12/4/2021,Phrae,0,6,436290,210317,225973,62210,62067,143,83,37,19/1/2022 7:23
12/4/2021,Mae Hong Son,3,10,285552,144717,140835,42084,41573,511,94,37,19/1/2022 7:23
12/4/2021,,0,12,,,,,,,,,19/1/2022 7:23
13/4/2021,Krabi,1,32,478376,237526,240850,100764,99754,1010,,,19/1/2022 7:23
13/4/2021,Bangkok,196,6532,5574497,2617639,2956858,1115611,1063854,51757,70,28,19/1/2022 7:23
13/4/2021,Kanchanaburi,0,33,892843,448201,444642,243519,243308,211,36,11,19/1/2022 7:23
13/4/2021,Kalasin,0,5,976734,482933,493801,12687,12687,0,,,19/1/2022 7:23
13/4/2021,Kamphaeng Phet,2,9,713471,352392,361079,39769,39688,81,,,19/1/2022 7:23
13/4/2021,Khon Kaen,12,65,1793256,881683,911573,57354,57291,63,96,47,19/1/2022 7:23
13/4/2021,Chanthaburi,9,251,535634,261945,273689,116001,115931,70,,,19/1/2022 7:23
13/4/2021,Chachoengsao,7,73,721596,353738,367858,29877,29877,0,57,35,19/1/2022 7:23
13/4/2021,Chon Buri,97,2088,1572004,766532,805472,156392,155350,1042,62,25,19/1/2022 7:23
13/4/2021,Chai Nat,0,13,321758,154645,167113,31521,31521,0,,,19/1/2022 7:23
13/4/2021,Chaiyaphum,1,19,1123903,555222,568681,40561,40512,49,,,19/1/2022 7:23
13/4/2021,Chumphon,1,37,509518,251414,258104,61047,60995,52,,,19/1/2022 7:23
13/4/2021,Trang,2,16,640411,313222,327189,40640,40547,93,,,19/1/2022 7:23
13/4/2021,Trat,0,43,228569,113072,115497,137616,137392,224,,,19/1/2022 7:23
13/4/2021,Tak,2,333,672976,340316,332660,59385,59312,73,,,19/1/2022 7:23
13/4/2021,Nakhon Nayok,0,24,259750,128155,131595,76708,76708,0,,,19/1/2022 7:23
13/4/2021,Nakhon Pathom,10,262,922448,443178,479270,98319,98268,51,57,22,19/1/2022 7:23
13/4/2021,Nakhon Phanom,1,5,716791,357234,359557,27584,27557,27,,,19/1/2022 7:23
13/4/2021,Nakhon Ratchasima,67,116,2633610,1294642,1338968,314682,313761,921,82,37,19/1/2022 7:23
13/4/2021,Nakhon Si Thammarat,6,28,1550947,765252,785695,108124,107604,520,,,19/1/2022 7:23
13/4/2021,Nakhon Sawan,3,33,1038712,506804,531908,115116,115001,115,83,37,19/1/2022 7:23
13/4/2021,Nonthaburi,1,536,1281245,596307,684938,33945,33820,125,56,20,19/1/2022 7:23
13/4/2021,Narathiwat,8,372,806698,398996,407702,12366,12366,0,65,22,19/1/2022 7:23
13/4/2021,Nan,0,5,476372,238449,237923,60575,60465,110,,,19/1/2022 7:23
13/4/2021,Bueng Kan,0,2,422066,211554,210512,5420,5420,0,,,19/1/2022 7:23
13/4/2021,Buri Ram,0,37,1580079,784198,795881,38966,38860,106,,,19/1/2022 7:23
13/4/2021,Pathum Thani,21,939,1180730,559573,621157,17584,17443,141,65,21,19/1/2022 7:23
13/4/2021,Prachuap Khiri Khan,72,290,551205,272975,278230,275365,275243,122,,,19/1/2022 7:23
13/4/2021,Prachin Buri,4,37,494574,244431,250143,62857,62857,0,74,36,19/1/2022 7:23
13/4/2021,Pattani,0,100,727686,359470,368216,11318,11318,0,,,19/1/2022 7:23
13/4/2021,Phra Nakhon Si Ayutthaya,5,105,819654,393768,425886,230549,229807,742,66,47,19/1/2022 7:23
13/4/2021,Phayao,0,8,466174,226975,239199,34541,34442,99,80,26,19/1/2022 7:23
13/4/2021,Phang-nga,0,6,268508,133879,134629,132253,130614,1639,,,19/1/2022 7:23
13/4/2021,Phatthalung,0,19,523116,254885,268231,50714,50714,0,,,19/1/2022 7:23
13/4/2021,Phichit,0,13,531541,259263,272278,52325,52325,0,,,19/1/2022 7:23
13/4/2021,Phitsanulok,0,20,848043,415270,432773,150029,149890,139,,,19/1/2022 7:23
13/4/2021,Phuket,8,298,413242,195176,218066,185057,183877,1180,71,23,19/1/2022 7:23
13/4/2021,Maha Sarakham,0,28,951507,466454,485053,12276,12276,0,,,19/1/2022 7:23
13/4/2021,Mukdahan,0,8,350834,175233,175601,29874,29874,0,,,19/1/2022 7:23
13/4/2021,Yala,0,152,539921,268685,271236,29789,29789,0,57,22,19/1/2022 7:23
13/4/2021,Yasothon,1,8,534065,266640,267425,23761,23761,0,,,19/1/2022 7:23
13/4/2021,Ranong,0,1,194741,98300,96441,52522,52361,161,,,19/1/2022 7:23
13/4/2021,Rayong,25,685,744962,365850,379112,102268,101970,298,58,27,19/1/2022 7:23
13/4/2021,Ratchaburi,13,90,869447,422955,446492,42340,42325,15,,,19/1/2022 7:23
13/4/2021,Roi Et,2,12,1297612,643180,654432,9529,9529,0,,,19/1/2022 7:23
13/4/2021,Lop Buri,3,39,741974,370517,371457,54769,54707,62,,,19/1/2022 7:23
13/4/2021,Lampang,1,17,727166,354266,372900,88127,87577,550,62,39,19/1/2022 7:23
13/4/2021,Lamphun,0,16,401750,193199,208551,70522,70337,185,,,19/1/2022 7:23
13/4/2021,Si Sa Ket,1,13,1457730,725631,732099,15523,15523,0,,,19/1/2022 7:23
13/4/2021,Sakon Nakhon,0,5,1146692,569813,576879,27390,27375,15,,,19/1/2022 7:23
13/4/2021,Songkhla,10,187,1429058,696568,732490,69929,69891,38,60,27,19/1/2022 7:23
13/4/2021,Satun,0,24,324321,161388,162933,73143,72554,589,44,18,19/1/2022 7:23
13/4/2021,Samut Prakarn,49,1229,1354390,645522,708868,27501,27263,238,,,19/1/2022 7:23
13/4/2021,Samut Songkhram,0,80,191749,91610,100139,126386,126314,72,39,13,19/1/2022 7:23
13/4/2021,Samut Sakhon,34,17289,586317,282574,303743,6690,6639,51,67,21,19/1/2022 7:23
13/4/2021,Saraburi,3,58,644230,316852,327378,96839,96724,115,71,43,19/1/2022 7:23
13/4/2021,Sa kaeo,11,120,561071,280075,280996,23441,23441,0,32,16,19/1/2022 7:23
13/4/2021,Sing Buri,1,18,205427,97606,107821,17847,17847,0,,,19/1/2022 7:23
13/4/2021,Suphan Buri,8,103,837370,404033,433337,72907,72907,0,,,19/1/2022 7:23
13/4/2021,Surat Thani,4,58,1068273,526182,542091,65669,65132,537,74,35,19/1/2022 7:23
13/4/2021,Surin,1,18,1377326,685192,692134,24004,23993,11,,,19/1/2022 7:23
13/4/2021,Sukhothai,2,10,586830,284310,302520,56642,55966,676,,,19/1/2022 7:23
13/4/2021,Nong Khai,2,12,517147,256546,260601,20943,20864,79,32,13,19/1/2022 7:23
13/4/2021,Nong Bua Lam Phu,0,9,509129,253956,255173,4947,4947,0,,,19/1/2022 7:23
13/4/2021,Amnat Charoen,0,8,376158,187258,188900,7354,7354,0,,,19/1/2022 7:23
13/4/2021,Udon Thani,0,47,1567503,776622,790881,39172,39152,20,,,19/1/2022 7:23
13/4/2021,Uttaradit,0,10,447754,218285,229469,47493,47493,0,,,19/1/2022 7:23
13/4/2021,Uthai Thani,0,7,325542,159106,166436,61633,61633,0,,,19/1/2022 7:23
13/4/2021,Ubon Ratchathani,7,48,1866247,931793,934454,115331,115317,14,121,41,19/1/2022 7:23
13/4/2021,Ang Thong,0,132,275944,132088,143856,35544,35544,0,,,19/1/2022 7:23
13/4/2021,Chiang Rai,0,103,1295958,630131,665827,132092,131542,550,74,25,19/1/2022 7:23
13/4/2021,Chiang Mai,250,946,1785706,863274,922432,396241,392204,4037,76,38,19/1/2022 7:23
13/4/2021,Phetchaburi,0,123,482292,232840,249452,385714,385488,226,,,19/1/2022 7:23
13/4/2021,Phetchabun,1,13,980662,483966,496696,95174,94812,362,,,19/1/2022 7:23
13/4/2021,Loei,0,17,638441,319953,318488,50148,50126,22,69,33,19/1/2022 7:23
13/4/2021,Phrae,0,6,436290,210317,225973,62210,62067,143,84,30,19/1/2022 7:23
13/4/2021,Mae Hong Son,0,10,285552,144717,140835,42084,41573,511,103,44,19/1/2022 7:23
13/4/2021,,0,12,,,,,,,,,19/1/2022 7:23
14/4/2021,Krabi,5,37,478376,237526,240850,100764,99754,1010,,,19/1/2022 7:23
14/4/2021,Bangkok,357,6889,5574497,2617639,2956858,1115611,1063854,51757,61,35,19/1/2022 7:23
14/4/2021,Kanchanaburi,16,49,892843,448201,444642,243519,243308,211,19,15,19/1/2022 7:23
14/4/2021,Kalasin,1,6,976734,482933,493801,12687,12687,0,,,19/1/2022 7:23
14/4/2021,Kamphaeng Phet,2,11,713471,352392,361079,39769,39688,81,,,19/1/2022 7:23
14/4/2021,Khon Kaen,18,83,1793256,881683,911573,57354,57291,63,88,37,19/1/2022 7:23
14/4/2021,Chanthaburi,5,256,535634,261945,273689,116001,115931,70,,,19/1/2022 7:23
14/4/2021,Chachoengsao,16,89,721596,353738,367858,29877,29877,0,59,38,19/1/2022 7:23
14/4/2021,Chon Buri,72,2160,1572004,766532,805472,156392,155350,1042,53,26,19/1/2022 7:23
14/4/2021,Chai Nat,2,15,321758,154645,167113,31521,31521,0,,,19/1/2022 7:23
14/4/2021,Chaiyaphum,1,20,1123903,555222,568681,40561,40512,49,,,19/1/2022 7:23
14/4/2021,Chumphon,3,40,509518,251414,258104,61047,60995,52,,,19/1/2022 7:23
14/4/2021,Trang,1,17,640411,313222,327189,40640,40547,93,,,19/1/2022 7:23
14/4/2021,Trat,0,43,228569,113072,115497,137616,137392,224,,,19/1/2022 7:23
14/4/2021,Tak,1,334,672976,340316,332660,59385,59312,73,,,19/1/2022 7:23
14/4/2021,Nakhon Nayok,0,24,259750,128155,131595,76708,76708,0,,,19/1/2022 7:23
14/4/2021,Nakhon Pathom,20,282,922448,443178,479270,98319,98268,51,55,28,19/1/2022 7:23
14/4/2021,Nakhon Phanom,1,6,716791,357234,359557,27584,27557,27,,,19/1/2022 7:23
14/4/2021,Nakhon Ratchasima,1,117,2633610,1294642,1338968,314682,313761,921,78,33,19/1/2022 7:23
14/4/2021,Nakhon Si Thammarat,3,31,1550947,765252,785695,108124,107604,520,,,19/1/2022 7:23
14/4/2021,Nakhon Sawan,3,36,1038712,506804,531908,115116,115001,115,69,28,19/1/2022 7:23
14/4/2021,Nonthaburi,9,545,1281245,596307,684938,33945,33820,125,47,29,19/1/2022 7:23
14/4/2021,Narathiwat,9,381,806698,398996,407702,12366,12366,0,47,18,19/1/2022 7:23
14/4/2021,Nan,0,5,476372,238449,237923,60575,60465,110,,,19/1/2022 7:23
14/4/2021,Bueng Kan,0,2,422066,211554,210512,5420,5420,0,,,19/1/2022 7:23
14/4/2021,Buri Ram,0,37,1580079,784198,795881,38966,38860,106,,,19/1/2022 7:23
14/4/2021,Pathum Thani,2,941,1180730,559573,621157,17584,17443,141,69,26,19/1/2022 7:23
14/4/2021,Prachuap Khiri Khan,161,451,551205,272975,278230,275365,275243,122,,,19/1/2022 7:23
14/4/2021,Prachin Buri,9,46,494574,244431,250143,62857,62857,0,81,30,19/1/2022 7:23
14/4/2021,Pattani,3,103,727686,359470,368216,11318,11318,0,,,19/1/2022 7:23
14/4/2021,Phra Nakhon Si Ayutthaya,11,116,819654,393768,425886,230549,229807,742,70,53,19/1/2022 7:23
14/4/2021,Phayao,0,8,466174,226975,239199,34541,34442,99,57,27,19/1/2022 7:23
14/4/2021,Phang-nga,3,9,268508,133879,134629,132253,130614,1639,,,19/1/2022 7:23
14/4/2021,Phatthalung,0,19,523116,254885,268231,50714,50714,0,,,19/1/2022 7:23
14/4/2021,Phichit,0,13,531541,259263,272278,52325,52325,0,,,19/1/2022 7:23
14/4/2021,Phitsanulok,3,23,848043,415270,432773,150029,149890,139,,,19/1/2022 7:23
14/4/2021,Phuket,26,324,413242,195176,218066,185057,183877,1180,77,25,19/1/2022 7:23
14/4/2021,Maha Sarakham,7,35,951507,466454,485053,12276,12276,0,,,19/1/2022 7:23
14/4/2021,Mukdahan,0,8,350834,175233,175601,29874,29874,0,,,19/1/2022 7:23
14/4/2021,Yala,0,152,539921,268685,271236,29789,29789,0,53,22,19/1/2022 7:23
14/4/2021,Yasothon,0,8,534065,266640,267425,23761,23761,0,,,19/1/2022 7:23
14/4/2021,Ranong,0,1,194741,98300,96441,52522,52361,161,,,19/1/2022 7:23
14/4/2021,Rayong,11,696,744962,365850,379112,102268,101970,298,56,31,19/1/2022 7:23
14/4/2021,Ratchaburi,14,104,869447,422955,446492,42340,42325,15,,,19/1/2022 7:23
14/4/2021,Roi Et,3,15,1297612,643180,654432,9529,9529,0,,,19/1/2022 7:23
14/4/2021,Lop Buri,0,39,741974,370517,371457,54769,54707,62,,,19/1/2022 7:23
14/4/2021,Lampang,0,17,727166,354266,372900,88127,87577,550,72,35,19/1/2022 7:23
14/4/2021,Lamphun,8,24,401750,193199,208551,70522,70337,185,,,19/1/2022 7:23
14/4/2021,Si Sa Ket,2,15,1457730,725631,732099,15523,15523,0,,,19/1/2022 7:23
14/4/2021,Sakon Nakhon,6,11,1146692,569813,576879,27390,27375,15,,,19/1/2022 7:23
14/4/2021,Songkhla,19,206,1429058,696568,732490,69929,69891,38,59,32,19/1/2022 7:23
14/4/2021,Satun,0,24,324321,161388,162933,73143,72554,589,35,17,19/1/2022 7:23
14/4/2021,Samut Prakarn,44,1273,1354390,645522,708868,27501,27263,238,,,19/1/2022 7:23
14/4/2021,Samut Songkhram,1,81,191749,91610,100139,126386,126314,72,35,13,19/1/2022 7:23
14/4/2021,Samut Sakhon,23,17312,586317,282574,303743,6690,6639,51,58,29,19/1/2022 7:23
14/4/2021,Saraburi,3,61,644230,316852,327378,96839,96724,115,65,57,19/1/2022 7:23
14/4/2021,Sa kaeo,21,141,561071,280075,280996,23441,23441,0,45,16,19/1/2022 7:23
14/4/2021,Sing Buri,0,18,205427,97606,107821,17847,17847,0,,,19/1/2022 7:23
14/4/2021,Suphan Buri,11,114,837370,404033,433337,72907,72907,0,,,19/1/2022 7:23
14/4/2021,Surat Thani,7,65,1068273,526182,542091,65669,65132,537,65,34,19/1/2022 7:23
14/4/2021,Surin,4,22,1377326,685192,692134,24004,23993,11,,,19/1/2022 7:23
14/4/2021,Sukhothai,3,13,586830,284310,302520,56642,55966,676,,,19/1/2022 7:23
14/4/2021,Nong Khai,0,12,517147,256546,260601,20943,20864,79,32,12,19/1/2022 7:23
14/4/2021,Nong Bua Lam Phu,3,12,509129,253956,255173,4947,4947,0,,,19/1/2022 7:23
14/4/2021,Amnat Charoen,0,8,376158,187258,188900,7354,7354,0,,,19/1/2022 7:23
14/4/2021,Udon Thani,32,79,1567503,776622,790881,39172,39152,20,,,19/1/2022 7:23
14/4/2021,Uttaradit,1,11,447754,218285,229469,47493,47493,0,,,19/1/2022 7:23
14/4/2021,Uthai Thani,0,7,325542,159106,166436,61633,61633,0,,,19/1/2022 7:23
14/4/2021,Ubon Ratchathani,17,65,1866247,931793,934454,115331,115317,14,86,31,19/1/2022 7:23
14/4/2021,Ang Thong,0,132,275944,132088,143856,35544,35544,0,,,19/1/2022 7:23
14/4/2021,Chiang Rai,0,103,1295958,630131,665827,132092,131542,550,68,31,19/1/2022 7:23
14/4/2021,Chiang Mai,319,1265,1785706,863274,922432,396241,392204,4037,81,41,19/1/2022 7:23
14/4/2021,Phetchaburi,10,133,482292,232840,249452,385714,385488,226,,,19/1/2022 7:23
14/4/2021,Phetchabun,3,16,980662,483966,496696,95174,94812,362,,,19/1/2022 7:23
14/4/2021,Loei,2,19,638441,319953,318488,50148,50126,22,62,26,19/1/2022 7:23
14/4/2021,Phrae,0,6,436290,210317,225973,62210,62067,143,71,27,19/1/2022 7:23
14/4/2021,Mae Hong Son,0,10,285552,144717,140835,42084,41573,511,117,43,19/1/2022 7:23
14/4/2021,,0,12,,,,,,,,,19/1/2022 7:23
15/4/2021,Krabi,6,43,478376,237526,240850,100764,99754,1010,,,19/1/2022 7:23
15/4/2021,Bangkok,411,7300,5574497,2617639,2956858,1115611,1063854,51757,74,28,19/1/2022 7:23
15/4/2021,Kanchanaburi,5,54,892843,448201,444642,243519,243308,211,17,16,19/1/2022 7:23
15/4/2021,Kalasin,6,12,976734,482933,493801,12687,12687,0,,,19/1/2022 7:23
15/4/2021,Kamphaeng Phet,1,12,713471,352392,361079,39769,39688,81,,,19/1/2022 7:23
15/4/2021,Khon Kaen,18,101,1793256,881683,911573,57354,57291,63,75,44,19/1/2022 7:23
15/4/2021,Chanthaburi,6,262,535634,261945,273689,116001,115931,70,,,19/1/2022 7:23
15/4/2021,Chachoengsao,7,96,721596,353738,367858,29877,29877,0,56,41,19/1/2022 7:23
15/4/2021,Chon Buri,98,2258,1572004,766532,805472,156392,155350,1042,56,26,19/1/2022 7:23
15/4/2021,Chai Nat,0,15,321758,154645,167113,31521,31521,0,,,19/1/2022 7:23
15/4/2021,Chaiyaphum,3,23,1123903,555222,568681,40561,40512,49,,,19/1/2022 7:23
15/4/2021,Chumphon,7,47,509518,251414,258104,61047,60995,52,,,19/1/2022 7:23
15/4/2021,Trang,1,18,640411,313222,327189,40640,40547,93,,,19/1/2022 7:23
15/4/2021,Trat,1,44,228569,113072,115497,137616,137392,224,,,19/1/2022 7:23
15/4/2021,Tak,5,339,672976,340316,332660,59385,59312,73,,,19/1/2022 7:23
15/4/2021,Nakhon Nayok,2,26,259750,128155,131595,76708,76708,0,,,19/1/2022 7:23
15/4/2021,Nakhon Pathom,17,299,922448,443178,479270,98319,98268,51,62,20,19/1/2022 7:23
15/4/2021,Nakhon Phanom,9,15,716791,357234,359557,27584,27557,27,,,19/1/2022 7:23
15/4/2021,Nakhon Ratchasima,0,117,2633610,1294642,1338968,314682,313761,921,70,33,19/1/2022 7:23
15/4/2021,Nakhon Si Thammarat,1,32,1550947,765252,785695,108124,107604,520,,,19/1/2022 7:23
15/4/2021,Nakhon Sawan,36,72,1038712,506804,531908,115116,115001,115,54,39,19/1/2022 7:23
15/4/2021,Nonthaburi,35,580,1281245,596307,684938,33945,33820,125,62,19,19/1/2022 7:23
15/4/2021,Narathiwat,19,400,806698,398996,407702,12366,12366,0,42,22,19/1/2022 7:23
15/4/2021,Nan,0,5,476372,238449,237923,60575,60465,110,,,19/1/2022 7:23
15/4/2021,Bueng Kan,1,3,422066,211554,210512,5420,5420,0,,,19/1/2022 7:23
15/4/2021,Buri Ram,8,45,1580079,784198,795881,38966,38860,106,,,19/1/2022 7:23
15/4/2021,Pathum Thani,38,979,1180730,559573,621157,17584,17443,141,80,18,19/1/2022 7:23
15/4/2021,Prachuap Khiri Khan,98,549,551205,272975,278230,275365,275243,122,,,19/1/2022 7:23
15/4/2021,Prachin Buri,5,51,494574,244431,250143,62857,62857,0,70,37,19/1/2022 7:23
15/4/2021,Pattani,0,103,727686,359470,368216,11318,11318,0,,,19/1/2022 7:23
15/4/2021,Phra Nakhon Si Ayutthaya,25,141,819654,393768,425886,230549,229807,742,67,48,19/1/2022 7:23
15/4/2021,Phayao,0,8,466174,226975,239199,34541,34442,99,67,34,19/1/2022 7:23
15/4/2021,Phang-nga,2,11,268508,133879,134629,132253,130614,1639,,,19/1/2022 7:23
15/4/2021,Phatthalung,0,19,523116,254885,268231,50714,50714,0,,,19/1/2022 7:23
15/4/2021,Phichit,0,13,531541,259263,272278,52325,52325,0,,,19/1/2022 7:23
15/4/2021,Phitsanulok,34,57,848043,415270,432773,150029,149890,139,,,19/1/2022 7:23
15/4/2021,Phuket,14,338,413242,195176,218066,185057,183877,1180,57,24,19/1/2022 7:23
15/4/2021,Maha Sarakham,4,39,951507,466454,485053,12276,12276,0,,,19/1/2022 7:23
15/4/2021,Mukdahan,1,9,350834,175233,175601,29874,29874,0,,,19/1/2022 7:23
15/4/2021,Yala,2,154,539921,268685,271236,29789,29789,0,49,27,19/1/2022 7:23
15/4/2021,Yasothon,2,10,534065,266640,267425,23761,23761,0,,,19/1/2022 7:23
15/4/2021,Ranong,0,1,194741,98300,96441,52522,52361,161,,,19/1/2022 7:23
15/4/2021,Rayong,23,719,744962,365850,379112,102268,101970,298,62,23,19/1/2022 7:23
15/4/2021,Ratchaburi,13,117,869447,422955,446492,42340,42325,15,,,19/1/2022 7:23
15/4/2021,Roi Et,2,17,1297612,643180,654432,9529,9529,0,,,19/1/2022 7:23
15/4/2021,Lop Buri,6,45,741974,370517,371457,54769,54707,62,,,19/1/2022 7:23
15/4/2021,Lampang,2,19,727166,354266,372900,88127,87577,550,62,39,19/1/2022 7:23
15/4/2021,Lamphun,30,54,401750,193199,208551,70522,70337,185,,,19/1/2022 7:23
15/4/2021,Si Sa Ket,0,15,1457730,725631,732099,15523,15523,0,,,19/1/2022 7:23
15/4/2021,Sakon Nakhon,2,13,1146692,569813,576879,27390,27375,15,,,19/1/2022 7:23
15/4/2021,Songkhla,18,224,1429058,696568,732490,69929,69891,38,64,38,19/1/2022 7:23
15/4/2021,Satun,0,24,324321,161388,162933,73143,72554,589,41,29,19/1/2022 7:23
15/4/2021,Samut Prakarn,23,1296,1354390,645522,708868,27501,27263,238,,,19/1/2022 7:23
15/4/2021,Samut Songkhram,2,83,191749,91610,100139,126386,126314,72,33,13,19/1/2022 7:23
15/4/2021,Samut Sakhon,46,17358,586317,282574,303743,6690,6639,51,68,32,19/1/2022 7:23
15/4/2021,Saraburi,7,68,644230,316852,327378,96839,96724,115,69,54,19/1/2022 7:23
15/4/2021,Sa kaeo,17,158,561071,280075,280996,23441,23441,0,39,13,19/1/2022 7:23
15/4/2021,Sing Buri,4,22,205427,97606,107821,17847,17847,0,,,19/1/2022 7:23
15/4/2021,Suphan Buri,21,135,837370,404033,433337,72907,72907,0,,,19/1/2022 7:23
15/4/2021,Surat Thani,13,78,1068273,526182,542091,65669,65132,537,70,39,19/1/2022 7:23
15/4/2021,Surin,4,26,1377326,685192,692134,24004,23993,11,,,19/1/2022 7:23
15/4/2021,Sukhothai,4,17,586830,284310,302520,56642,55966,676,,,19/1/2022 7:23
15/4/2021,Nong Khai,0,12,517147,256546,260601,20943,20864,79,31,12,19/1/2022 7:23
15/4/2021,Nong Bua Lam Phu,4,16,509129,253956,255173,4947,4947,0,,,19/1/2022 7:23
15/4/2021,Amnat Charoen,3,11,376158,187258,188900,7354,7354,0,,,19/1/2022 7:23
15/4/2021,Udon Thani,17,96,1567503,776622,790881,39172,39152,20,,,19/1/2022 7:23
15/4/2021,Uttaradit,5,16,447754,218285,229469,47493,47493,0,,,19/1/2022 7:23
15/4/2021,Uthai Thani,0,7,325542,159106,166436,61633,61633,0,,,19/1/2022 7:23
15/4/2021,Ubon Ratchathani,30,95,1866247,931793,934454,115331,115317,14,76,46,19/1/2022 7:23
15/4/2021,Ang Thong,1,133,275944,132088,143856,35544,35544,0,,,19/1/2022 7:23
15/4/2021,Chiang Rai,0,103,1295958,630131,665827,132092,131542,550,87,38,19/1/2022 7:23
15/4/2021,Chiang Mai,277,1542,1785706,863274,922432,396241,392204,4037,88,47,19/1/2022 7:23
15/4/2021,Phetchaburi,29,162,482292,232840,249452,385714,385488,226,,,19/1/2022 7:23
15/4/2021,Phetchabun,5,21,980662,483966,496696,95174,94812,362,,,19/1/2022 7:23
15/4/2021,Loei,1,20,638441,319953,318488,50148,50126,22,52,34,19/1/2022 7:23
15/4/2021,Phrae,0,6,436290,210317,225973,62210,62067,143,62,33,19/1/2022 7:23
15/4/2021,Mae Hong Son,6,16,285552,144717,140835,42084,41573,511,112,47,19/1/2022 7:23
15/4/2021,,0,12,,,,,,,,,19/1/2022 7:23
16/4/2021,Krabi,5,48,478376,237526,240850,100764,99754,1010,,,19/1/2022 7:23
16/4/2021,Bangkok,313,7613,5574497,2617639,2956858,1115611,1063854,51757,66,27,19/1/2022 7:23
16/4/2021,Kanchanaburi,4,58,892843,448201,444642,243519,243308,211,41,16,19/1/2022 7:23
16/4/2021,Kalasin,1,13,976734,482933,493801,12687,12687,0,,,19/1/2022 7:23
16/4/2021,Kamphaeng Phet,4,16,713471,352392,361079,39769,39688,81,,,19/1/2022 7:23
16/4/2021,Khon Kaen,8,109,1793256,881683,911573,57354,57291,63,78,72,19/1/2022 7:23
16/4/2021,Chanthaburi,2,264,535634,261945,273689,116001,115931,70,,,19/1/2022 7:23
16/4/2021,Chachoengsao,9,105,721596,353738,367858,29877,29877,0,71,42,19/1/2022 7:23
16/4/2021,Chon Buri,111,2369,1572004,766532,805472,156392,155350,1042,53,27,19/1/2022 7:23
16/4/2021,Chai Nat,0,15,321758,154645,167113,31521,31521,0,,,19/1/2022 7:23
16/4/2021,Chaiyaphum,4,27,1123903,555222,568681,40561,40512,49,,,19/1/2022 7:23
16/4/2021,Chumphon,1,48,509518,251414,258104,61047,60995,52,,,19/1/2022 7:23
16/4/2021,Trang,6,24,640411,313222,327189,40640,40547,93,,,19/1/2022 7:23
16/4/2021,Trat,1,45,228569,113072,115497,137616,137392,224,,,19/1/2022 7:23
16/4/2021,Tak,5,344,672976,340316,332660,59385,59312,73,,,19/1/2022 7:23
16/4/2021,Nakhon Nayok,1,27,259750,128155,131595,76708,76708,0,,,19/1/2022 7:23
16/4/2021,Nakhon Pathom,27,326,922448,443178,479270,98319,98268,51,43,25,19/1/2022 7:23
16/4/2021,Nakhon Phanom,4,19,716791,357234,359557,27584,27557,27,,,19/1/2022 7:23
16/4/2021,Nakhon Ratchasima,14,131,2633610,1294642,1338968,314682,313761,921,73,32,19/1/2022 7:23
16/4/2021,Nakhon Si Thammarat,10,42,1550947,765252,785695,108124,107604,520,,,19/1/2022 7:23
16/4/2021,Nakhon Sawan,1,73,1038712,506804,531908,115116,115001,115,64,33,19/1/2022 7:23
16/4/2021,Nonthaburi,61,641,1281245,596307,684938,33945,33820,125,48,20,19/1/2022 7:23
16/4/2021,Narathiwat,5,405,806698,398996,407702,12366,12366,0,58,23,19/1/2022 7:23
16/4/2021,Nan,0,5,476372,238449,237923,60575,60465,110,,,19/1/2022 7:23
16/4/2021,Bueng Kan,2,5,422066,211554,210512,5420,5420,0,,,19/1/2022 7:23
16/4/2021,Buri Ram,8,53,1580079,784198,795881,38966,38860,106,,,19/1/2022 7:23
16/4/2021,Pathum Thani,27,1006,1180730,559573,621157,17584,17443,141,58,24,19/1/2022 7:23
16/4/2021,Prachuap Khiri Khan,100,649,551205,272975,278230,275365,275243,122,,,19/1/2022 7:23
16/4/2021,Prachin Buri,1,52,494574,244431,250143,62857,62857,0,78,43,19/1/2022 7:23
16/4/2021,Pattani,0,103,727686,359470,368216,11318,11318,0,,,19/1/2022 7:23
16/4/2021,Phra Nakhon Si Ayutthaya,19,160,819654,393768,425886,230549,229807,742,55,51,19/1/2022 7:23
16/4/2021,Phayao,9,17,466174,226975,239199,34541,34442,99,74,22,19/1/2022 7:23
16/4/2021,Phang-nga,1,12,268508,133879,134629,132253,130614,1639,,,19/1/2022 7:23
16/4/2021,Phatthalung,4,23,523116,254885,268231,50714,50714,0,,,19/1/2022 7:23
16/4/2021,Phichit,0,13,531541,259263,272278,52325,52325,0,,,19/1/2022 7:23
16/4/2021,Phitsanulok,8,65,848043,415270,432773,150029,149890,139,,,19/1/2022 7:23
16/4/2021,Phuket,30,368,413242,195176,218066,185057,183877,1180,55,20,19/1/2022 7:23
16/4/2021,Maha Sarakham,0,39,951507,466454,485053,12276,12276,0,,,19/1/2022 7:23
16/4/2021,Mukdahan,1,10,350834,175233,175601,29874,29874,0,,,19/1/2022 7:23
16/4/2021,Yala,0,154,539921,268685,271236,29789,29789,0,58,27,19/1/2022 7:23
16/4/2021,Yasothon,2,12,534065,266640,267425,23761,23761,0,,,19/1/2022 7:23
16/4/2021,Ranong,2,3,194741,98300,96441,52522,52361,161,,,19/1/2022 7:23
16/4/2021,Rayong,11,730,744962,365850,379112,102268,101970,298,53,27,19/1/2022 7:23
16/4/2021,Ratchaburi,12,129,869447,422955,446492,42340,42325,15,,,19/1/2022 7:23
16/4/2021,Roi Et,3,20,1297612,643180,654432,9529,9529,0,,,19/1/2022 7:23
16/4/2021,Lop Buri,9,54,741974,370517,371457,54769,54707,62,,,19/1/2022 7:23
16/4/2021,Lampang,59,78,727166,354266,372900,88127,87577,550,77,28,19/1/2022 7:23
16/4/2021,Lamphun,18,72,401750,193199,208551,70522,70337,185,,,19/1/2022 7:23
16/4/2021,Si Sa Ket,19,34,1457730,725631,732099,15523,15523,0,,,19/1/2022 7:23
16/4/2021,Sakon Nakhon,1,14,1146692,569813,576879,27390,27375,15,,,19/1/2022 7:23
16/4/2021,Songkhla,89,313,1429058,696568,732490,69929,69891,38,67,33,19/1/2022 7:23
16/4/2021,Satun,1,25,324321,161388,162933,73143,72554,589,54,52,19/1/2022 7:23
16/4/2021,Samut Prakarn,41,1337,1354390,645522,708868,27501,27263,238,,,19/1/2022 7:23
16/4/2021,Samut Songkhram,0,83,191749,91610,100139,126386,126314,72,32,13,19/1/2022 7:23
16/4/2021,Samut Sakhon,48,17406,586317,282574,303743,6690,6639,51,63,35,19/1/2022 7:23
16/4/2021,Saraburi,3,71,644230,316852,327378,96839,96724,115,76,65,19/1/2022 7:23
16/4/2021,Sa kaeo,15,173,561071,280075,280996,23441,23441,0,32,20,19/1/2022 7:23
16/4/2021,Sing Buri,10,32,205427,97606,107821,17847,17847,0,,,19/1/2022 7:23
16/4/2021,Suphan Buri,0,135,837370,404033,433337,72907,72907,0,,,19/1/2022 7:23
16/4/2021,Surat Thani,11,89,1068273,526182,542091,65669,65132,537,68,32,19/1/2022 7:23
16/4/2021,Surin,7,33,1377326,685192,692134,24004,23993,11,,,19/1/2022 7:23
16/4/2021,Sukhothai,0,17,586830,284310,302520,56642,55966,676,,,19/1/2022 7:23
16/4/2021,Nong Khai,4,16,517147,256546,260601,20943,20864,79,32,11,19/1/2022 7:23
16/4/2021,Nong Bua Lam Phu,3,19,509129,253956,255173,4947,4947,0,,,19/1/2022 7:23
16/4/2021,Amnat Charoen,3,14,376158,187258,188900,7354,7354,0,,,19/1/2022 7:23
16/4/2021,Udon Thani,11,107,1567503,776622,790881,39172,39152,20,,,19/1/2022 7:23
16/4/2021,Uttaradit,2,18,447754,218285,229469,47493,47493,0,,,19/1/2022 7:23
16/4/2021,Uthai Thani,1,8,325542,159106,166436,61633,61633,0,,,19/1/2022 7:23
16/4/2021,Ubon Ratchathani,7,102,1866247,931793,934454,115331,115317,14,94,39,19/1/2022 7:23
16/4/2021,Ang Thong,1,134,275944,132088,143856,35544,35544,0,,,19/1/2022 7:23
16/4/2021,Chiang Rai,77,180,1295958,630131,665827,132092,131542,550,97,39,19/1/2022 7:23
16/4/2021,Chiang Mai,272,1814,1785706,863274,922432,396241,392204,4037,101,35,19/1/2022 7:23
16/4/2021,Phetchaburi,17,179,482292,232840,249452,385714,385488,226,,,19/1/2022 7:23
16/4/2021,Phetchabun,1,22,980662,483966,496696,95174,94812,362,,,19/1/2022 7:23
16/4/2021,Loei,0,20,638441,319953,318488,50148,50126,22,68,18,19/1/2022 7:23
16/4/2021,Phrae,15,21,436290,210317,225973,62210,62067,143,76,22,19/1/2022 7:23
16/4/2021,Mae Hong Son,0,16,285552,144717,140835,42084,41573,511,124,37,19/1/2022 7:23
16/4/2021,,0,12,,,,,,,,,19/1/2022 7:23
17/4/2021,Krabi,3,51,478376,237526,240850,100764,99754,1010,,,19/1/2022 7:23
17/4/2021,Bangkok,279,7892,5574497,2617639,2956858,1115611,1063854,51757,64,28,19/1/2022 7:23
17/4/2021,Kanchanaburi,5,63,892843,448201,444642,243519,243308,211,40,11,19/1/2022 7:23
17/4/2021,Kalasin,4,17,976734,482933,493801,12687,12687,0,,,19/1/2022 7:23
17/4/2021,Kamphaeng Phet,2,18,713471,352392,361079,39769,39688,81,,,19/1/2022 7:23
17/4/2021,Khon Kaen,15,124,1793256,881683,911573,57354,57291,63,106,43,19/1/2022 7:23
17/4/2021,Chanthaburi,2,266,535634,261945,273689,116001,115931,70,,,19/1/2022 7:23
17/4/2021,Chachoengsao,11,116,721596,353738,367858,29877,29877,0,62,47,19/1/2022 7:23
17/4/2021,Chon Buri,101,2470,1572004,766532,805472,156392,155350,1042,55,23,19/1/2022 7:23
17/4/2021,Chai Nat,0,15,321758,154645,167113,31521,31521,0,,,19/1/2022 7:23
17/4/2021,Chaiyaphum,7,34,1123903,555222,568681,40561,40512,49,,,19/1/2022 7:23
17/4/2021,Chumphon,6,54,509518,251414,258104,61047,60995,52,,,19/1/2022 7:23
17/4/2021,Trang,0,24,640411,313222,327189,40640,40547,93,,,19/1/2022 7:23
17/4/2021,Trat,2,47,228569,113072,115497,137616,137392,224,,,19/1/2022 7:23
17/4/2021,Tak,1,345,672976,340316,332660,59385,59312,73,,,19/1/2022 7:23
17/4/2021,Nakhon Nayok,0,27,259750,128155,131595,76708,76708,0,,,19/1/2022 7:23
17/4/2021,Nakhon Pathom,18,344,922448,443178,479270,98319,98268,51,52,19,19/1/2022 7:23
17/4/2021,Nakhon Phanom,2,21,716791,357234,359557,27584,27557,27,,,19/1/2022 7:23
17/4/2021,Nakhon Ratchasima,6,137,2633610,1294642,1338968,314682,313761,921,73,35,19/1/2022 7:23
17/4/2021,Nakhon Si Thammarat,6,48,1550947,765252,785695,108124,107604,520,,,19/1/2022 7:23
17/4/2021,Nakhon Sawan,16,89,1038712,506804,531908,115116,115001,115,60,34,19/1/2022 7:23
17/4/2021,Nonthaburi,248,889,1281245,596307,684938,33945,33820,125,45,23,19/1/2022 7:23
17/4/2021,Narathiwat,19,424,806698,398996,407702,12366,12366,0,54,20,19/1/2022 7:23
17/4/2021,Nan,0,5,476372,238449,237923,60575,60465,110,,,19/1/2022 7:23
17/4/2021,Bueng Kan,2,7,422066,211554,210512,5420,5420,0,,,19/1/2022 7:23
17/4/2021,Buri Ram,9,62,1580079,784198,795881,38966,38860,106,,,19/1/2022 7:23
17/4/2021,Pathum Thani,26,1032,1180730,559573,621157,17584,17443,141,66,21,19/1/2022 7:23
17/4/2021,Prachuap Khiri Khan,58,707,551205,272975,278230,275365,275243,122,,,19/1/2022 7:23
17/4/2021,Prachin Buri,5,57,494574,244431,250143,62857,62857,0,94,30,19/1/2022 7:23
17/4/2021,Pattani,0,103,727686,359470,368216,11318,11318,0,,,19/1/2022 7:23
17/4/2021,Phra Nakhon Si Ayutthaya,13,173,819654,393768,425886,230549,229807,742,76,44,19/1/2022 7:23
17/4/2021,Phayao,21,38,466174,226975,239199,34541,34442,99,58,17,19/1/2022 7:23
17/4/2021,Phang-nga,2,14,268508,133879,134629,132253,130614,1639,,,19/1/2022 7:23
17/4/2021,Phatthalung,2,25,523116,254885,268231,50714,50714,0,,,19/1/2022 7:23
17/4/2021,Phichit,3,16,531541,259263,272278,52325,52325,0,,,19/1/2022 7:23
17/4/2021,Phitsanulok,25,90,848043,415270,432773,150029,149890,139,,,19/1/2022 7:23
17/4/2021,Phuket,24,392,413242,195176,218066,185057,183877,1180,50,22,19/1/2022 7:23
17/4/2021,Maha Sarakham,6,45,951507,466454,485053,12276,12276,0,,,19/1/2022 7:23
17/4/2021,Mukdahan,2,12,350834,175233,175601,29874,29874,0,,,19/1/2022 7:23
17/4/2021,Yala,3,157,539921,268685,271236,29789,29789,0,59,21,19/1/2022 7:23
17/4/2021,Yasothon,0,12,534065,266640,267425,23761,23761,0,,,19/1/2022 7:23
17/4/2021,Ranong,1,4,194741,98300,96441,52522,52361,161,,,19/1/2022 7:23
17/4/2021,Rayong,10,740,744962,365850,379112,102268,101970,298,55,26,19/1/2022 7:23
17/4/2021,Ratchaburi,14,143,869447,422955,446492,42340,42325,15,,,19/1/2022 7:23
17/4/2021,Roi Et,6,26,1297612,643180,654432,9529,9529,0,,,19/1/2022 7:23
17/4/2021,Lop Buri,6,60,741974,370517,371457,54769,54707,62,,,19/1/2022 7:23
17/4/2021,Lampang,10,88,727166,354266,372900,88127,87577,550,53,25,19/1/2022 7:23
17/4/2021,Lamphun,45,117,401750,193199,208551,70522,70337,185,,,19/1/2022 7:23
17/4/2021,Si Sa Ket,13,47,1457730,725631,732099,15523,15523,0,,,19/1/2022 7:23
17/4/2021,Sakon Nakhon,8,22,1146692,569813,576879,27390,27375,15,,,19/1/2022 7:23
17/4/2021,Songkhla,17,330,1429058,696568,732490,69929,69891,38,64,26,19/1/2022 7:23
17/4/2021,Satun,0,25,324321,161388,162933,73143,72554,589,93,11,19/1/2022 7:23
17/4/2021,Samut Prakarn,27,1364,1354390,645522,708868,27501,27263,238,,,19/1/2022 7:23
17/4/2021,Samut Songkhram,1,84,191749,91610,100139,126386,126314,72,31,12,19/1/2022 7:23
17/4/2021,Samut Sakhon,37,17443,586317,282574,303743,6690,6639,51,74,32,19/1/2022 7:23
17/4/2021,Saraburi,7,78,644230,316852,327378,96839,96724,115,82,73,19/1/2022 7:23
17/4/2021,Sa kaeo,4,177,561071,280075,280996,23441,23441,0,50,18,19/1/2022 7:23
17/4/2021,Sing Buri,2,34,205427,97606,107821,17847,17847,0,,,19/1/2022 7:23
17/4/2021,Suphan Buri,16,151,837370,404033,433337,72907,72907,0,,,19/1/2022 7:23
17/4/2021,Surat Thani,23,112,1068273,526182,542091,65669,65132,537,63,32,19/1/2022 7:23
17/4/2021,Surin,3,36,1377326,685192,692134,24004,23993,11,,,19/1/2022 7:23
17/4/2021,Sukhothai,0,17,586830,284310,302520,56642,55966,676,,,19/1/2022 7:23
17/4/2021,Nong Khai,0,16,517147,256546,260601,20943,20864,79,29,12,19/1/2022 7:23
17/4/2021,Nong Bua Lam Phu,0,19,509129,253956,255173,4947,4947,0,,,19/1/2022 7:23
17/4/2021,Amnat Charoen,2,16,376158,187258,188900,7354,7354,0,,,19/1/2022 7:23
17/4/2021,Udon Thani,30,137,1567503,776622,790881,39172,39152,20,,,19/1/2022 7:23
17/4/2021,Uttaradit,10,28,447754,218285,229469,47493,47493,0,,,19/1/2022 7:23
17/4/2021,Uthai Thani,0,8,325542,159106,166436,61633,61633,0,,,19/1/2022 7:23
17/4/2021,Ubon Ratchathani,12,114,1866247,931793,934454,115331,115317,14,90,40,19/1/2022 7:23
17/4/2021,Ang Thong,3,137,275944,132088,143856,35544,35544,0,,,19/1/2022 7:23
17/4/2021,Chiang Rai,17,197,1295958,630131,665827,132092,131542,550,99,30,19/1/2022 7:23
17/4/2021,Chiang Mai,140,1954,1785706,863274,922432,396241,392204,4037,79,21,19/1/2022 7:23
17/4/2021,Phetchaburi,20,199,482292,232840,249452,385714,385488,226,,,19/1/2022 7:23
17/4/2021,Phetchabun,2,24,980662,483966,496696,95174,94812,362,,,19/1/2022 7:23
17/4/2021,Loei,1,21,638441,319953,318488,50148,50126,22,34,23,19/1/2022 7:23
17/4/2021,Phrae,2,23,436290,210317,225973,62210,62067,143,56,17,19/1/2022 7:23
17/4/2021,Mae Hong Son,3,19,285552,144717,140835,42084,41573,511,101,31,19/1/2022 7:23
17/4/2021,,101,113,,,,,,,,,19/1/2022 7:23
18/4/2021,Krabi,5,56,478376,237526,240850,100764,99754,1010,,,19/1/2022 7:23
18/4/2021,Bangkok,349,8241,5574497,2617639,2956858,1115611,1063854,51757,61,25,19/1/2022 7:23
18/4/2021,Kanchanaburi,2,65,892843,448201,444642,243519,243308,211,31,15,19/1/2022 7:23
18/4/2021,Kalasin,1,18,976734,482933,493801,12687,12687,0,,,19/1/2022 7:23
18/4/2021,Kamphaeng Phet,5,23,713471,352392,361079,39769,39688,81,,,19/1/2022 7:23
18/4/2021,Khon Kaen,10,134,1793256,881683,911573,57354,57291,63,85,32,19/1/2022 7:23
18/4/2021,Chanthaburi,2,268,535634,261945,273689,116001,115931,70,,,19/1/2022 7:23
18/4/2021,Chachoengsao,29,145,721596,353738,367858,29877,29877,0,71,37,19/1/2022 7:23
18/4/2021,Chon Buri,230,2700,1572004,766532,805472,156392,155350,1042,46,24,19/1/2022 7:23
18/4/2021,Chai Nat,1,16,321758,154645,167113,31521,31521,0,,,19/1/2022 7:23
18/4/2021,Chaiyaphum,4,38,1123903,555222,568681,40561,40512,49,,,19/1/2022 7:23
18/4/2021,Chumphon,3,57,509518,251414,258104,61047,60995,52,,,19/1/2022 7:23
18/4/2021,Trang,5,29,640411,313222,327189,40640,40547,93,,,19/1/2022 7:23
18/4/2021,Trat,3,50,228569,113072,115497,137616,137392,224,,,19/1/2022 7:23
18/4/2021,Tak,13,358,672976,340316,332660,59385,59312,73,,,19/1/2022 7:23
18/4/2021,Nakhon Nayok,3,30,259750,128155,131595,76708,76708,0,,,19/1/2022 7:23
18/4/2021,Nakhon Pathom,26,370,922448,443178,479270,98319,98268,51,43,16,19/1/2022 7:23
18/4/2021,Nakhon Phanom,8,29,716791,357234,359557,27584,27557,27,,,19/1/2022 7:23
18/4/2021,Nakhon Ratchasima,51,188,2633610,1294642,1338968,314682,313761,921,75,21,19/1/2022 7:23
18/4/2021,Nakhon Si Thammarat,12,60,1550947,765252,785695,108124,107604,520,,,19/1/2022 7:23
18/4/2021,Nakhon Sawan,51,140,1038712,506804,531908,115116,115001,115,64,23,19/1/2022 7:23
18/4/2021,Nonthaburi,100,989,1281245,596307,684938,33945,33820,125,44,17,19/1/2022 7:23
18/4/2021,Narathiwat,18,442,806698,398996,407702,12366,12366,0,52,16,19/1/2022 7:23
18/4/2021,Nan,25,30,476372,238449,237923,60575,60465,110,,,19/1/2022 7:23
18/4/2021,Bueng Kan,1,8,422066,211554,210512,5420,5420,0,,,19/1/2022 7:23
18/4/2021,Buri Ram,0,62,1580079,784198,795881,38966,38860,106,,,19/1/2022 7:23
18/4/2021,Pathum Thani,24,1056,1180730,559573,621157,17584,17443,141,66,16,19/1/2022 7:23
18/4/2021,Prachuap Khiri Khan,66,773,551205,272975,278230,275365,275243,122,,,19/1/2022 7:23
18/4/2021,Prachin Buri,5,62,494574,244431,250143,62857,62857,0,67,27,19/1/2022 7:23
18/4/2021,Pattani,1,104,727686,359470,368216,11318,11318,0,,,19/1/2022 7:23
18/4/2021,Phra Nakhon Si Ayutthaya,7,180,819654,393768,425886,230549,229807,742,59,36,19/1/2022 7:23
18/4/2021,Phayao,8,46,466174,226975,239199,34541,34442,99,44,22,19/1/2022 7:23
18/4/2021,Phang-nga,1,15,268508,133879,134629,132253,130614,1639,,,19/1/2022 7:23
18/4/2021,Phatthalung,3,28,523116,254885,268231,50714,50714,0,,,19/1/2022 7:23
18/4/2021,Phichit,0,16,531541,259263,272278,52325,52325,0,,,19/1/2022 7:23
18/4/2021,Phitsanulok,46,136,848043,415270,432773,150029,149890,139,,,19/1/2022 7:23
18/4/2021,Phuket,25,417,413242,195176,218066,185057,183877,1180,47,19,19/1/2022 7:23
18/4/2021,Maha Sarakham,2,47,951507,466454,485053,12276,12276,0,,,19/1/2022 7:23
18/4/2021,Mukdahan,1,13,350834,175233,175601,29874,29874,0,,,19/1/2022 7:23
18/4/2021,Yala,2,159,539921,268685,271236,29789,29789,0,51,22,19/1/2022 7:23
18/4/2021,Yasothon,3,15,534065,266640,267425,23761,23761,0,,,19/1/2022 7:23
18/4/2021,Ranong,4,8,194741,98300,96441,52522,52361,161,,,19/1/2022 7:23
18/4/2021,Rayong,34,774,744962,365850,379112,102268,101970,298,44,22,19/1/2022 7:23
18/4/2021,Ratchaburi,12,155,869447,422955,446492,42340,42325,15,,,19/1/2022 7:23
18/4/2021,Roi Et,7,33,1297612,643180,654432,9529,9529,0,,,19/1/2022 7:23
18/4/2021,Lop Buri,8,68,741974,370517,371457,54769,54707,62,,,19/1/2022 7:23
18/4/2021,Lampang,34,122,727166,354266,372900,88127,87577,550,41,25,19/1/2022 7:23
18/4/2021,Lamphun,25,142,401750,193199,208551,70522,70337,185,,,19/1/2022 7:23
18/4/2021,Si Sa Ket,6,53,1457730,725631,732099,15523,15523,0,,,19/1/2022 7:23
18/4/2021,Sakon Nakhon,2,24,1146692,569813,576879,27390,27375,15,,,19/1/2022 7:23
18/4/2021,Songkhla,25,355,1429058,696568,732490,69929,69891,38,51,28,19/1/2022 7:23
18/4/2021,Satun,1,26,324321,161388,162933,73143,72554,589,26,14,19/1/2022 7:23
18/4/2021,Samut Prakarn,64,1428,1354390,645522,708868,27501,27263,238,,,19/1/2022 7:23
18/4/2021,Samut Songkhram,0,84,191749,91610,100139,126386,126314,72,31,10,19/1/2022 7:23
18/4/2021,Samut Sakhon,18,17461,586317,282574,303743,6690,6639,51,66,28,19/1/2022 7:23
18/4/2021,Saraburi,3,81,644230,316852,327378,96839,96724,115,79,48,19/1/2022 7:23
18/4/2021,Sa kaeo,10,187,561071,280075,280996,23441,23441,0,47,11,19/1/2022 7:23
18/4/2021,Sing Buri,0,34,205427,97606,107821,17847,17847,0,,,19/1/2022 7:23
18/4/2021,Suphan Buri,0,151,837370,404033,433337,72907,72907,0,,,19/1/2022 7:23
18/4/2021,Surat Thani,38,150,1068273,526182,542091,65669,65132,537,59,33,19/1/2022 7:23
18/4/2021,Surin,8,44,1377326,685192,692134,24004,23993,11,,,19/1/2022 7:23
18/4/2021,Sukhothai,1,18,586830,284310,302520,56642,55966,676,,,19/1/2022 7:23
18/4/2021,Nong Khai,3,19,517147,256546,260601,20943,20864,79,29,10,19/1/2022 7:23
18/4/2021,Nong Bua Lam Phu,2,21,509129,253956,255173,4947,4947,0,,,19/1/2022 7:23
18/4/2021,Amnat Charoen,0,16,376158,187258,188900,7354,7354,0,,,19/1/2022 7:23
18/4/2021,Udon Thani,15,152,1567503,776622,790881,39172,39152,20,,,19/1/2022 7:23
18/4/2021,Uttaradit,17,45,447754,218285,229469,47493,47493,0,,,19/1/2022 7:23
18/4/2021,Uthai Thani,1,9,325542,159106,166436,61633,61633,0,,,19/1/2022 7:23
18/4/2021,Ubon Ratchathani,7,121,1866247,931793,934454,115331,115317,14,92,37,19/1/2022 7:23
18/4/2021,Ang Thong,3,140,275944,132088,143856,35544,35544,0,,,19/1/2022 7:23
18/4/2021,Chiang Rai,17,214,1295958,630131,665827,132092,131542,550,80,22,19/1/2022 7:23
18/4/2021,Chiang Mai,164,2118,1785706,863274,922432,396241,392204,4037,52,34,19/1/2022 7:23
18/4/2021,Phetchaburi,23,222,482292,232840,249452,385714,385488,226,,,19/1/2022 7:23
18/4/2021,Phetchabun,7,31,980662,483966,496696,95174,94812,362,,,19/1/2022 7:23
18/4/2021,Loei,1,22,638441,319953,318488,50148,50126,22,35,22,19/1/2022 7:23
18/4/2021,Phrae,16,39,436290,210317,225973,62210,62067,143,43,18,19/1/2022 7:23
18/4/2021,Mae Hong Son,0,19,285552,144717,140835,42084,41573,511,90,36,19/1/2022 7:23
18/4/2021,,40,153,,,,,,,,,19/1/2022 7:23
19/4/2021,Krabi,0,56,478376,237526,240850,100764,99754,1010,,,19/1/2022 7:23
19/4/2021,Bangkok,295,8536,5574497,2617639,2956858,1115611,1063854,51757,47,27,19/1/2022 7:23
19/4/2021,Kanchanaburi,1,66,892843,448201,444642,243519,243308,211,40,12,19/1/2022 7:23
19/4/2021,Kalasin,8,26,976734,482933,493801,12687,12687,0,,,19/1/2022 7:23
19/4/2021,Kamphaeng Phet,6,29,713471,352392,361079,39769,39688,81,,,19/1/2022 7:23
19/4/2021,Khon Kaen,20,154,1793256,881683,911573,57354,57291,63,63,36,19/1/2022 7:23
19/4/2021,Chanthaburi,9,277,535634,261945,273689,116001,115931,70,,,19/1/2022 7:23
19/4/2021,Chachoengsao,15,160,721596,353738,367858,29877,29877,0,54,35,19/1/2022 7:23
19/4/2021,Chon Buri,100,2800,1572004,766532,805472,156392,155350,1042,36,27,19/1/2022 7:23
19/4/2021,Chai Nat,0,16,321758,154645,167113,31521,31521,0,,,19/1/2022 7:23
19/4/2021,Chaiyaphum,4,42,1123903,555222,568681,40561,40512,49,,,19/1/2022 7:23
19/4/2021,Chumphon,3,60,509518,251414,258104,61047,60995,52,,,19/1/2022 7:23
19/4/2021,Trang,1,30,640411,313222,327189,40640,40547,93,,,19/1/2022 7:23
19/4/2021,Trat,1,51,228569,113072,115497,137616,137392,224,,,19/1/2022 7:23
19/4/2021,Tak,4,362,672976,340316,332660,59385,59312,73,,,19/1/2022 7:23
19/4/2021,Nakhon Nayok,4,34,259750,128155,131595,76708,76708,0,,,19/1/2022 7:23
19/4/2021,Nakhon Pathom,38,408,922448,443178,479270,98319,98268,51,38,17,19/1/2022 7:23
19/4/2021,Nakhon Phanom,7,36,716791,357234,359557,27584,27557,27,,,19/1/2022 7:23
19/4/2021,Nakhon Ratchasima,35,223,2633610,1294642,1338968,314682,313761,921,47,29,19/1/2022 7:23
19/4/2021,Nakhon Si Thammarat,11,71,1550947,765252,785695,108124,107604,520,,,19/1/2022 7:23
19/4/2021,Nakhon Sawan,9,149,1038712,506804,531908,115116,115001,115,41,32,19/1/2022 7:23
19/4/2021,Nonthaburi,39,1028,1281245,596307,684938,33945,33820,125,29,24,19/1/2022 7:23
19/4/2021,Narathiwat,15,457,806698,398996,407702,12366,12366,0,38,17,19/1/2022 7:23
19/4/2021,Nan,0,30,476372,238449,237923,60575,60465,110,,,19/1/2022 7:23
19/4/2021,Bueng Kan,1,9,422066,211554,210512,5420,5420,0,,,19/1/2022 7:23
19/4/2021,Buri Ram,8,70,1580079,784198,795881,38966,38860,106,,,19/1/2022 7:23
19/4/2021,Pathum Thani,19,1075,1180730,559573,621157,17584,17443,141,44,31,19/1/2022 7:23
19/4/2021,Prachuap Khiri Khan,23,796,551205,272975,278230,275365,275243,122,,,19/1/2022 7:23
19/4/2021,Prachin Buri,7,69,494574,244431,250143,62857,62857,0,59,30,19/1/2022 7:23
19/4/2021,Pattani,0,104,727686,359470,368216,11318,11318,0,,,19/1/2022 7:23
19/4/2021,Phra Nakhon Si Ayutthaya,42,222,819654,393768,425886,230549,229807,742,41,43,19/1/2022 7:23
19/4/2021,Phayao,6,52,466174,226975,239199,34541,34442,99,47,29,19/1/2022 7:23
19/4/2021,Phang-nga,4,19,268508,133879,134629,132253,130614,1639,,,19/1/2022 7:23
19/4/2021,Phatthalung,10,38,523116,254885,268231,50714,50714,0,,,19/1/2022 7:23
19/4/2021,Phichit,1,17,531541,259263,272278,52325,52325,0,,,19/1/2022 7:23
19/4/2021,Phitsanulok,26,162,848043,415270,432773,150029,149890,139,,,19/1/2022 7:23
19/4/2021,Phuket,18,435,413242,195176,218066,185057,183877,1180,39,23,19/1/2022 7:23
19/4/2021,Maha Sarakham,3,50,951507,466454,485053,12276,12276,0,,,19/1/2022 7:23
19/4/2021,Mukdahan,0,13,350834,175233,175601,29874,29874,0,,,19/1/2022 7:23
19/4/2021,Yala,0,159,539921,268685,271236,29789,29789,0,49,23,19/1/2022 7:23
19/4/2021,Yasothon,2,17,534065,266640,267425,23761,23761,0,,,19/1/2022 7:23
19/4/2021,Ranong,3,11,194741,98300,96441,52522,52361,161,,,19/1/2022 7:23
19/4/2021,Rayong,19,793,744962,365850,379112,102268,101970,298,42,24,19/1/2022 7:23
19/4/2021,Ratchaburi,5,160,869447,422955,446492,42340,42325,15,,,19/1/2022 7:23
19/4/2021,Roi Et,4,37,1297612,643180,654432,9529,9529,0,,,19/1/2022 7:23
19/4/2021,Lop Buri,9,77,741974,370517,371457,54769,54707,62,,,19/1/2022 7:23
19/4/2021,Lampang,7,129,727166,354266,372900,88127,87577,550,32,33,19/1/2022 7:23
19/4/2021,Lamphun,0,142,401750,193199,208551,70522,70337,185,,,19/1/2022 7:23
19/4/2021,Si Sa Ket,2,55,1457730,725631,732099,15523,15523,0,,,19/1/2022 7:23
19/4/2021,Sakon Nakhon,1,25,1146692,569813,576879,27390,27375,15,,,19/1/2022 7:23
19/4/2021,Songkhla,34,389,1429058,696568,732490,69929,69891,38,51,29,19/1/2022 7:23
19/4/2021,Satun,0,26,324321,161388,162933,73143,72554,589,26,13,19/1/2022 7:23
19/4/2021,Samut Prakarn,82,1510,1354390,645522,708868,27501,27263,238,,,19/1/2022 7:23
19/4/2021,Samut Songkhram,2,86,191749,91610,100139,126386,126314,72,20,9,19/1/2022 7:23
19/4/2021,Samut Sakhon,32,17493,586317,282574,303743,6690,6639,51,50,38,19/1/2022 7:23
19/4/2021,Saraburi,1,82,644230,316852,327378,96839,96724,115,61,95,19/1/2022 7:23
19/4/2021,Sa kaeo,18,205,561071,280075,280996,23441,23441,0,23,14,19/1/2022 7:23
19/4/2021,Sing Buri,3,37,205427,97606,107821,17847,17847,0,,,19/1/2022 7:23
19/4/2021,Suphan Buri,15,166,837370,404033,433337,72907,72907,0,,,19/1/2022 7:23
19/4/2021,Surat Thani,42,192,1068273,526182,542091,65669,65132,537,63,31,19/1/2022 7:23
19/4/2021,Surin,3,47,1377326,685192,692134,24004,23993,11,,,19/1/2022 7:23
19/4/2021,Sukhothai,1,19,586830,284310,302520,56642,55966,676,,,19/1/2022 7:23
19/4/2021,Nong Khai,0,19,517147,256546,260601,20943,20864,79,25,10,19/1/2022 7:23
19/4/2021,Nong Bua Lam Phu,0,21,509129,253956,255173,4947,4947,0,,,19/1/2022 7:23
19/4/2021,Amnat Charoen,4,20,376158,187258,188900,7354,7354,0,,,19/1/2022 7:23
19/4/2021,Udon Thani,23,175,1567503,776622,790881,39172,39152,20,,,19/1/2022 7:23
19/4/2021,Uttaradit,5,50,447754,218285,229469,47493,47493,0,,,19/1/2022 7:23
19/4/2021,Uthai Thani,1,10,325542,159106,166436,61633,61633,0,,,19/1/2022 7:23
19/4/2021,Ubon Ratchathani,12,133,1866247,931793,934454,115331,115317,14,85,20,19/1/2022 7:23
19/4/2021,Ang Thong,4,144,275944,132088,143856,35544,35544,0,,,19/1/2022 7:23
19/4/2021,Chiang Rai,17,231,1295958,630131,665827,132092,131542,550,54,32,19/1/2022 7:23
19/4/2021,Chiang Mai,197,2315,1785706,863274,922432,396241,392204,4037,66,43,19/1/2022 7:23
19/4/2021,Phetchaburi,35,257,482292,232840,249452,385714,385488,226,,,19/1/2022 7:23
19/4/2021,Phetchabun,6,37,980662,483966,496696,95174,94812,362,,,19/1/2022 7:23
19/4/2021,Loei,3,25,638441,319953,318488,50148,50126,22,23,28,19/1/2022 7:23
19/4/2021,Phrae,5,44,436290,210317,225973,62210,62067,143,38,24,19/1/2022 7:23
19/4/2021,Mae Hong Son,0,19,285552,144717,140835,42084,41573,511,100,48,19/1/2022 7:23
19/4/2021,,0,153,,,,,,,,,19/1/2022 7:23
20/4/2021,Krabi,4,60,478376,237526,240850,100764,99754,1010,,,19/1/2022 7:23
20/4/2021,Bangkok,351,8887,5574497,2617639,2956858,1115611,1063854,51757,51,30,19/1/2022 7:23
20/4/2021,Kanchanaburi,3,69,892843,448201,444642,243519,243308,211,32,16,19/1/2022 7:23
20/4/2021,Kalasin,4,30,976734,482933,493801,12687,12687,0,,,19/1/2022 7:23
20/4/2021,Kamphaeng Phet,5,34,713471,352392,361079,39769,39688,81,,,19/1/2022 7:23
20/4/2021,Khon Kaen,19,173,1793256,881683,911573,57354,57291,63,69,45,19/1/2022 7:23
20/4/2021,Chanthaburi,4,281,535634,261945,273689,116001,115931,70,,,19/1/2022 7:23
20/4/2021,Chachoengsao,9,169,721596,353738,367858,29877,29877,0,52,37,19/1/2022 7:23
20/4/2021,Chon Buri,83,2883,1572004,766532,805472,156392,155350,1042,41,25,19/1/2022 7:23
20/4/2021,Chai Nat,0,16,321758,154645,167113,31521,31521,0,,,19/1/2022 7:23
20/4/2021,Chaiyaphum,1,43,1123903,555222,568681,40561,40512,49,,,19/1/2022 7:23
20/4/2021,Chumphon,2,62,509518,251414,258104,61047,60995,52,,,19/1/2022 7:23
20/4/2021,Trang,1,31,640411,313222,327189,40640,40547,93,,,19/1/2022 7:23
20/4/2021,Trat,1,52,228569,113072,115497,137616,137392,224,,,19/1/2022 7:23
20/4/2021,Tak,4,366,672976,340316,332660,59385,59312,73,,,19/1/2022 7:23
20/4/2021,Nakhon Nayok,6,40,259750,128155,131595,76708,76708,0,,,19/1/2022 7:23
20/4/2021,Nakhon Pathom,35,443,922448,443178,479270,98319,98268,51,30,19,19/1/2022 7:23
20/4/2021,Nakhon Phanom,10,46,716791,357234,359557,27584,27557,27,,,19/1/2022 7:23
20/4/2021,Nakhon Ratchasima,47,270,2633610,1294642,1338968,314682,313761,921,56,26,19/1/2022 7:23
20/4/2021,Nakhon Si Thammarat,11,82,1550947,765252,785695,108124,107604,520,,,19/1/2022 7:23
20/4/2021,Nakhon Sawan,1,150,1038712,506804,531908,115116,115001,115,47,41,19/1/2022 7:23
20/4/2021,Nonthaburi,23,1051,1281245,596307,684938,33945,33820,125,38,15,19/1/2022 7:23
20/4/2021,Narathiwat,17,474,806698,398996,407702,12366,12366,0,34,17,19/1/2022 7:23
20/4/2021,Nan,14,44,476372,238449,237923,60575,60465,110,,,19/1/2022 7:23
20/4/2021,Bueng Kan,1,10,422066,211554,210512,5420,5420,0,,,19/1/2022 7:23
20/4/2021,Buri Ram,2,72,1580079,784198,795881,38966,38860,106,,,19/1/2022 7:23
20/4/2021,Pathum Thani,57,1132,1180730,559573,621157,17584,17443,141,69,30,19/1/2022 7:23
20/4/2021,Prachuap Khiri Khan,41,837,551205,272975,278230,275365,275243,122,,,19/1/2022 7:23
20/4/2021,Prachin Buri,5,74,494574,244431,250143,62857,62857,0,61,30,19/1/2022 7:23
20/4/2021,Pattani,0,104,727686,359470,368216,11318,11318,0,,,19/1/2022 7:23
20/4/2021,Phra Nakhon Si Ayutthaya,18,240,819654,393768,425886,230549,229807,742,47,53,19/1/2022 7:23
20/4/2021,Phayao,8,60,466174,226975,239199,34541,34442,99,59,36,19/1/2022 7:23
20/4/2021,Phang-nga,2,21,268508,133879,134629,132253,130614,1639,,,19/1/2022 7:23
20/4/2021,Phatthalung,13,51,523116,254885,268231,50714,50714,0,,,19/1/2022 7:23
20/4/2021,Phichit,0,17,531541,259263,272278,52325,52325,0,,,19/1/2022 7:23
20/4/2021,Phitsanulok,17,179,848043,415270,432773,150029,149890,139,,,19/1/2022 7:23
20/4/2021,Phuket,20,455,413242,195176,218066,185057,183877,1180,47,23,19/1/2022 7:23
20/4/2021,Maha Sarakham,19,69,951507,466454,485053,12276,12276,0,,,19/1/2022 7:23
20/4/2021,Mukdahan,1,14,350834,175233,175601,29874,29874,0,,,19/1/2022 7:23
20/4/2021,Yala,0,159,539921,268685,271236,29789,29789,0,48,23,19/1/2022 7:23
20/4/2021,Yasothon,1,18,534065,266640,267425,23761,23761,0,,,19/1/2022 7:23
20/4/2021,Ranong,1,12,194741,98300,96441,52522,52361,161,,,19/1/2022 7:23
20/4/2021,Rayong,35,828,744962,365850,379112,102268,101970,298,26,20,19/1/2022 7:23
20/4/2021,Ratchaburi,8,168,869447,422955,446492,42340,42325,15,,,19/1/2022 7:23
20/4/2021,Roi Et,5,42,1297612,643180,654432,9529,9529,0,,,19/1/2022 7:23
20/4/2021,Lop Buri,9,86,741974,370517,371457,54769,54707,62,,,19/1/2022 7:23
20/4/2021,Lampang,17,146,727166,354266,372900,88127,87577,550,50,44,19/1/2022 7:23
20/4/2021,Lamphun,39,181,401750,193199,208551,70522,70337,185,,,19/1/2022 7:23
20/4/2021,Si Sa Ket,6,61,1457730,725631,732099,15523,15523,0,,,19/1/2022 7:23
20/4/2021,Sakon Nakhon,9,34,1146692,569813,576879,27390,27375,15,,,19/1/2022 7:23
20/4/2021,Songkhla,29,418,1429058,696568,732490,69929,69891,38,50,28,19/1/2022 7:23
20/4/2021,Satun,1,27,324321,161388,162933,73143,72554,589,18,15,19/1/2022 7:23
20/4/2021,Samut Prakarn,60,1570,1354390,645522,708868,27501,27263,238,,,19/1/2022 7:23
20/4/2021,Samut Songkhram,0,86,191749,91610,100139,126386,126314,72,16,12,19/1/2022 7:23
20/4/2021,Samut Sakhon,43,17536,586317,282574,303743,6690,6639,51,71,40,19/1/2022 7:23
20/4/2021,Saraburi,3,85,644230,316852,327378,96839,96724,115,86,92,19/1/2022 7:23
20/4/2021,Sa kaeo,7,212,561071,280075,280996,23441,23441,0,34,11,19/1/2022 7:23
20/4/2021,Sing Buri,4,41,205427,97606,107821,17847,17847,0,,,19/1/2022 7:23
20/4/2021,Suphan Buri,13,179,837370,404033,433337,72907,72907,0,,,19/1/2022 7:23
20/4/2021,Surat Thani,47,239,1068273,526182,542091,65669,65132,537,64,34,19/1/2022 7:23
20/4/2021,Surin,5,52,1377326,685192,692134,24004,23993,11,,,19/1/2022 7:23
20/4/2021,Sukhothai,0,19,586830,284310,302520,56642,55966,676,,,19/1/2022 7:23
20/4/2021,Nong Khai,3,22,517147,256546,260601,20943,20864,79,25,11,19/1/2022 7:23
20/4/2021,Nong Bua Lam Phu,0,21,509129,253956,255173,4947,4947,0,,,19/1/2022 7:23
20/4/2021,Amnat Charoen,3,23,376158,187258,188900,7354,7354,0,,,19/1/2022 7:23
20/4/2021,Udon Thani,16,191,1567503,776622,790881,39172,39152,20,,,19/1/2022 7:23
20/4/2021,Uttaradit,2,52,447754,218285,229469,47493,47493,0,,,19/1/2022 7:23
20/4/2021,Uthai Thani,0,10,325542,159106,166436,61633,61633,0,,,19/1/2022 7:23
20/4/2021,Ubon Ratchathani,17,150,1866247,931793,934454,115331,115317,14,47,38,19/1/2022 7:23
20/4/2021,Ang Thong,0,144,275944,132088,143856,35544,35544,0,,,19/1/2022 7:23
20/4/2021,Chiang Rai,17,248,1295958,630131,665827,132092,131542,550,79,37,19/1/2022 7:23
20/4/2021,Chiang Mai,116,2431,1785706,863274,922432,396241,392204,4037,82,50,19/1/2022 7:23
20/4/2021,Phetchaburi,43,300,482292,232840,249452,385714,385488,226,,,19/1/2022 7:23
20/4/2021,Phetchabun,2,39,980662,483966,496696,95174,94812,362,,,19/1/2022 7:23
20/4/2021,Loei,3,28,638441,319953,318488,50148,50126,22,34,34,19/1/2022 7:23
20/4/2021,Phrae,6,50,436290,210317,225973,62210,62067,143,58,35,19/1/2022 7:23
20/4/2021,Mae Hong Son,14,33,285552,144717,140835,42084,41573,511,124,54,19/1/2022 7:23
20/4/2021,,0,153,,,,,,,,,19/1/2022 7:23
21/4/2021,Krabi,6,66,478376,237526,240850,100764,99754,1010,,,19/1/2022 7:23
21/4/2021,Bangkok,368,9255,5574497,2617639,2956858,1115611,1063854,51757,58,39,19/1/2022 7:23
21/4/2021,Kanchanaburi,3,72,892843,448201,444642,243519,243308,211,43,23,19/1/2022 7:23
21/4/2021,Kalasin,7,37,976734,482933,493801,12687,12687,0,,,19/1/2022 7:23
21/4/2021,Kamphaeng Phet,4,38,713471,352392,361079,39769,39688,81,,,19/1/2022 7:23
21/4/2021,Khon Kaen,14,187,1793256,881683,911573,57354,57291,63,84,51,19/1/2022 7:23
21/4/2021,Chanthaburi,9,290,535634,261945,273689,116001,115931,70,,,19/1/2022 7:23
21/4/2021,Chachoengsao,23,192,721596,353738,367858,29877,29877,0,46,39,19/1/2022 7:23
21/4/2021,Chon Buri,80,2963,1572004,766532,805472,156392,155350,1042,43,32,19/1/2022 7:23
21/4/2021,Chai Nat,0,16,321758,154645,167113,31521,31521,0,,,19/1/2022 7:23
21/4/2021,Chaiyaphum,2,45,1123903,555222,568681,40561,40512,49,,,19/1/2022 7:23
21/4/2021,Chumphon,3,65,509518,251414,258104,61047,60995,52,,,19/1/2022 7:23
21/4/2021,Trang,0,31,640411,313222,327189,40640,40547,93,,,19/1/2022 7:23
21/4/2021,Trat,1,53,228569,113072,115497,137616,137392,224,,,19/1/2022 7:23
21/4/2021,Tak,8,374,672976,340316,332660,59385,59312,73,,,19/1/2022 7:23
21/4/2021,Nakhon Nayok,9,49,259750,128155,131595,76708,76708,0,,,19/1/2022 7:23
21/4/2021,Nakhon Pathom,19,462,922448,443178,479270,98319,98268,51,40,27,19/1/2022 7:23
21/4/2021,Nakhon Phanom,9,55,716791,357234,359557,27584,27557,27,,,19/1/2022 7:23
21/4/2021,Nakhon Ratchasima,35,305,2633610,1294642,1338968,314682,313761,921,55,33,19/1/2022 7:23
21/4/2021,Nakhon Si Thammarat,13,95,1550947,765252,785695,108124,107604,520,,,19/1/2022 7:23
21/4/2021,Nakhon Sawan,0,150,1038712,506804,531908,115116,115001,115,73,41,19/1/2022 7:23
21/4/2021,Nonthaburi,69,1120,1281245,596307,684938,33945,33820,125,41,32,19/1/2022 7:23
21/4/2021,Narathiwat,21,495,806698,398996,407702,12366,12366,0,38,17,19/1/2022 7:23
21/4/2021,Nan,5,49,476372,238449,237923,60575,60465,110,,,19/1/2022 7:23
21/4/2021,Bueng Kan,0,10,422066,211554,210512,5420,5420,0,,,19/1/2022 7:23
21/4/2021,Buri Ram,5,77,1580079,784198,795881,38966,38860,106,,,19/1/2022 7:23
21/4/2021,Pathum Thani,24,1156,1180730,559573,621157,17584,17443,141,71,32,19/1/2022 7:23
21/4/2021,Prachuap Khiri Khan,47,884,551205,272975,278230,275365,275243,122,,,19/1/2022 7:23
21/4/2021,Prachin Buri,17,91,494574,244431,250143,62857,62857,0,66,31,19/1/2022 7:23
21/4/2021,Pattani,0,104,727686,359470,368216,11318,11318,0,,,19/1/2022 7:23
21/4/2021,Phra Nakhon Si Ayutthaya,21,261,819654,393768,425886,230549,229807,742,68,58,19/1/2022 7:23
21/4/2021,Phayao,3,63,466174,226975,239199,34541,34442,99,71,44,19/1/2022 7:23
21/4/2021,Phang-nga,4,25,268508,133879,134629,132253,130614,1639,,,19/1/2022 7:23
21/4/2021,Phatthalung,19,70,523116,254885,268231,50714,50714,0,,,19/1/2022 7:23
21/4/2021,Phichit,0,17,531541,259263,272278,52325,52325,0,,,19/1/2022 7:23
21/4/2021,Phitsanulok,10,189,848043,415270,432773,150029,149890,139,,,19/1/2022 7:23
21/4/2021,Phuket,18,473,413242,195176,218066,185057,183877,1180,49,22,19/1/2022 7:23
21/4/2021,Maha Sarakham,12,81,951507,466454,485053,12276,12276,0,,,19/1/2022 7:23
21/4/2021,Mukdahan,1,15,350834,175233,175601,29874,29874,0,,,19/1/2022 7:23
21/4/2021,Yala,3,162,539921,268685,271236,29789,29789,0,48,19,19/1/2022 7:23
21/4/2021,Yasothon,2,20,534065,266640,267425,23761,23761,0,,,19/1/2022 7:23
21/4/2021,Ranong,0,12,194741,98300,96441,52522,52361,161,,,19/1/2022 7:23
21/4/2021,Rayong,64,892,744962,365850,379112,102268,101970,298,33,26,19/1/2022 7:23
21/4/2021,Ratchaburi,12,180,869447,422955,446492,42340,42325,15,,,19/1/2022 7:23
21/4/2021,Roi Et,5,47,1297612,643180,654432,9529,9529,0,,,19/1/2022 7:23
21/4/2021,Lop Buri,8,94,741974,370517,371457,54769,54707,62,,,19/1/2022 7:23
21/4/2021,Lampang,6,152,727166,354266,372900,88127,87577,550,71,52,19/1/2022 7:23
21/4/2021,Lamphun,19,200,401750,193199,208551,70522,70337,185,,,19/1/2022 7:23
21/4/2021,Si Sa Ket,17,78,1457730,725631,732099,15523,15523,0,,,19/1/2022 7:23
21/4/2021,Sakon Nakhon,5,39,1146692,569813,576879,27390,27375,15,,,19/1/2022 7:23
21/4/2021,Songkhla,41,459,1429058,696568,732490,69929,69891,38,52,33,19/1/2022 7:23
21/4/2021,Satun,1,28,324321,161388,162933,73143,72554,589,28,14,19/1/2022 7:23
21/4/2021,Samut Prakarn,39,1609,1354390,645522,708868,27501,27263,238,,,19/1/2022 7:23
21/4/2021,Samut Songkhram,2,88,191749,91610,100139,126386,126314,72,25,15,19/1/2022 7:23
21/4/2021,Samut Sakhon,54,17590,586317,282574,303743,6690,6639,51,67,52,19/1/2022 7:23
21/4/2021,Saraburi,5,90,644230,316852,327378,96839,96724,115,92,78,19/1/2022 7:23
21/4/2021,Sa kaeo,12,224,561071,280075,280996,23441,23441,0,19,11,19/1/2022 7:23
21/4/2021,Sing Buri,0,41,205427,97606,107821,17847,17847,0,,,19/1/2022 7:23
21/4/2021,Suphan Buri,5,184,837370,404033,433337,72907,72907,0,,,19/1/2022 7:23
21/4/2021,Surat Thani,22,261,1068273,526182,542091,65669,65132,537,89,35,19/1/2022 7:23
21/4/2021,Surin,6,58,1377326,685192,692134,24004,23993,11,,,19/1/2022 7:23
21/4/2021,Sukhothai,10,29,586830,284310,302520,56642,55966,676,,,19/1/2022 7:23
21/4/2021,Nong Khai,7,29,517147,256546,260601,20943,20864,79,27,11,19/1/2022 7:23
21/4/2021,Nong Bua Lam Phu,0,21,509129,253956,255173,4947,4947,0,,,19/1/2022 7:23
21/4/2021,Amnat Charoen,2,25,376158,187258,188900,7354,7354,0,,,19/1/2022 7:23
21/4/2021,Udon Thani,16,207,1567503,776622,790881,39172,39152,20,,,19/1/2022 7:23
21/4/2021,Uttaradit,1,53,447754,218285,229469,47493,47493,0,,,19/1/2022 7:23
21/4/2021,Uthai Thani,0,10,325542,159106,166436,61633,61633,0,,,19/1/2022 7:23
21/4/2021,Ubon Ratchathani,7,157,1866247,931793,934454,115331,115317,14,88,43,19/1/2022 7:23
21/4/2021,Ang Thong,3,147,275944,132088,143856,35544,35544,0,,,19/1/2022 7:23
21/4/2021,Chiang Rai,21,269,1295958,630131,665827,132092,131542,550,90,48,19/1/2022 7:23
21/4/2021,Chiang Mai,134,2565,1785706,863274,922432,396241,392204,4037,101,58,19/1/2022 7:23
21/4/2021,Phetchaburi,25,325,482292,232840,249452,385714,385488,226,,,19/1/2022 7:23
21/4/2021,Phetchabun,4,43,980662,483966,496696,95174,94812,362,,,19/1/2022 7:23
21/4/2021,Loei,4,32,638441,319953,318488,50148,50126,22,48,34,19/1/2022 7:23
21/4/2021,Phrae,5,55,436290,210317,225973,62210,62067,143,75,40,19/1/2022 7:23
21/4/2021,Mae Hong Son,2,35,285552,144717,140835,42084,41573,511,139,60,19/1/2022 7:23
21/4/2021,,0,153,,,,,,,,,19/1/2022 7:23
22/4/2021,Krabi,2,68,478376,237526,240850,100764,99754,1010,,,19/1/2022 7:23
22/4/2021,Bangkok,446,9701,5574497,2617639,2956858,1115611,1063854,51757,83,42,19/1/2022 7:23
22/4/2021,Kanchanaburi,6,78,892843,448201,444642,243519,243308,211,57,26,19/1/2022 7:23
22/4/2021,Kalasin,2,39,976734,482933,493801,12687,12687,0,,,19/1/2022 7:23
22/4/2021,Kamphaeng Phet,1,39,713471,352392,361079,39769,39688,81,,,19/1/2022 7:23
22/4/2021,Khon Kaen,12,199,1793256,881683,911573,57354,57291,63,97,47,19/1/2022 7:23
22/4/2021,Chanthaburi,7,297,535634,261945,273689,116001,115931,70,,,19/1/2022 7:23
22/4/2021,Chachoengsao,26,218,721596,353738,367858,29877,29877,0,68,48,19/1/2022 7:23
22/4/2021,Chon Buri,97,3060,1572004,766532,805472,156392,155350,1042,58,38,19/1/2022 7:23
22/4/2021,Chai Nat,0,16,321758,154645,167113,31521,31521,0,,,19/1/2022 7:23
22/4/2021,Chaiyaphum,12,57,1123903,555222,568681,40561,40512,49,,,19/1/2022 7:23
22/4/2021,Chumphon,2,67,509518,251414,258104,61047,60995,52,,,19/1/2022 7:23
22/4/2021,Trang,5,36,640411,313222,327189,40640,40547,93,,,19/1/2022 7:23
22/4/2021,Trat,3,56,228569,113072,115497,137616,137392,224,,,19/1/2022 7:23
22/4/2021,Tak,3,377,672976,340316,332660,59385,59312,73,,,19/1/2022 7:23
22/4/2021,Nakhon Nayok,4,53,259750,128155,131595,76708,76708,0,,,19/1/2022 7:23
22/4/2021,Nakhon Pathom,21,483,922448,443178,479270,98319,98268,51,57,28,19/1/2022 7:23
22/4/2021,Nakhon Phanom,7,62,716791,357234,359557,27584,27557,27,,,19/1/2022 7:23
22/4/2021,Nakhon Ratchasima,0,305,2633610,1294642,1338968,314682,313761,921,68,35,19/1/2022 7:23
22/4/2021,Nakhon Si Thammarat,21,116,1550947,765252,785695,108124,107604,520,,,19/1/2022 7:23
22/4/2021,Nakhon Sawan,29,179,1038712,506804,531908,115116,115001,115,90,49,19/1/2022 7:23
22/4/2021,Nonthaburi,118,1238,1281245,596307,684938,33945,33820,125,66,34,19/1/2022 7:23
22/4/2021,Narathiwat,23,518,806698,398996,407702,12366,12366,0,39,18,19/1/2022 7:23
22/4/2021,Nan,0,49,476372,238449,237923,60575,60465,110,,,19/1/2022 7:23
22/4/2021,Bueng Kan,1,11,422066,211554,210512,5420,5420,0,,,19/1/2022 7:23
22/4/2021,Buri Ram,5,82,1580079,784198,795881,38966,38860,106,,,19/1/2022 7:23
22/4/2021,Pathum Thani,31,1187,1180730,559573,621157,17584,17443,141,80,26,19/1/2022 7:23
22/4/2021,Prachuap Khiri Khan,37,921,551205,272975,278230,275365,275243,122,,,19/1/2022 7:23
22/4/2021,Prachin Buri,4,95,494574,244431,250143,62857,62857,0,70,37,19/1/2022 7:23
22/4/2021,Pattani,2,106,727686,359470,368216,11318,11318,0,,,19/1/2022 7:23
22/4/2021,Phra Nakhon Si Ayutthaya,25,286,819654,393768,425886,230549,229807,742,73,57,19/1/2022 7:23
22/4/2021,Phayao,4,67,466174,226975,239199,34541,34442,99,90,53,19/1/2022 7:23
22/4/2021,Phang-nga,5,30,268508,133879,134629,132253,130614,1639,,,19/1/2022 7:23
22/4/2021,Phatthalung,6,76,523116,254885,268231,50714,50714,0,,,19/1/2022 7:23
22/4/2021,Phichit,0,17,531541,259263,272278,52325,52325,0,,,19/1/2022 7:23
22/4/2021,Phitsanulok,10,199,848043,415270,432773,150029,149890,139,,,19/1/2022 7:23
22/4/2021,Phuket,9,482,413242,195176,218066,185057,183877,1180,48,21,19/1/2022 7:23
22/4/2021,Maha Sarakham,8,89,951507,466454,485053,12276,12276,0,,,19/1/2022 7:23
22/4/2021,Mukdahan,2,17,350834,175233,175601,29874,29874,0,,,19/1/2022 7:23
22/4/2021,Yala,3,165,539921,268685,271236,29789,29789,0,48,19,19/1/2022 7:23
22/4/2021,Yasothon,0,20,534065,266640,267425,23761,23761,0,,,19/1/2022 7:23
22/4/2021,Ranong,8,20,194741,98300,96441,52522,52361,161,,,19/1/2022 7:23
22/4/2021,Rayong,18,910,744962,365850,379112,102268,101970,298,52,37,19/1/2022 7:23
22/4/2021,Ratchaburi,21,201,869447,422955,446492,42340,42325,15,,,19/1/2022 7:23
22/4/2021,Roi Et,10,57,1297612,643180,654432,9529,9529,0,,,19/1/2022 7:23
22/4/2021,Lop Buri,5,99,741974,370517,371457,54769,54707,62,,,19/1/2022 7:23
22/4/2021,Lampang,10,162,727166,354266,372900,88127,87577,550,105,58,19/1/2022 7:23
22/4/2021,Lamphun,7,207,401750,193199,208551,70522,70337,185,,,19/1/2022 7:23
22/4/2021,Si Sa Ket,15,93,1457730,725631,732099,15523,15523,0,,,19/1/2022 7:23
22/4/2021,Sakon Nakhon,2,41,1146692,569813,576879,27390,27375,15,,,19/1/2022 7:23
22/4/2021,Songkhla,42,501,1429058,696568,732490,69929,69891,38,63,36,19/1/2022 7:23
22/4/2021,Satun,0,28,324321,161388,162933,73143,72554,589,33,12,19/1/2022 7:23
22/4/2021,Samut Prakarn,39,1648,1354390,645522,708868,27501,27263,238,,,19/1/2022 7:23
22/4/2021,Samut Songkhram,1,89,191749,91610,100139,126386,126314,72,37,18,19/1/2022 7:23
22/4/2021,Samut Sakhon,30,17620,586317,282574,303743,6690,6639,51,94,43,19/1/2022 7:23
22/4/2021,Saraburi,8,98,644230,316852,327378,96839,96724,115,101,68,19/1/2022 7:23
22/4/2021,Sa kaeo,11,235,561071,280075,280996,23441,23441,0,30,19,19/1/2022 7:23
22/4/2021,Sing Buri,3,44,205427,97606,107821,17847,17847,0,,,19/1/2022 7:23
22/4/2021,Suphan Buri,0,184,837370,404033,433337,72907,72907,0,,,19/1/2022 7:23
22/4/2021,Surat Thani,41,302,1068273,526182,542091,65669,65132,537,70,37,19/1/2022 7:23
22/4/2021,Surin,3,61,1377326,685192,692134,24004,23993,11,,,19/1/2022 7:23
22/4/2021,Sukhothai,9,38,586830,284310,302520,56642,55966,676,,,19/1/2022 7:23
22/4/2021,Nong Khai,5,34,517147,256546,260601,20943,20864,79,28,10,19/1/2022 7:23
22/4/2021,Nong Bua Lam Phu,1,22,509129,253956,255173,4947,4947,0,,,19/1/2022 7:23
22/4/2021,Amnat Charoen,0,25,376158,187258,188900,7354,7354,0,,,19/1/2022 7:23
22/4/2021,Udon Thani,25,232,1567503,776622,790881,39172,39152,20,,,19/1/2022 7:23
22/4/2021,Uttaradit,4,57,447754,218285,229469,47493,47493,0,,,19/1/2022 7:23
22/4/2021,Uthai Thani,0,10,325542,159106,166436,61633,61633,0,,,19/1/2022 7:23
22/4/2021,Ubon Ratchathani,12,169,1866247,931793,934454,115331,115317,14,96,29,19/1/2022 7:23
22/4/2021,Ang Thong,0,147,275944,132088,143856,35544,35544,0,,,19/1/2022 7:23
22/4/2021,Chiang Rai,16,285,1295958,630131,665827,132092,131542,550,112,57,19/1/2022 7:23
22/4/2021,Chiang Mai,99,2664,1785706,863274,922432,396241,392204,4037,126,61,19/1/2022 7:23
22/4/2021,Phetchaburi,21,346,482292,232840,249452,385714,385488,226,,,19/1/2022 7:23
22/4/2021,Phetchabun,1,44,980662,483966,496696,95174,94812,362,,,19/1/2022 7:23
22/4/2021,Loei,3,35,638441,319953,318488,50148,50126,22,65,50,19/1/2022 7:23
22/4/2021,Phrae,0,55,436290,210317,225973,62210,62067,143,87,51,19/1/2022 7:23
22/4/2021,Mae Hong Son,1,36,285552,144717,140835,42084,41573,511,155,61,19/1/2022 7:23
22/4/2021,,0,153,,,,,,,,,19/1/2022 7:23
23/4/2021,Krabi,3,71,478376,237526,240850,100764,99754,1010,,,19/1/2022 7:23
23/4/2021,Bangkok,741,10442,5574497,2617639,2956858,1115611,1063854,51757,77,43,19/1/2022 7:23
23/4/2021,Kanchanaburi,3,81,892843,448201,444642,243519,243308,211,62,29,19/1/2022 7:23
23/4/2021,Kalasin,3,42,976734,482933,493801,12687,12687,0,,,19/1/2022 7:23
23/4/2021,Kamphaeng Phet,0,39,713471,352392,361079,39769,39688,81,,,19/1/2022 7:23
23/4/2021,Khon Kaen,13,212,1793256,881683,911573,57354,57291,63,92,49,19/1/2022 7:23
23/4/2021,Chanthaburi,21,318,535634,261945,273689,116001,115931,70,,,19/1/2022 7:23
23/4/2021,Chachoengsao,9,227,721596,353738,367858,29877,29877,0,89,45,19/1/2022 7:23
23/4/2021,Chon Buri,126,3186,1572004,766532,805472,156392,155350,1042,68,37,19/1/2022 7:23
23/4/2021,Chai Nat,2,18,321758,154645,167113,31521,31521,0,,,19/1/2022 7:23
23/4/2021,Chaiyaphum,4,61,1123903,555222,568681,40561,40512,49,,,19/1/2022 7:23
23/4/2021,Chumphon,0,67,509518,251414,258104,61047,60995,52,,,19/1/2022 7:23
23/4/2021,Trang,7,43,640411,313222,327189,40640,40547,93,,,19/1/2022 7:23
23/4/2021,Trat,1,57,228569,113072,115497,137616,137392,224,,,19/1/2022 7:23
23/4/2021,Tak,5,382,672976,340316,332660,59385,59312,73,,,19/1/2022 7:23
23/4/2021,Nakhon Nayok,7,60,259750,128155,131595,76708,76708,0,,,19/1/2022 7:23
23/4/2021,Nakhon Pathom,24,507,922448,443178,479270,98319,98268,51,58,32,19/1/2022 7:23
23/4/2021,Nakhon Phanom,5,67,716791,357234,359557,27584,27557,27,,,19/1/2022 7:23
23/4/2021,Nakhon Ratchasima,69,374,2633610,1294642,1338968,314682,313761,921,73,38,19/1/2022 7:23
23/4/2021,Nakhon Si Thammarat,17,133,1550947,765252,785695,108124,107604,520,,,19/1/2022 7:23
23/4/2021,Nakhon Sawan,4,183,1038712,506804,531908,115116,115001,115,105,48,19/1/2022 7:23
23/4/2021,Nonthaburi,34,1272,1281245,596307,684938,33945,33820,125,57,33,19/1/2022 7:23
23/4/2021,Narathiwat,27,545,806698,398996,407702,12366,12366,0,34,16,19/1/2022 7:23
23/4/2021,Nan,14,63,476372,238449,237923,60575,60465,110,,,19/1/2022 7:23
23/4/2021,Bueng Kan,0,11,422066,211554,210512,5420,5420,0,,,19/1/2022 7:23
23/4/2021,Buri Ram,6,88,1580079,784198,795881,38966,38860,106,,,19/1/2022 7:23
23/4/2021,Pathum Thani,41,1228,1180730,559573,621157,17584,17443,141,69,38,19/1/2022 7:23
23/4/2021,Prachuap Khiri Khan,44,965,551205,272975,278230,275365,275243,122,,,19/1/2022 7:23
23/4/2021,Prachin Buri,14,109,494574,244431,250143,62857,62857,0,53,34,19/1/2022 7:23
23/4/2021,Pattani,8,114,727686,359470,368216,11318,11318,0,,,19/1/2022 7:23
23/4/2021,Phra Nakhon Si Ayutthaya,31,317,819654,393768,425886,230549,229807,742,77,58,19/1/2022 7:23
23/4/2021,Phayao,3,70,466174,226975,239199,34541,34442,99,112,58,19/1/2022 7:23
23/4/2021,Phang-nga,2,32,268508,133879,134629,132253,130614,1639,,,19/1/2022 7:23
23/4/2021,Phatthalung,10,86,523116,254885,268231,50714,50714,0,,,19/1/2022 7:23
23/4/2021,Phichit,4,21,531541,259263,272278,52325,52325,0,,,19/1/2022 7:23
23/4/2021,Phitsanulok,9,208,848043,415270,432773,150029,149890,139,,,19/1/2022 7:23
23/4/2021,Phuket,22,504,413242,195176,218066,185057,183877,1180,52,25,19/1/2022 7:23
23/4/2021,Maha Sarakham,12,101,951507,466454,485053,12276,12276,0,,,19/1/2022 7:23
23/4/2021,Mukdahan,0,17,350834,175233,175601,29874,29874,0,,,19/1/2022 7:23
23/4/2021,Yala,10,175,539921,268685,271236,29789,29789,0,45,16,19/1/2022 7:23
23/4/2021,Yasothon,4,24,534065,266640,267425,23761,23761,0,,,19/1/2022 7:23
23/4/2021,Ranong,15,35,194741,98300,96441,52522,52361,161,,,19/1/2022 7:23
23/4/2021,Rayong,35,945,744962,365850,379112,102268,101970,298,63,27,19/1/2022 7:23
23/4/2021,Ratchaburi,17,218,869447,422955,446492,42340,42325,15,,,19/1/2022 7:23
23/4/2021,Roi Et,7,64,1297612,643180,654432,9529,9529,0,,,19/1/2022 7:23
23/4/2021,Lop Buri,3,102,741974,370517,371457,54769,54707,62,,,19/1/2022 7:23
23/4/2021,Lampang,9,171,727166,354266,372900,88127,87577,550,129,63,19/1/2022 7:23
23/4/2021,Lamphun,24,231,401750,193199,208551,70522,70337,185,,,19/1/2022 7:23
23/4/2021,Si Sa Ket,13,106,1457730,725631,732099,15523,15523,0,,,19/1/2022 7:23
23/4/2021,Sakon Nakhon,0,41,1146692,569813,576879,27390,27375,15,,,19/1/2022 7:23
23/4/2021,Songkhla,17,518,1429058,696568,732490,69929,69891,38,66,28,19/1/2022 7:23
23/4/2021,Satun,4,32,324321,161388,162933,73143,72554,589,21,11,19/1/2022 7:23
23/4/2021,Samut Prakarn,79,1727,1354390,645522,708868,27501,27263,238,,,19/1/2022 7:23
23/4/2021,Samut Songkhram,3,92,191749,91610,100139,126386,126314,72,41,18,19/1/2022 7:23
23/4/2021,Samut Sakhon,48,17668,586317,282574,303743,6690,6639,51,76,40,19/1/2022 7:23
23/4/2021,Saraburi,9,107,644230,316852,327378,96839,96724,115,92,57,19/1/2022 7:23
23/4/2021,Sa kaeo,12,247,561071,280075,280996,23441,23441,0,38,19,19/1/2022 7:23
23/4/2021,Sing Buri,6,50,205427,97606,107821,17847,17847,0,,,19/1/2022 7:23
23/4/2021,Suphan Buri,12,196,837370,404033,433337,72907,72907,0,,,19/1/2022 7:23
23/4/2021,Surat Thani,38,340,1068273,526182,542091,65669,65132,537,73,38,19/1/2022 7:23
23/4/2021,Surin,5,66,1377326,685192,692134,24004,23993,11,,,19/1/2022 7:23
23/4/2021,Sukhothai,16,54,586830,284310,302520,56642,55966,676,,,19/1/2022 7:23
23/4/2021,Nong Khai,6,40,517147,256546,260601,20943,20864,79,26,10,19/1/2022 7:23
23/4/2021,Nong Bua Lam Phu,4,26,509129,253956,255173,4947,4947,0,,,19/1/2022 7:23
23/4/2021,Amnat Charoen,1,26,376158,187258,188900,7354,7354,0,,,19/1/2022 7:23
23/4/2021,Udon Thani,28,260,1567503,776622,790881,39172,39152,20,,,19/1/2022 7:23
23/4/2021,Uttaradit,0,57,447754,218285,229469,47493,47493,0,,,19/1/2022 7:23
23/4/2021,Uthai Thani,1,11,325542,159106,166436,61633,61633,0,,,19/1/2022 7:23
23/4/2021,Ubon Ratchathani,9,178,1866247,931793,934454,115331,115317,14,67,30,19/1/2022 7:23
23/4/2021,Ang Thong,5,152,275944,132088,143856,35544,35544,0,,,19/1/2022 7:23
23/4/2021,Chiang Rai,17,302,1295958,630131,665827,132092,131542,550,132,58,19/1/2022 7:23
23/4/2021,Chiang Mai,237,2901,1785706,863274,922432,396241,392204,4037,141,65,19/1/2022 7:23
23/4/2021,Phetchaburi,22,368,482292,232840,249452,385714,385488,226,,,19/1/2022 7:23
23/4/2021,Phetchabun,4,48,980662,483966,496696,95174,94812,362,,,19/1/2022 7:23
23/4/2021,Loei,1,36,638441,319953,318488,50148,50126,22,87,48,19/1/2022 7:23
23/4/2021,Phrae,3,58,436290,210317,225973,62210,62067,143,111,55,19/1/2022 7:23
23/4/2021,Mae Hong Son,1,37,285552,144717,140835,42084,41573,511,156,58,19/1/2022 7:23
23/4/2021,,0,153,,,,,,,,,19/1/2022 7:23
24/4/2021,Krabi,5,76,478376,237526,240850,100764,99754,1010,,,19/1/2022 7:23
24/4/2021,Bangkok,1585,12027,5574497,2617639,2956858,1115611,1063854,51757,75,40,19/1/2022 7:23
24/4/2021,Kanchanaburi,12,93,892843,448201,444642,243519,243308,211,65,27,19/1/2022 7:23
24/4/2021,Kalasin,2,44,976734,482933,493801,12687,12687,0,,,19/1/2022 7:23
24/4/2021,Kamphaeng Phet,0,39,713471,352392,361079,39769,39688,81,,,19/1/2022 7:23
24/4/2021,Khon Kaen,31,243,1793256,881683,911573,57354,57291,63,94,55,19/1/2022 7:23
24/4/2021,Chanthaburi,8,326,535634,261945,273689,116001,115931,70,,,19/1/2022 7:23
24/4/2021,Chachoengsao,9,236,721596,353738,367858,29877,29877,0,70,44,19/1/2022 7:23
24/4/2021,Chon Buri,122,3308,1572004,766532,805472,156392,155350,1042,62,37,19/1/2022 7:23
24/4/2021,Chai Nat,2,20,321758,154645,167113,31521,31521,0,,,19/1/2022 7:23
24/4/2021,Chaiyaphum,4,65,1123903,555222,568681,40561,40512,49,,,19/1/2022 7:23
24/4/2021,Chumphon,1,68,509518,251414,258104,61047,60995,52,,,19/1/2022 7:23
24/4/2021,Trang,14,57,640411,313222,327189,40640,40547,93,,,19/1/2022 7:23
24/4/2021,Trat,0,57,228569,113072,115497,137616,137392,224,,,19/1/2022 7:23
24/4/2021,Tak,0,382,672976,340316,332660,59385,59312,73,,,19/1/2022 7:23
24/4/2021,Nakhon Nayok,5,65,259750,128155,131595,76708,76708,0,,,19/1/2022 7:23
24/4/2021,Nakhon Pathom,13,520,922448,443178,479270,98319,98268,51,55,34,19/1/2022 7:23
24/4/2021,Nakhon Phanom,6,73,716791,357234,359557,27584,27557,27,,,19/1/2022 7:23
24/4/2021,Nakhon Ratchasima,16,390,2633610,1294642,1338968,314682,313761,921,83,35,19/1/2022 7:23
24/4/2021,Nakhon Si Thammarat,20,153,1550947,765252,785695,108124,107604,520,,,19/1/2022 7:23
24/4/2021,Nakhon Sawan,38,221,1038712,506804,531908,115116,115001,115,100,50,19/1/2022 7:23
24/4/2021,Nonthaburi,102,1374,1281245,596307,684938,33945,33820,125,58,33,19/1/2022 7:23
24/4/2021,Narathiwat,4,549,806698,398996,407702,12366,12366,0,28,12,19/1/2022 7:23
24/4/2021,Nan,2,65,476372,238449,237923,60575,60465,110,,,19/1/2022 7:23
24/4/2021,Bueng Kan,1,12,422066,211554,210512,5420,5420,0,,,19/1/2022 7:23
24/4/2021,Buri Ram,7,95,1580079,784198,795881,38966,38860,106,,,19/1/2022 7:23
24/4/2021,Pathum Thani,59,1287,1180730,559573,621157,17584,17443,141,89,36,19/1/2022 7:23
24/4/2021,Prachuap Khiri Khan,23,988,551205,272975,278230,275365,275243,122,,,19/1/2022 7:23
24/4/2021,Prachin Buri,22,131,494574,244431,250143,62857,62857,0,47,42,19/1/2022 7:23
24/4/2021,Pattani,2,116,727686,359470,368216,11318,11318,0,,,19/1/2022 7:23
24/4/2021,Phra Nakhon Si Ayutthaya,24,341,819654,393768,425886,230549,229807,742,79,59,19/1/2022 7:23
24/4/2021,Phayao,4,74,466174,226975,239199,34541,34442,99,129,54,19/1/2022 7:23
24/4/2021,Phang-nga,0,32,268508,133879,134629,132253,130614,1639,,,19/1/2022 7:23
24/4/2021,Phatthalung,14,100,523116,254885,268231,50714,50714,0,,,19/1/2022 7:23
24/4/2021,Phichit,2,23,531541,259263,272278,52325,52325,0,,,19/1/2022 7:23
24/4/2021,Phitsanulok,12,220,848043,415270,432773,150029,149890,139,,,19/1/2022 7:23
24/4/2021,Phuket,11,515,413242,195176,218066,185057,183877,1180,55,22,19/1/2022 7:23
24/4/2021,Maha Sarakham,29,130,951507,466454,485053,12276,12276,0,,,19/1/2022 7:23
24/4/2021,Mukdahan,5,22,350834,175233,175601,29874,29874,0,,,19/1/2022 7:23
24/4/2021,Yala,0,175,539921,268685,271236,29789,29789,0,42,15,19/1/2022 7:23
24/4/2021,Yasothon,0,24,534065,266640,267425,23761,23761,0,,,19/1/2022 7:23
24/4/2021,Ranong,13,48,194741,98300,96441,52522,52361,161,,,19/1/2022 7:23
24/4/2021,Rayong,31,976,744962,365850,379112,102268,101970,298,61,36,19/1/2022 7:23
24/4/2021,Ratchaburi,16,234,869447,422955,446492,42340,42325,15,,,19/1/2022 7:23
24/4/2021,Roi Et,11,75,1297612,643180,654432,9529,9529,0,,,19/1/2022 7:23
24/4/2021,Lop Buri,6,108,741974,370517,371457,54769,54707,62,,,19/1/2022 7:23
24/4/2021,Lampang,8,179,727166,354266,372900,88127,87577,550,141,58,19/1/2022 7:23
24/4/2021,Lamphun,7,238,401750,193199,208551,70522,70337,185,,,19/1/2022 7:23
24/4/2021,Si Sa Ket,8,114,1457730,725631,732099,15523,15523,0,,,19/1/2022 7:23
24/4/2021,Sakon Nakhon,4,45,1146692,569813,576879,27390,27375,15,,,19/1/2022 7:23
24/4/2021,Songkhla,34,552,1429058,696568,732490,69929,69891,38,50,28,19/1/2022 7:23
24/4/2021,Satun,0,32,324321,161388,162933,73143,72554,589,15,11,19/1/2022 7:23
24/4/2021,Samut Prakarn,84,1811,1354390,645522,708868,27501,27263,238,,,19/1/2022 7:23
24/4/2021,Samut Songkhram,3,95,191749,91610,100139,126386,126314,72,43,19,19/1/2022 7:23
24/4/2021,Samut Sakhon,57,17725,586317,282574,303743,6690,6639,51,73,39,19/1/2022 7:23
24/4/2021,Saraburi,5,112,644230,316852,327378,96839,96724,115,79,70,19/1/2022 7:23
24/4/2021,Sa kaeo,17,264,561071,280075,280996,23441,23441,0,35,21,19/1/2022 7:23
24/4/2021,Sing Buri,1,51,205427,97606,107821,17847,17847,0,,,19/1/2022 7:23
24/4/2021,Suphan Buri,1,197,837370,404033,433337,72907,72907,0,,,19/1/2022 7:23
24/4/2021,Surat Thani,46,386,1068273,526182,542091,65669,65132,537,67,37,19/1/2022 7:23
24/4/2021,Surin,4,70,1377326,685192,692134,24004,23993,11,,,19/1/2022 7:23
24/4/2021,Sukhothai,16,70,586830,284310,302520,56642,55966,676,,,19/1/2022 7:23
24/4/2021,Nong Khai,3,43,517147,256546,260601,20943,20864,79,27,9,19/1/2022 7:23
24/4/2021,Nong Bua Lam Phu,2,28,509129,253956,255173,4947,4947,0,,,19/1/2022 7:23
24/4/2021,Amnat Charoen,1,27,376158,187258,188900,7354,7354,0,,,19/1/2022 7:23
24/4/2021,Udon Thani,20,280,1567503,776622,790881,39172,39152,20,,,19/1/2022 7:23
24/4/2021,Uttaradit,0,57,447754,218285,229469,47493,47493,0,,,19/1/2022 7:23
24/4/2021,Uthai Thani,0,11,325542,159106,166436,61633,61633,0,,,19/1/2022 7:23
24/4/2021,Ubon Ratchathani,15,193,1866247,931793,934454,115331,115317,14,72,39,19/1/2022 7:23
24/4/2021,Ang Thong,3,155,275944,132088,143856,35544,35544,0,,,19/1/2022 7:23
24/4/2021,Chiang Rai,19,321,1295958,630131,665827,132092,131542,550,143,41,19/1/2022 7:23
24/4/2021,Chiang Mai,151,3052,1785706,863274,922432,396241,392204,4037,148,50,19/1/2022 7:23
24/4/2021,Phetchaburi,26,394,482292,232840,249452,385714,385488,226,,,19/1/2022 7:23
24/4/2021,Phetchabun,1,49,980662,483966,496696,95174,94812,362,,,19/1/2022 7:23
24/4/2021,Loei,7,43,638441,319953,318488,50148,50126,22,97,49,19/1/2022 7:23
24/4/2021,Phrae,2,60,436290,210317,225973,62210,62067,143,125,57,19/1/2022 7:23
24/4/2021,Mae Hong Son,1,38,285552,144717,140835,42084,41573,511,151,55,19/1/2022 7:23
24/4/2021,,0,153,,,,,,,,,19/1/2022 7:23
25/4/2021,Krabi,4,80,478376,237526,240850,100764,99754,1010,,,19/1/2022 7:23
25/4/2021,Bangkok,1079,13106,5574497,2617639,2956858,1115611,1063854,51757,84,39,19/1/2022 7:23
25/4/2021,Kanchanaburi,2,95,892843,448201,444642,243519,243308,211,62,19,19/1/2022 7:23
25/4/2021,Kalasin,8,52,976734,482933,493801,12687,12687,0,,,19/1/2022 7:23
25/4/2021,Kamphaeng Phet,21,60,713471,352392,361079,39769,39688,81,,,19/1/2022 7:23
25/4/2021,Khon Kaen,26,269,1793256,881683,911573,57354,57291,63,105,59,19/1/2022 7:23
25/4/2021,Chanthaburi,14,340,535634,261945,273689,116001,115931,70,,,19/1/2022 7:23
25/4/2021,Chachoengsao,11,247,721596,353738,367858,29877,29877,0,70,48,19/1/2022 7:23
25/4/2021,Chon Buri,79,3387,1572004,766532,805472,156392,155350,1042,69,37,19/1/2022 7:23
25/4/2021,Chai Nat,2,22,321758,154645,167113,31521,31521,0,,,19/1/2022 7:23
25/4/2021,Chaiyaphum,8,73,1123903,555222,568681,40561,40512,49,,,19/1/2022 7:23
25/4/2021,Chumphon,5,73,509518,251414,258104,61047,60995,52,,,19/1/2022 7:23
25/4/2021,Trang,3,60,640411,313222,327189,40640,40547,93,,,19/1/2022 7:23
25/4/2021,Trat,1,58,228569,113072,115497,137616,137392,224,,,19/1/2022 7:23
25/4/2021,Tak,2,384,672976,340316,332660,59385,59312,73,,,19/1/2022 7:23
25/4/2021,Nakhon Nayok,5,70,259750,128155,131595,76708,76708,0,,,19/1/2022 7:23
25/4/2021,Nakhon Pathom,16,536,922448,443178,479270,98319,98268,51,67,24,19/1/2022 7:23
25/4/2021,Nakhon Phanom,3,76,716791,357234,359557,27584,27557,27,,,19/1/2022 7:23
25/4/2021,Nakhon Ratchasima,54,444,2633610,1294642,1338968,314682,313761,921,78,38,19/1/2022 7:23
25/4/2021,Nakhon Si Thammarat,55,208,1550947,765252,785695,108124,107604,520,,,19/1/2022 7:23
25/4/2021,Nakhon Sawan,24,245,1038712,506804,531908,115116,115001,115,104,39,19/1/2022 7:23
25/4/2021,Nonthaburi,113,1487,1281245,596307,684938,33945,33820,125,57,32,19/1/2022 7:23
25/4/2021,Narathiwat,6,555,806698,398996,407702,12366,12366,0,24,18,19/1/2022 7:23
25/4/2021,Nan,4,69,476372,238449,237923,60575,60465,110,,,19/1/2022 7:23
25/4/2021,Bueng Kan,0,12,422066,211554,210512,5420,5420,0,,,19/1/2022 7:23
25/4/2021,Buri Ram,3,98,1580079,784198,795881,38966,38860,106,,,19/1/2022 7:23
25/4/2021,Pathum Thani,42,1329,1180730,559573,621157,17584,17443,141,83,25,19/1/2022 7:23
25/4/2021,Prachuap Khiri Khan,20,1008,551205,272975,278230,275365,275243,122,,,19/1/2022 7:23
25/4/2021,Prachin Buri,13,144,494574,244431,250143,62857,62857,0,90,31,19/1/2022 7:23
25/4/2021,Pattani,27,143,727686,359470,368216,11318,11318,0,,,19/1/2022 7:23
25/4/2021,Phra Nakhon Si Ayutthaya,28,369,819654,393768,425886,230549,229807,742,78,47,19/1/2022 7:23
25/4/2021,Phayao,2,76,466174,226975,239199,34541,34442,99,115,31,19/1/2022 7:23
25/4/2021,Phang-nga,0,32,268508,133879,134629,132253,130614,1639,,,19/1/2022 7:23
25/4/2021,Phatthalung,14,114,523116,254885,268231,50714,50714,0,,,19/1/2022 7:23
25/4/2021,Phichit,6,29,531541,259263,272278,52325,52325,0,,,19/1/2022 7:23
25/4/2021,Phitsanulok,9,229,848043,415270,432773,150029,149890,139,,,19/1/2022 7:23
25/4/2021,Phuket,22,537,413242,195176,218066,185057,183877,1180,50,23,19/1/2022 7:23
25/4/2021,Maha Sarakham,12,142,951507,466454,485053,12276,12276,0,,,19/1/2022 7:23
25/4/2021,Mukdahan,0,22,350834,175233,175601,29874,29874,0,,,19/1/2022 7:23
25/4/2021,Yala,6,181,539921,268685,271236,29789,29789,0,35,22,19/1/2022 7:23
25/4/2021,Yasothon,8,32,534065,266640,267425,23761,23761,0,,,19/1/2022 7:23
25/4/2021,Ranong,25,73,194741,98300,96441,52522,52361,161,,,19/1/2022 7:23
25/4/2021,Rayong,31,1007,744962,365850,379112,102268,101970,298,73,32,19/1/2022 7:23
25/4/2021,Ratchaburi,18,252,869447,422955,446492,42340,42325,15,,,19/1/2022 7:23
25/4/2021,Roi Et,23,98,1297612,643180,654432,9529,9529,0,,,19/1/2022 7:23
25/4/2021,Lop Buri,10,118,741974,370517,371457,54769,54707,62,,,19/1/2022 7:23
25/4/2021,Lampang,2,181,727166,354266,372900,88127,87577,550,126,37,19/1/2022 7:23
25/4/2021,Lamphun,7,245,401750,193199,208551,70522,70337,185,,,19/1/2022 7:23
25/4/2021,Si Sa Ket,10,124,1457730,725631,732099,15523,15523,0,,,19/1/2022 7:23
25/4/2021,Sakon Nakhon,1,46,1146692,569813,576879,27390,27375,15,,,19/1/2022 7:23
25/4/2021,Songkhla,51,603,1429058,696568,732490,69929,69891,38,65,31,19/1/2022 7:23
25/4/2021,Satun,2,34,324321,161388,162933,73143,72554,589,16,19,19/1/2022 7:23
25/4/2021,Samut Prakarn,77,1888,1354390,645522,708868,27501,27263,238,,,19/1/2022 7:23
25/4/2021,Samut Songkhram,2,97,191749,91610,100139,126386,126314,72,49,18,19/1/2022 7:23
25/4/2021,Samut Sakhon,52,17777,586317,282574,303743,6690,6639,51,80,41,19/1/2022 7:23
25/4/2021,Saraburi,11,123,644230,316852,327378,96839,96724,115,80,76,19/1/2022 7:23
25/4/2021,Sa kaeo,27,291,561071,280075,280996,23441,23441,0,44,16,19/1/2022 7:23
25/4/2021,Sing Buri,0,51,205427,97606,107821,17847,17847,0,,,19/1/2022 7:23
25/4/2021,Suphan Buri,5,202,837370,404033,433337,72907,72907,0,,,19/1/2022 7:23
25/4/2021,Surat Thani,54,440,1068273,526182,542091,65669,65132,537,71,35,19/1/2022 7:23
25/4/2021,Surin,5,75,1377326,685192,692134,24004,23993,11,,,19/1/2022 7:23
25/4/2021,Sukhothai,12,82,586830,284310,302520,56642,55966,676,,,19/1/2022 7:23
25/4/2021,Nong Khai,2,45,517147,256546,260601,20943,20864,79,23,10,19/1/2022 7:23
25/4/2021,Nong Bua Lam Phu,0,28,509129,253956,255173,4947,4947,0,,,19/1/2022 7:23
25/4/2021,Amnat Charoen,0,27,376158,187258,188900,7354,7354,0,,,19/1/2022 7:23
25/4/2021,Udon Thani,21,301,1567503,776622,790881,39172,39152,20,,,19/1/2022 7:23
25/4/2021,Uttaradit,1,58,447754,218285,229469,47493,47493,0,,,19/1/2022 7:23
25/4/2021,Uthai Thani,2,13,325542,159106,166436,61633,61633,0,,,19/1/2022 7:23
25/4/2021,Ubon Ratchathani,10,203,1866247,931793,934454,115331,115317,14,91,41,19/1/2022 7:23
25/4/2021,Ang Thong,0,155,275944,132088,143856,35544,35544,0,,,19/1/2022 7:23
25/4/2021,Chiang Rai,34,355,1295958,630131,665827,132092,131542,550,102,30,19/1/2022 7:23
25/4/2021,Chiang Mai,163,3215,1785706,863274,922432,396241,392204,4037,109,43,19/1/2022 7:23
25/4/2021,Phetchaburi,17,411,482292,232840,249452,385714,385488,226,,,19/1/2022 7:23
25/4/2021,Phetchabun,0,49,980662,483966,496696,95174,94812,362,,,19/1/2022 7:23
25/4/2021,Loei,3,46,638441,319953,318488,50148,50126,22,104,33,19/1/2022 7:23
25/4/2021,Phrae,2,62,436290,210317,225973,62210,62067,143,130,41,19/1/2022 7:23
25/4/2021,Mae Hong Son,1,39,285552,144717,140835,42084,41573,511,146,43,19/1/2022 7:23
25/4/2021,,0,153,,,,,,,,,19/1/2022 7:23
26/4/2021,Krabi,0,80,478376,237526,240850,100764,99754,1010,,,19/1/2022 7:23
26/4/2021,Bangkok,908,14014,5574497,2617639,2956858,1115611,1063854,51757,79,32,19/1/2022 7:23
26/4/2021,Kanchanaburi,3,98,892843,448201,444642,243519,243308,211,50,19,19/1/2022 7:23
26/4/2021,Kalasin,5,57,976734,482933,493801,12687,12687,0,,,19/1/2022 7:23
26/4/2021,Kamphaeng Phet,26,86,713471,352392,361079,39769,39688,81,,,19/1/2022 7:23
26/4/2021,Khon Kaen,11,280,1793256,881683,911573,57354,57291,63,118,27,19/1/2022 7:23
26/4/2021,Chanthaburi,14,354,535634,261945,273689,116001,115931,70,,,19/1/2022 7:23
26/4/2021,Chachoengsao,8,255,721596,353738,367858,29877,29877,0,80,42,19/1/2022 7:23
26/4/2021,Chon Buri,105,3492,1572004,766532,805472,156392,155350,1042,67,35,19/1/2022 7:23
26/4/2021,Chai Nat,4,26,321758,154645,167113,31521,31521,0,,,19/1/2022 7:23
26/4/2021,Chaiyaphum,10,83,1123903,555222,568681,40561,40512,49,,,19/1/2022 7:23
26/4/2021,Chumphon,5,78,509518,251414,258104,61047,60995,52,,,19/1/2022 7:23
26/4/2021,Trang,9,69,640411,313222,327189,40640,40547,93,,,19/1/2022 7:23
26/4/2021,Trat,5,63,228569,113072,115497,137616,137392,224,,,19/1/2022 7:23
26/4/2021,Tak,2,386,672976,340316,332660,59385,59312,73,,,19/1/2022 7:23
26/4/2021,Nakhon Nayok,0,70,259750,128155,131595,76708,76708,0,,,19/1/2022 7:23
26/4/2021,Nakhon Pathom,48,584,922448,443178,479270,98319,98268,51,52,29,19/1/2022 7:23
26/4/2021,Nakhon Phanom,7,83,716791,357234,359557,27584,27557,27,,,19/1/2022 7:23
26/4/2021,Nakhon Ratchasima,22,466,2633610,1294642,1338968,314682,313761,921,81,27,19/1/2022 7:23
26/4/2021,Nakhon Si Thammarat,23,231,1550947,765252,785695,108124,107604,520,,,19/1/2022 7:23
26/4/2021,Nakhon Sawan,9,254,1038712,506804,531908,115116,115001,115,84,25,19/1/2022 7:23
26/4/2021,Nonthaburi,99,1586,1281245,596307,684938,33945,33820,125,55,34,19/1/2022 7:23
26/4/2021,Narathiwat,2,557,806698,398996,407702,12366,12366,0,31,15,19/1/2022 7:23
26/4/2021,Nan,3,72,476372,238449,237923,60575,60465,110,,,19/1/2022 7:23
26/4/2021,Bueng Kan,0,12,422066,211554,210512,5420,5420,0,,,19/1/2022 7:23
26/4/2021,Buri Ram,9,107,1580079,784198,795881,38966,38860,106,,,19/1/2022 7:23
26/4/2021,Pathum Thani,0,1329,1180730,559573,621157,17584,17443,141,62,23,19/1/2022 7:23
26/4/2021,Prachuap Khiri Khan,18,1026,551205,272975,278230,275365,275243,122,,,19/1/2022 7:23
26/4/2021,Prachin Buri,16,160,494574,244431,250143,62857,62857,0,56,33,19/1/2022 7:23
26/4/2021,Pattani,4,147,727686,359470,368216,11318,11318,0,,,19/1/2022 7:23
26/4/2021,Phra Nakhon Si Ayutthaya,9,378,819654,393768,425886,230549,229807,742,56,53,19/1/2022 7:23
26/4/2021,Phayao,0,76,466174,226975,239199,34541,34442,99,69,29,19/1/2022 7:23
26/4/2021,Phang-nga,2,34,268508,133879,134629,132253,130614,1639,,,19/1/2022 7:23
26/4/2021,Phatthalung,11,125,523116,254885,268231,50714,50714,0,,,19/1/2022 7:23
26/4/2021,Phichit,5,34,531541,259263,272278,52325,52325,0,,,19/1/2022 7:23
26/4/2021,Phitsanulok,12,241,848043,415270,432773,150029,149890,139,,,19/1/2022 7:23
26/4/2021,Phuket,21,558,413242,195176,218066,185057,183877,1180,49,20,19/1/2022 7:23
26/4/2021,Maha Sarakham,13,155,951507,466454,485053,12276,12276,0,,,19/1/2022 7:23
26/4/2021,Mukdahan,0,22,350834,175233,175601,29874,29874,0,,,19/1/2022 7:23
26/4/2021,Yala,2,183,539921,268685,271236,29789,29789,0,45,18,19/1/2022 7:23
26/4/2021,Yasothon,6,38,534065,266640,267425,23761,23761,0,,,19/1/2022 7:23
26/4/2021,Ranong,6,79,194741,98300,96441,52522,52361,161,,,19/1/2022 7:23
26/4/2021,Rayong,21,1028,744962,365850,379112,102268,101970,298,65,27,19/1/2022 7:23
26/4/2021,Ratchaburi,22,274,869447,422955,446492,42340,42325,15,,,19/1/2022 7:23
26/4/2021,Roi Et,14,112,1297612,643180,654432,9529,9529,0,,,19/1/2022 7:23
26/4/2021,Lop Buri,4,122,741974,370517,371457,54769,54707,62,,,19/1/2022 7:23
26/4/2021,Lampang,7,188,727166,354266,372900,88127,87577,550,68,29,19/1/2022 7:23
26/4/2021,Lamphun,10,255,401750,193199,208551,70522,70337,185,,,19/1/2022 7:23
26/4/2021,Si Sa Ket,3,127,1457730,725631,732099,15523,15523,0,,,19/1/2022 7:23
26/4/2021,Sakon Nakhon,5,51,1146692,569813,576879,27390,27375,15,,,19/1/2022 7:23
26/4/2021,Songkhla,38,641,1429058,696568,732490,69929,69891,38,61,24,19/1/2022 7:23
26/4/2021,Satun,1,35,324321,161388,162933,73143,72554,589,37,11,19/1/2022 7:23
26/4/2021,Samut Prakarn,110,1998,1354390,645522,708868,27501,27263,238,,,19/1/2022 7:23
26/4/2021,Samut Songkhram,3,100,191749,91610,100139,126386,126314,72,41,15,19/1/2022 7:23
26/4/2021,Samut Sakhon,56,17833,586317,282574,303743,6690,6639,51,82,33,19/1/2022 7:23
26/4/2021,Saraburi,6,129,644230,316852,327378,96839,96724,115,83,113,19/1/2022 7:23
26/4/2021,Sa kaeo,11,302,561071,280075,280996,23441,23441,0,32,15,19/1/2022 7:23
26/4/2021,Sing Buri,3,54,205427,97606,107821,17847,17847,0,,,19/1/2022 7:23
26/4/2021,Suphan Buri,9,211,837370,404033,433337,72907,72907,0,,,19/1/2022 7:23
26/4/2021,Surat Thani,61,501,1068273,526182,542091,65669,65132,537,64,37,19/1/2022 7:23
26/4/2021,Surin,7,82,1377326,685192,692134,24004,23993,11,,,19/1/2022 7:23
26/4/2021,Sukhothai,4,86,586830,284310,302520,56642,55966,676,,,19/1/2022 7:23
26/4/2021,Nong Khai,5,50,517147,256546,260601,20943,20864,79,26,11,19/1/2022 7:23
26/4/2021,Nong Bua Lam Phu,0,28,509129,253956,255173,4947,4947,0,,,19/1/2022 7:23
26/4/2021,Amnat Charoen,4,31,376158,187258,188900,7354,7354,0,,,19/1/2022 7:23
26/4/2021,Udon Thani,19,320,1567503,776622,790881,39172,39152,20,,,19/1/2022 7:23
26/4/2021,Uttaradit,0,58,447754,218285,229469,47493,47493,0,,,19/1/2022 7:23
26/4/2021,Uthai Thani,2,15,325542,159106,166436,61633,61633,0,,,19/1/2022 7:23
26/4/2021,Ubon Ratchathani,2,205,1866247,931793,934454,115331,115317,14,91,18,19/1/2022 7:23
26/4/2021,Ang Thong,12,167,275944,132088,143856,35544,35544,0,,,19/1/2022 7:23
26/4/2021,Chiang Rai,19,374,1295958,630131,665827,132092,131542,550,67,21,19/1/2022 7:23
26/4/2021,Chiang Mai,84,3299,1785706,863274,922432,396241,392204,4037,90,33,19/1/2022 7:23
26/4/2021,Phetchaburi,32,443,482292,232840,249452,385714,385488,226,,,19/1/2022 7:23
26/4/2021,Phetchabun,10,59,980662,483966,496696,95174,94812,362,,,19/1/2022 7:23
26/4/2021,Loei,0,46,638441,319953,318488,50148,50126,22,66,21,19/1/2022 7:23
26/4/2021,Phrae,1,63,436290,210317,225973,62210,62067,143,93,26,19/1/2022 7:23
26/4/2021,Mae Hong Son,1,40,285552,144717,140835,42084,41573,511,112,32,19/1/2022 7:23
26/4/2021,,0,153,,,,,,,,,19/1/2022 7:23
27/4/2021,Krabi,3,83,478376,237526,240850,100764,99754,1010,,,19/1/2022 7:23
27/4/2021,Bangkok,994,15008,5574497,2617639,2956858,1115611,1063854,51757,66,41,19/1/2022 7:23
27/4/2021,Kanchanaburi,6,104,892843,448201,444642,243519,243308,211,49,29,19/1/2022 7:23
27/4/2021,Kalasin,4,61,976734,482933,493801,12687,12687,0,,,19/1/2022 7:23
27/4/2021,Kamphaeng Phet,7,93,713471,352392,361079,39769,39688,81,,,19/1/2022 7:23
27/4/2021,Khon Kaen,8,288,1793256,881683,911573,57354,57291,63,58,36,19/1/2022 7:23
27/4/2021,Chanthaburi,21,375,535634,261945,273689,116001,115931,70,,,19/1/2022 7:23
27/4/2021,Chachoengsao,18,273,721596,353738,367858,29877,29877,0,70,36,19/1/2022 7:23
27/4/2021,Chon Buri,83,3575,1572004,766532,805472,156392,155350,1042,65,35,19/1/2022 7:23
27/4/2021,Chai Nat,3,29,321758,154645,167113,31521,31521,0,,,19/1/2022 7:23
27/4/2021,Chaiyaphum,27,110,1123903,555222,568681,40561,40512,49,,,19/1/2022 7:23
27/4/2021,Chumphon,5,83,509518,251414,258104,61047,60995,52,,,19/1/2022 7:23
27/4/2021,Trang,8,77,640411,313222,327189,40640,40547,93,,,19/1/2022 7:23
27/4/2021,Trat,6,69,228569,113072,115497,137616,137392,224,,,19/1/2022 7:23
27/4/2021,Tak,0,386,672976,340316,332660,59385,59312,73,,,19/1/2022 7:23
27/4/2021,Nakhon Nayok,7,77,259750,128155,131595,76708,76708,0,,,19/1/2022 7:23
27/4/2021,Nakhon Pathom,28,612,922448,443178,479270,98319,98268,51,62,32,19/1/2022 7:23
27/4/2021,Nakhon Phanom,8,91,716791,357234,359557,27584,27557,27,,,19/1/2022 7:23
27/4/2021,Nakhon Ratchasima,33,499,2633610,1294642,1338968,314682,313761,921,58,30,19/1/2022 7:23
27/4/2021,Nakhon Si Thammarat,24,255,1550947,765252,785695,108124,107604,520,,,19/1/2022 7:23
27/4/2021,Nakhon Sawan,17,271,1038712,506804,531908,115116,115001,115,40,26,19/1/2022 7:23
27/4/2021,Nonthaburi,150,1736,1281245,596307,684938,33945,33820,125,56,66,19/1/2022 7:23
27/4/2021,Narathiwat,3,560,806698,398996,407702,12366,12366,0,29,19,19/1/2022 7:23
27/4/2021,Nan,4,76,476372,238449,237923,60575,60465,110,,,19/1/2022 7:23
27/4/2021,Bueng Kan,1,13,422066,211554,210512,5420,5420,0,,,19/1/2022 7:23
27/4/2021,Buri Ram,2,109,1580079,784198,795881,38966,38860,106,,,19/1/2022 7:23
27/4/2021,Pathum Thani,93,1422,1180730,559573,621157,17584,17443,141,64,23,19/1/2022 7:23
27/4/2021,Prachuap Khiri Khan,21,1047,551205,272975,278230,275365,275243,122,,,19/1/2022 7:23
27/4/2021,Prachin Buri,9,169,494574,244431,250143,62857,62857,0,72,28,19/1/2022 7:23
27/4/2021,Pattani,6,153,727686,359470,368216,11318,11318,0,,,19/1/2022 7:23
27/4/2021,Phra Nakhon Si Ayutthaya,30,408,819654,393768,425886,230549,229807,742,60,54,19/1/2022 7:23
27/4/2021,Phayao,4,80,466174,226975,239199,34541,34442,99,64,24,19/1/2022 7:23
27/4/2021,Phang-nga,4,38,268508,133879,134629,132253,130614,1639,,,19/1/2022 7:23
27/4/2021,Phatthalung,7,132,523116,254885,268231,50714,50714,0,,,19/1/2022 7:23
27/4/2021,Phichit,5,39,531541,259263,272278,52325,52325,0,,,19/1/2022 7:23
27/4/2021,Phitsanulok,4,245,848043,415270,432773,150029,149890,139,,,19/1/2022 7:23
27/4/2021,Phuket,13,571,413242,195176,218066,185057,183877,1180,49,24,19/1/2022 7:23
27/4/2021,Maha Sarakham,18,173,951507,466454,485053,12276,12276,0,,,19/1/2022 7:23
27/4/2021,Mukdahan,0,22,350834,175233,175601,29874,29874,0,,,19/1/2022 7:23
27/4/2021,Yala,4,187,539921,268685,271236,29789,29789,0,45,19,19/1/2022 7:23
27/4/2021,Yasothon,1,39,534065,266640,267425,23761,23761,0,,,19/1/2022 7:23
27/4/2021,Ranong,20,99,194741,98300,96441,52522,52361,161,,,19/1/2022 7:23
27/4/2021,Rayong,18,1046,744962,365850,379112,102268,101970,298,52,33,19/1/2022 7:23
27/4/2021,Ratchaburi,19,293,869447,422955,446492,42340,42325,15,,,19/1/2022 7:23
27/4/2021,Roi Et,7,119,1297612,643180,654432,9529,9529,0,,,19/1/2022 7:23
27/4/2021,Lop Buri,4,126,741974,370517,371457,54769,54707,62,,,19/1/2022 7:23
27/4/2021,Lampang,3,191,727166,354266,372900,88127,87577,550,66,26,19/1/2022 7:23
27/4/2021,Lamphun,3,258,401750,193199,208551,70522,70337,185,,,19/1/2022 7:23
27/4/2021,Si Sa Ket,8,135,1457730,725631,732099,15523,15523,0,,,19/1/2022 7:23
27/4/2021,Sakon Nakhon,7,58,1146692,569813,576879,27390,27375,15,,,19/1/2022 7:23
27/4/2021,Songkhla,23,664,1429058,696568,732490,69929,69891,38,47,30,19/1/2022 7:23
27/4/2021,Satun,1,36,324321,161388,162933,73143,72554,589,23,15,19/1/2022 7:23
27/4/2021,Samut Prakarn,93,2091,1354390,645522,708868,27501,27263,238,,,19/1/2022 7:23
27/4/2021,Samut Songkhram,4,104,191749,91610,100139,126386,126314,72,39,17,19/1/2022 7:23
27/4/2021,Samut Sakhon,61,17894,586317,282574,303743,6690,6639,51,72,43,19/1/2022 7:23
27/4/2021,Saraburi,7,136,644230,316852,327378,96839,96724,115,90,86,19/1/2022 7:23
27/4/2021,Sa kaeo,11,313,561071,280075,280996,23441,23441,0,36,13,19/1/2022 7:23
27/4/2021,Sing Buri,0,54,205427,97606,107821,17847,17847,0,,,19/1/2022 7:23
27/4/2021,Suphan Buri,5,216,837370,404033,433337,72907,72907,0,,,19/1/2022 7:23
27/4/2021,Surat Thani,62,563,1068273,526182,542091,65669,65132,537,65,39,19/1/2022 7:23
27/4/2021,Surin,4,86,1377326,685192,692134,24004,23993,11,,,19/1/2022 7:23
27/4/2021,Sukhothai,2,88,586830,284310,302520,56642,55966,676,,,19/1/2022 7:23
27/4/2021,Nong Khai,3,53,517147,256546,260601,20943,20864,79,27,10,19/1/2022 7:23
27/4/2021,Nong Bua Lam Phu,0,28,509129,253956,255173,4947,4947,0,,,19/1/2022 7:23
27/4/2021,Amnat Charoen,1,32,376158,187258,188900,7354,7354,0,,,19/1/2022 7:23
27/4/2021,Udon Thani,6,326,1567503,776622,790881,39172,39152,20,,,19/1/2022 7:23
27/4/2021,Uttaradit,0,58,447754,218285,229469,47493,47493,0,,,19/1/2022 7:23
27/4/2021,Uthai Thani,0,15,325542,159106,166436,61633,61633,0,,,19/1/2022 7:23
27/4/2021,Ubon Ratchathani,6,211,1866247,931793,934454,115331,115317,14,44,32,19/1/2022 7:23
27/4/2021,Ang Thong,5,172,275944,132088,143856,35544,35544,0,,,19/1/2022 7:23
27/4/2021,Chiang Rai,7,381,1295958,630131,665827,132092,131542,550,60,18,19/1/2022 7:23
27/4/2021,Chiang Mai,60,3359,1785706,863274,922432,396241,392204,4037,74,27,19/1/2022 7:23
27/4/2021,Phetchaburi,29,472,482292,232840,249452,385714,385488,226,,,19/1/2022 7:23
27/4/2021,Phetchabun,7,66,980662,483966,496696,95174,94812,362,,,19/1/2022 7:23
27/4/2021,Loei,1,47,638441,319953,318488,50148,50126,22,32,27,19/1/2022 7:23
27/4/2021,Phrae,2,65,436290,210317,225973,62210,62067,143,65,19,19/1/2022 7:23
27/4/2021,Mae Hong Son,1,41,285552,144717,140835,42084,41573,511,93,8,19/1/2022 7:23
27/4/2021,,0,153,,,,,,,,,19/1/2022 7:23
28/4/2021,Krabi,7,90,478376,237526,240850,100764,99754,1010,,,19/1/2022 7:23
28/4/2021,Bangkok,834,15842,5574497,2617639,2956858,1115611,1063854,51757,82,30,19/1/2022 7:23
28/4/2021,Kanchanaburi,6,110,892843,448201,444642,243519,243308,211,66,24,19/1/2022 7:23
28/4/2021,Kalasin,2,63,976734,482933,493801,12687,12687,0,,,19/1/2022 7:23
28/4/2021,Kamphaeng Phet,2,95,713471,352392,361079,39769,39688,81,,,19/1/2022 7:23
28/4/2021,Khon Kaen,19,307,1793256,881683,911573,57354,57291,63,72,32,19/1/2022 7:23
28/4/2021,Chanthaburi,23,398,535634,261945,273689,116001,115931,70,,,19/1/2022 7:23
28/4/2021,Chachoengsao,21,294,721596,353738,367858,29877,29877,0,59,34,19/1/2022 7:23
28/4/2021,Chon Buri,112,3687,1572004,766532,805472,156392,155350,1042,62,26,19/1/2022 7:23
28/4/2021,Chai Nat,1,30,321758,154645,167113,31521,31521,0,,,19/1/2022 7:23
28/4/2021,Chaiyaphum,12,122,1123903,555222,568681,40561,40512,49,,,19/1/2022 7:23
28/4/2021,Chumphon,6,89,509518,251414,258104,61047,60995,52,,,19/1/2022 7:23
28/4/2021,Trang,6,83,640411,313222,327189,40640,40547,93,,,19/1/2022 7:23
28/4/2021,Trat,7,76,228569,113072,115497,137616,137392,224,,,19/1/2022 7:23
28/4/2021,Tak,2,388,672976,340316,332660,59385,59312,73,,,19/1/2022 7:23
28/4/2021,Nakhon Nayok,8,85,259750,128155,131595,76708,76708,0,,,19/1/2022 7:23
28/4/2021,Nakhon Pathom,38,650,922448,443178,479270,98319,98268,51,66,25,19/1/2022 7:23
28/4/2021,Nakhon Phanom,3,94,716791,357234,359557,27584,27557,27,,,19/1/2022 7:23
28/4/2021,Nakhon Ratchasima,17,516,2633610,1294642,1338968,314682,313761,921,70,21,19/1/2022 7:23
28/4/2021,Nakhon Si Thammarat,16,271,1550947,765252,785695,108124,107604,520,,,19/1/2022 7:23
28/4/2021,Nakhon Sawan,14,285,1038712,506804,531908,115116,115001,115,57,19,19/1/2022 7:23
28/4/2021,Nonthaburi,72,1808,1281245,596307,684938,33945,33820,125,61,24,19/1/2022 7:23
28/4/2021,Narathiwat,5,565,806698,398996,407702,12366,12366,0,34,23,19/1/2022 7:23
28/4/2021,Nan,13,89,476372,238449,237923,60575,60465,110,,,19/1/2022 7:23
28/4/2021,Bueng Kan,1,14,422066,211554,210512,5420,5420,0,,,19/1/2022 7:23
28/4/2021,Buri Ram,1,110,1580079,784198,795881,38966,38860,106,,,19/1/2022 7:23
28/4/2021,Pathum Thani,57,1479,1180730,559573,621157,17584,17443,141,61,18,19/1/2022 7:23
28/4/2021,Prachuap Khiri Khan,11,1058,551205,272975,278230,275365,275243,122,,,19/1/2022 7:23
28/4/2021,Prachin Buri,4,173,494574,244431,250143,62857,62857,0,64,22,19/1/2022 7:23
28/4/2021,Pattani,7,160,727686,359470,368216,11318,11318,0,,,19/1/2022 7:23
28/4/2021,Phra Nakhon Si Ayutthaya,27,435,819654,393768,425886,230549,229807,742,64,45,19/1/2022 7:23
28/4/2021,Phayao,5,85,466174,226975,239199,34541,34442,99,54,17,19/1/2022 7:23
28/4/2021,Phang-nga,1,39,268508,133879,134629,132253,130614,1639,,,19/1/2022 7:23
28/4/2021,Phatthalung,19,151,523116,254885,268231,50714,50714,0,,,19/1/2022 7:23
28/4/2021,Phichit,19,58,531541,259263,272278,52325,52325,0,,,19/1/2022 7:23
28/4/2021,Phitsanulok,16,261,848043,415270,432773,150029,149890,139,,,19/1/2022 7:23
28/4/2021,Phuket,13,584,413242,195176,218066,185057,183877,1180,53,25,19/1/2022 7:23
28/4/2021,Maha Sarakham,11,184,951507,466454,485053,12276,12276,0,,,19/1/2022 7:23
28/4/2021,Mukdahan,1,23,350834,175233,175601,29874,29874,0,,,19/1/2022 7:23
28/4/2021,Yala,4,191,539921,268685,271236,29789,29789,0,44,21,19/1/2022 7:23
28/4/2021,Yasothon,7,46,534065,266640,267425,23761,23761,0,,,19/1/2022 7:23
28/4/2021,Ranong,7,106,194741,98300,96441,52522,52361,161,,,19/1/2022 7:23
28/4/2021,Rayong,37,1083,744962,365850,379112,102268,101970,298,63,17,19/1/2022 7:23
28/4/2021,Ratchaburi,11,304,869447,422955,446492,42340,42325,15,,,19/1/2022 7:23
28/4/2021,Roi Et,8,127,1297612,643180,654432,9529,9529,0,,,19/1/2022 7:23
28/4/2021,Lop Buri,5,131,741974,370517,371457,54769,54707,62,,,19/1/2022 7:23
28/4/2021,Lampang,0,191,727166,354266,372900,88127,87577,550,43,25,19/1/2022 7:23
28/4/2021,Lamphun,3,261,401750,193199,208551,70522,70337,185,,,19/1/2022 7:23
28/4/2021,Si Sa Ket,12,147,1457730,725631,732099,15523,15523,0,,,19/1/2022 7:23
28/4/2021,Sakon Nakhon,0,58,1146692,569813,576879,27390,27375,15,,,19/1/2022 7:23
28/4/2021,Songkhla,52,716,1429058,696568,732490,69929,69891,38,55,34,19/1/2022 7:23
28/4/2021,Satun,0,36,324321,161388,162933,73143,72554,589,32,19,19/1/2022 7:23
28/4/2021,Samut Prakarn,161,2252,1354390,645522,708868,27501,27263,238,,,19/1/2022 7:23
28/4/2021,Samut Songkhram,4,108,191749,91610,100139,126386,126314,72,44,12,19/1/2022 7:23
28/4/2021,Samut Sakhon,59,17953,586317,282574,303743,6690,6639,51,84,32,19/1/2022 7:23
28/4/2021,Saraburi,5,141,644230,316852,327378,96839,96724,115,79,65,19/1/2022 7:23
28/4/2021,Sa kaeo,8,321,561071,280075,280996,23441,23441,0,24,10,19/1/2022 7:23
28/4/2021,Sing Buri,0,54,205427,97606,107821,17847,17847,0,,,19/1/2022 7:23
28/4/2021,Suphan Buri,14,230,837370,404033,433337,72907,72907,0,,,19/1/2022 7:23
28/4/2021,Surat Thani,40,603,1068273,526182,542091,65669,65132,537,69,36,19/1/2022 7:23
28/4/2021,Surin,3,89,1377326,685192,692134,24004,23993,11,,,19/1/2022 7:23
28/4/2021,Sukhothai,1,89,586830,284310,302520,56642,55966,676,,,19/1/2022 7:23
28/4/2021,Nong Khai,5,58,517147,256546,260601,20943,20864,79,25,10,19/1/2022 7:23
28/4/2021,Nong Bua Lam Phu,0,28,509129,253956,255173,4947,4947,0,,,19/1/2022 7:23
28/4/2021,Amnat Charoen,2,34,376158,187258,188900,7354,7354,0,,,19/1/2022 7:23
28/4/2021,Udon Thani,14,340,1567503,776622,790881,39172,39152,20,,,19/1/2022 7:23
28/4/2021,Uttaradit,0,58,447754,218285,229469,47493,47493,0,,,19/1/2022 7:23
28/4/2021,Uthai Thani,2,17,325542,159106,166436,61633,61633,0,,,19/1/2022 7:23
28/4/2021,Ubon Ratchathani,11,222,1866247,931793,934454,115331,115317,14,75,31,19/1/2022 7:23
28/4/2021,Ang Thong,0,172,275944,132088,143856,35544,35544,0,,,19/1/2022 7:23
28/4/2021,Chiang Rai,20,401,1295958,630131,665827,132092,131542,550,50,18,19/1/2022 7:23
28/4/2021,Chiang Mai,55,3414,1785706,863274,922432,396241,392204,4037,63,25,19/1/2022 7:23
28/4/2021,Phetchaburi,19,491,482292,232840,249452,385714,385488,226,,,19/1/2022 7:23
28/4/2021,Phetchabun,1,67,980662,483966,496696,95174,94812,362,,,19/1/2022 7:23
28/4/2021,Loei,3,50,638441,319953,318488,50148,50126,22,42,17,19/1/2022 7:23
28/4/2021,Phrae,0,65,436290,210317,225973,62210,62067,143,49,16,19/1/2022 7:23
28/4/2021,Mae Hong Son,0,41,285552,144717,140835,42084,41573,511,37,15,19/1/2022 7:23
28/4/2021,,0,153,,,,,,,,,19/1/2022 7:23
29/4/2021,Krabi,1,91,478376,237526,240850,100764,99754,1010,,,19/1/2022 7:23
29/4/2021,Bangkok,693,16535,5574497,2617639,2956858,1115611,1063854,51757,62,33,19/1/2022 7:23
29/4/2021,Kanchanaburi,15,125,892843,448201,444642,243519,243308,211,57,13,19/1/2022 7:23
29/4/2021,Kalasin,0,63,976734,482933,493801,12687,12687,0,,,19/1/2022 7:23
29/4/2021,Kamphaeng Phet,1,96,713471,352392,361079,39769,39688,81,,,19/1/2022 7:23
29/4/2021,Khon Kaen,32,339,1793256,881683,911573,57354,57291,63,72,36,19/1/2022 7:23
29/4/2021,Chanthaburi,9,407,535634,261945,273689,116001,115931,70,,,19/1/2022 7:23
29/4/2021,Chachoengsao,11,305,721596,353738,367858,29877,29877,0,45,34,19/1/2022 7:23
29/4/2021,Chon Buri,114,3801,1572004,766532,805472,156392,155350,1042,51,29,19/1/2022 7:23
29/4/2021,Chai Nat,1,31,321758,154645,167113,31521,31521,0,,,19/1/2022 7:23
29/4/2021,Chaiyaphum,3,125,1123903,555222,568681,40561,40512,49,,,19/1/2022 7:23
29/4/2021,Chumphon,3,92,509518,251414,258104,61047,60995,52,,,19/1/2022 7:23
29/4/2021,Trang,27,110,640411,313222,327189,40640,40547,93,,,19/1/2022 7:23
29/4/2021,Trat,5,81,228569,113072,115497,137616,137392,224,,,19/1/2022 7:23
29/4/2021,Tak,3,391,672976,340316,332660,59385,59312,73,,,19/1/2022 7:23
29/4/2021,Nakhon Nayok,10,95,259750,128155,131595,76708,76708,0,,,19/1/2022 7:23
29/4/2021,Nakhon Pathom,30,680,922448,443178,479270,98319,98268,51,57,25,19/1/2022 7:23
29/4/2021,Nakhon Phanom,4,98,716791,357234,359557,27584,27557,27,,,19/1/2022 7:23
29/4/2021,Nakhon Ratchasima,10,526,2633610,1294642,1338968,314682,313761,921,46,25,19/1/2022 7:23
29/4/2021,Nakhon Si Thammarat,22,293,1550947,765252,785695,108124,107604,520,,,19/1/2022 7:23
29/4/2021,Nakhon Sawan,29,314,1038712,506804,531908,115116,115001,115,47,21,19/1/2022 7:23
29/4/2021,Nonthaburi,28,1836,1281245,596307,684938,33945,33820,125,49,29,19/1/2022 7:23
29/4/2021,Narathiwat,3,568,806698,398996,407702,12366,12366,0,44,18,19/1/2022 7:23
29/4/2021,Nan,3,92,476372,238449,237923,60575,60465,110,,,19/1/2022 7:23
29/4/2021,Bueng Kan,0,14,422066,211554,210512,5420,5420,0,,,19/1/2022 7:23
29/4/2021,Buri Ram,0,110,1580079,784198,795881,38966,38860,106,,,19/1/2022 7:23
29/4/2021,Pathum Thani,81,1560,1180730,559573,621157,17584,17443,141,53,27,19/1/2022 7:23
29/4/2021,Prachuap Khiri Khan,30,1088,551205,272975,278230,275365,275243,122,,,19/1/2022 7:23
29/4/2021,Prachin Buri,6,179,494574,244431,250143,62857,62857,0,52,20,19/1/2022 7:23
29/4/2021,Pattani,9,169,727686,359470,368216,11318,11318,0,,,19/1/2022 7:23
29/4/2021,Phra Nakhon Si Ayutthaya,24,459,819654,393768,425886,230549,229807,742,46,52,19/1/2022 7:23
29/4/2021,Phayao,2,87,466174,226975,239199,34541,34442,99,36,15,19/1/2022 7:23
29/4/2021,Phang-nga,1,40,268508,133879,134629,132253,130614,1639,,,19/1/2022 7:23
29/4/2021,Phatthalung,10,161,523116,254885,268231,50714,50714,0,,,19/1/2022 7:23
29/4/2021,Phichit,0,58,531541,259263,272278,52325,52325,0,,,19/1/2022 7:23
29/4/2021,Phitsanulok,6,267,848043,415270,432773,150029,149890,139,,,19/1/2022 7:23
29/4/2021,Phuket,13,597,413242,195176,218066,185057,183877,1180,59,25,19/1/2022 7:23
29/4/2021,Maha Sarakham,19,203,951507,466454,485053,12276,12276,0,,,19/1/2022 7:23
29/4/2021,Mukdahan,1,24,350834,175233,175601,29874,29874,0,,,19/1/2022 7:23
29/4/2021,Yala,2,193,539921,268685,271236,29789,29789,0,47,22,19/1/2022 7:23
29/4/2021,Yasothon,9,55,534065,266640,267425,23761,23761,0,,,19/1/2022 7:23
29/4/2021,Ranong,18,124,194741,98300,96441,52522,52361,161,,,19/1/2022 7:23
29/4/2021,Rayong,17,1100,744962,365850,379112,102268,101970,298,37,22,19/1/2022 7:23
29/4/2021,Ratchaburi,15,319,869447,422955,446492,42340,42325,15,,,19/1/2022 7:23
29/4/2021,Roi Et,11,138,1297612,643180,654432,9529,9529,0,,,19/1/2022 7:23
29/4/2021,Lop Buri,11,142,741974,370517,371457,54769,54707,62,,,19/1/2022 7:23
29/4/2021,Lampang,2,193,727166,354266,372900,88127,87577,550,34,18,19/1/2022 7:23
29/4/2021,Lamphun,6,267,401750,193199,208551,70522,70337,185,,,19/1/2022 7:23
29/4/2021,Si Sa Ket,9,156,1457730,725631,732099,15523,15523,0,,,19/1/2022 7:23
29/4/2021,Sakon Nakhon,9,67,1146692,569813,576879,27390,27375,15,,,19/1/2022 7:23
29/4/2021,Songkhla,46,762,1429058,696568,732490,69929,69891,38,67,32,19/1/2022 7:23
29/4/2021,Satun,4,40,324321,161388,162933,73143,72554,589,34,21,19/1/2022 7:23
29/4/2021,Samut Prakarn,151,2403,1354390,645522,708868,27501,27263,238,,,19/1/2022 7:23
29/4/2021,Samut Songkhram,7,115,191749,91610,100139,126386,126314,72,30,12,19/1/2022 7:23
29/4/2021,Samut Sakhon,39,17992,586317,282574,303743,6690,6639,51,71,27,19/1/2022 7:23
29/4/2021,Saraburi,8,149,644230,316852,327378,96839,96724,115,62,80,19/1/2022 7:23
29/4/2021,Sa kaeo,14,335,561071,280075,280996,23441,23441,0,20,12,19/1/2022 7:23
29/4/2021,Sing Buri,2,56,205427,97606,107821,17847,17847,0,,,19/1/2022 7:23
29/4/2021,Suphan Buri,13,243,837370,404033,433337,72907,72907,0,,,19/1/2022 7:23
29/4/2021,Surat Thani,46,649,1068273,526182,542091,65669,65132,537,66,39,19/1/2022 7:23
29/4/2021,Surin,8,97,1377326,685192,692134,24004,23993,11,,,19/1/2022 7:23
29/4/2021,Sukhothai,4,93,586830,284310,302520,56642,55966,676,,,19/1/2022 7:23
29/4/2021,Nong Khai,3,61,517147,256546,260601,20943,20864,79,24,10,19/1/2022 7:23
29/4/2021,Nong Bua Lam Phu,1,29,509129,253956,255173,4947,4947,0,,,19/1/2022 7:23
29/4/2021,Amnat Charoen,2,36,376158,187258,188900,7354,7354,0,,,19/1/2022 7:23
29/4/2021,Udon Thani,12,352,1567503,776622,790881,39172,39152,20,,,19/1/2022 7:23
29/4/2021,Uttaradit,2,60,447754,218285,229469,47493,47493,0,,,19/1/2022 7:23
29/4/2021,Uthai Thani,0,17,325542,159106,166436,61633,61633,0,,,19/1/2022 7:23
29/4/2021,Ubon Ratchathani,2,224,1866247,931793,934454,115331,115317,14,71,26,19/1/2022 7:23
29/4/2021,Ang Thong,27,199,275944,132088,143856,35544,35544,0,,,19/1/2022 7:23
29/4/2021,Chiang Rai,11,412,1295958,630131,665827,132092,131542,550,42,17,19/1/2022 7:23
29/4/2021,Chiang Mai,89,3503,1785706,863274,922432,396241,392204,4037,57,23,19/1/2022 7:23
29/4/2021,Phetchaburi,9,500,482292,232840,249452,385714,385488,226,,,19/1/2022 7:23
29/4/2021,Phetchabun,2,69,980662,483966,496696,95174,94812,362,,,19/1/2022 7:23
29/4/2021,Loei,0,50,638441,319953,318488,50148,50126,22,23,17,19/1/2022 7:23
29/4/2021,Phrae,1,66,436290,210317,225973,62210,62067,143,39,18,19/1/2022 7:23
29/4/2021,Mae Hong Son,0,41,285552,144717,140835,42084,41573,511,53,17,19/1/2022 7:23
29/4/2021,,0,153,,,,,,,,,19/1/2022 7:23
30/4/2021,Krabi,5,96,478376,237526,240850,100764,99754,1010,,,19/1/2022 7:23
30/4/2021,Bangkok,420,16955,5574497,2617639,2956858,1115611,1063854,51757,67,32,19/1/2022 7:23
30/4/2021,Kanchanaburi,11,136,892843,448201,444642,243519,243308,211,36,13,19/1/2022 7:23
30/4/2021,Kalasin,6,69,976734,482933,493801,12687,12687,0,,,19/1/2022 7:23
30/4/2021,Kamphaeng Phet,5,101,713471,352392,361079,39769,39688,81,,,19/1/2022 7:23
30/4/2021,Khon Kaen,17,356,1793256,881683,911573,57354,57291,63,67,31,19/1/2022 7:23
30/4/2021,Chanthaburi,18,425,535634,261945,273689,116001,115931,70,,,19/1/2022 7:23
30/4/2021,Chachoengsao,29,334,721596,353738,367858,29877,29877,0,47,41,19/1/2022 7:23
30/4/2021,Chon Buri,132,3933,1572004,766532,805472,156392,155350,1042,54,35,19/1/2022 7:23
30/4/2021,Chai Nat,4,35,321758,154645,167113,31521,31521,0,,,19/1/2022 7:23
30/4/2021,Chaiyaphum,4,129,1123903,555222,568681,40561,40512,49,,,19/1/2022 7:23
30/4/2021,Chumphon,2,94,509518,251414,258104,61047,60995,52,,,19/1/2022 7:23
30/4/2021,Trang,4,114,640411,313222,327189,40640,40547,93,,,19/1/2022 7:23
30/4/2021,Trat,10,91,228569,113072,115497,137616,137392,224,,,19/1/2022 7:23
30/4/2021,Tak,1,392,672976,340316,332660,59385,59312,73,,,19/1/2022 7:23
30/4/2021,Nakhon Nayok,5,100,259750,128155,131595,76708,76708,0,,,19/1/2022 7:23
30/4/2021,Nakhon Pathom,34,714,922448,443178,479270,98319,98268,51,55,22,19/1/2022 7:23
30/4/2021,Nakhon Phanom,5,103,716791,357234,359557,27584,27557,27,,,19/1/2022 7:23
30/4/2021,Nakhon Ratchasima,15,541,2633610,1294642,1338968,314682,313761,921,57,22,19/1/2022 7:23
30/4/2021,Nakhon Si Thammarat,18,311,1550947,765252,785695,108124,107604,520,,,19/1/2022 7:23
30/4/2021,Nakhon Sawan,25,339,1038712,506804,531908,115116,115001,115,54,25,19/1/2022 7:23
30/4/2021,Nonthaburi,50,1886,1281245,596307,684938,33945,33820,125,54,18,19/1/2022 7:23
30/4/2021,Narathiwat,6,574,806698,398996,407702,12366,12366,0,34,16,19/1/2022 7:23
30/4/2021,Nan,6,98,476372,238449,237923,60575,60465,110,,,19/1/2022 7:23
30/4/2021,Bueng Kan,0,14,422066,211554,210512,5420,5420,0,,,19/1/2022 7:23
30/4/2021,Buri Ram,1,111,1580079,784198,795881,38966,38860,106,,,19/1/2022 7:23
30/4/2021,Pathum Thani,35,1595,1180730,559573,621157,17584,17443,141,68,20,19/1/2022 7:23
30/4/2021,Prachuap Khiri Khan,11,1099,551205,272975,278230,275365,275243,122,,,19/1/2022 7:23
30/4/2021,Prachin Buri,14,193,494574,244431,250143,62857,62857,0,49,28,19/1/2022 7:23
30/4/2021,Pattani,12,181,727686,359470,368216,11318,11318,0,,,19/1/2022 7:23
30/4/2021,Phra Nakhon Si Ayutthaya,25,484,819654,393768,425886,230549,229807,742,54,43,19/1/2022 7:23
30/4/2021,Phayao,0,87,466174,226975,239199,34541,34442,99,38,16,19/1/2022 7:23
30/4/2021,Phang-nga,0,40,268508,133879,134629,132253,130614,1639,,,19/1/2022 7:23
30/4/2021,Phatthalung,25,186,523116,254885,268231,50714,50714,0,,,19/1/2022 7:23
30/4/2021,Phichit,3,61,531541,259263,272278,52325,52325,0,,,19/1/2022 7:23
30/4/2021,Phitsanulok,14,281,848043,415270,432773,150029,149890,139,,,19/1/2022 7:23
30/4/2021,Phuket,17,614,413242,195176,218066,185057,183877,1180,59,25,19/1/2022 7:23
30/4/2021,Maha Sarakham,7,210,951507,466454,485053,12276,12276,0,,,19/1/2022 7:23
30/4/2021,Mukdahan,1,25,350834,175233,175601,29874,29874,0,,,19/1/2022 7:23
30/4/2021,Yala,10,203,539921,268685,271236,29789,29789,0,47,19,19/1/2022 7:23
30/4/2021,Yasothon,3,58,534065,266640,267425,23761,23761,0,,,19/1/2022 7:23
30/4/2021,Ranong,36,160,194741,98300,96441,52522,52361,161,,,19/1/2022 7:23
30/4/2021,Rayong,15,1115,744962,365850,379112,102268,101970,298,51,28,19/1/2022 7:23
30/4/2021,Ratchaburi,20,339,869447,422955,446492,42340,42325,15,,,19/1/2022 7:23
30/4/2021,Roi Et,15,153,1297612,643180,654432,9529,9529,0,,,19/1/2022 7:23
30/4/2021,Lop Buri,5,147,741974,370517,371457,54769,54707,62,,,19/1/2022 7:23
30/4/2021,Lampang,11,204,727166,354266,372900,88127,87577,550,28,25,19/1/2022 7:23
30/4/2021,Lamphun,9,276,401750,193199,208551,70522,70337,185,,,19/1/2022 7:23
30/4/2021,Si Sa Ket,15,171,1457730,725631,732099,15523,15523,0,,,19/1/2022 7:23
30/4/2021,Sakon Nakhon,3,70,1146692,569813,576879,27390,27375,15,,,19/1/2022 7:23
30/4/2021,Songkhla,20,782,1429058,696568,732490,69929,69891,38,66,34,19/1/2022 7:23
30/4/2021,Satun,1,41,324321,161388,162933,73143,72554,589,42,16,19/1/2022 7:23
30/4/2021,Samut Prakarn,138,2541,1354390,645522,708868,27501,27263,238,,,19/1/2022 7:23
30/4/2021,Samut Songkhram,2,117,191749,91610,100139,126386,126314,72,30,10,19/1/2022 7:23
30/4/2021,Samut Sakhon,48,18040,586317,282574,303743,6690,6639,51,63,24,19/1/2022 7:23
30/4/2021,Saraburi,21,170,644230,316852,327378,96839,96724,115,65,58,19/1/2022 7:23
30/4/2021,Sa kaeo,11,346,561071,280075,280996,23441,23441,0,19,11,19/1/2022 7:23
30/4/2021,Sing Buri,7,63,205427,97606,107821,17847,17847,0,,,19/1/2022 7:23
30/4/2021,Suphan Buri,9,252,837370,404033,433337,72907,72907,0,,,19/1/2022 7:23
30/4/2021,Surat Thani,34,683,1068273,526182,542091,65669,65132,537,72,40,19/1/2022 7:23
30/4/2021,Surin,14,111,1377326,685192,692134,24004,23993,11,,,19/1/2022 7:23
30/4/2021,Sukhothai,1,94,586830,284310,302520,56642,55966,676,,,19/1/2022 7:23
30/4/2021,Nong Khai,5,66,517147,256546,260601,20943,20864,79,25,10,19/1/2022 7:23
30/4/2021,Nong Bua Lam Phu,0,29,509129,253956,255173,4947,4947,0,,,19/1/2022 7:23
30/4/2021,Amnat Charoen,0,36,376158,187258,188900,7354,7354,0,,,19/1/2022 7:23
30/4/2021,Udon Thani,6,358,1567503,776622,790881,39172,39152,20,,,19/1/2022 7:23
30/4/2021,Uttaradit,7,67,447754,218285,229469,47493,47493,0,,,19/1/2022 7:23
30/4/2021,Uthai Thani,0,17,325542,159106,166436,61633,61633,0,,,19/1/2022 7:23
30/4/2021,Ubon Ratchathani,7,231,1866247,931793,934454,115331,115317,14,60,26,19/1/2022 7:23
30/4/2021,Ang Thong,7,206,275944,132088,143856,35544,35544,0,,,19/1/2022 7:23
30/4/2021,Chiang Rai,26,438,1295958,630131,665827,132092,131542,550,48,18,19/1/2022 7:23
30/4/2021,Chiang Mai,66,3569,1785706,863274,922432,396241,392204,4037,54,23,19/1/2022 7:23
30/4/2021,Phetchaburi,9,509,482292,232840,249452,385714,385488,226,,,19/1/2022 7:23
30/4/2021,Phetchabun,0,69,980662,483966,496696,95174,94812,362,,,19/1/2022 7:23
30/4/2021,Loei,3,53,638441,319953,318488,50148,50126,22,28,21,19/1/2022 7:23
30/4/2021,Phrae,1,67,436290,210317,225973,62210,62067,143,34,19,19/1/2022 7:23
30/4/2021,Mae Hong Son,1,42,285552,144717,140835,42084,41573,511,64,13,19/1/2022 7:23
30/4/2021,,0,153,,,,,,,,,19/1/2022 7:23
1/5/2021,Krabi,7,103,478425,237576,240849,2222,2082,140,,,19/1/2022 7:23
1/5/2021,Bangkok,743,17698,5565337,2611984,2953353,353401,323907,29494,70,38,19/1/2022 7:23
1/5/2021,Kanchanaburi,14,150,892304,447427,444877,38060,37817,243,35,22,19/1/2022 7:23
1/5/2021,Kalasin,3,72,977098,483228,493870,2258,2258,0,,,19/1/2022 7:23
1/5/2021,Kamphaeng Phet,2,103,713612,352508,361104,8775,8775,0,,,19/1/2022 7:23
1/5/2021,Khon Kaen,14,370,1793078,881616,911462,46729,46690,39,66,38,19/1/2022 7:23
1/5/2021,Chanthaburi,32,457,535709,261994,273715,22331,22275,56,,,19/1/2022 7:23
1/5/2021,Chachoengsao,17,351,721880,353941,367939,5688,5688,0,61,45,19/1/2022 7:23
1/5/2021,Chon Buri,127,4060,1572844,766647,806197,29860,29153,707,70,36,19/1/2022 7:23
1/5/2021,Chai Nat,10,45,321640,154663,166977,5843,5843,0,,,19/1/2022 7:23
1/5/2021,Chaiyaphum,12,141,1124135,555470,568665,7737,7725,12,,,19/1/2022 7:23
1/5/2021,Chumphon,0,94,509660,251522,258138,1501,1501,0,,,19/1/2022 7:23
1/5/2021,Trang,33,147,640335,313195,327140,1786,1786,0,,,19/1/2022 7:23
1/5/2021,Trat,6,97,228577,113056,115521,25099,24970,129,,,19/1/2022 7:23
1/5/2021,Tak,1,393,673504,340558,332946,19138,19115,23,,,19/1/2022 7:23
1/5/2021,Nakhon Nayok,2,102,259663,128076,131587,7533,7533,0,,,19/1/2022 7:23
1/5/2021,Nakhon Pathom,29,743,922477,443242,479235,13279,13263,16,46,28,19/1/2022 7:23
1/5/2021,Nakhon Phanom,3,106,717008,357388,359620,4972,4963,9,,,19/1/2022 7:23
1/5/2021,Nakhon Ratchasima,21,562,2633898,1294636,1339262,95155,94599,556,49,24,19/1/2022 7:23
1/5/2021,Nakhon Si Thammarat,46,357,1550685,765026,785659,7956,7956,0,,,19/1/2022 7:23
1/5/2021,Nakhon Sawan,20,359,1038321,506625,531696,21893,21893,0,61,34,19/1/2022 7:23
1/5/2021,Nonthaburi,46,1932,1282168,596750,685418,3634,3613,21,40,46,19/1/2022 7:23
1/5/2021,Narathiwat,2,576,807640,399607,408033,1063,1063,0,32,14,19/1/2022 7:23
1/5/2021,Nan,5,103,476276,238368,237908,6955,6876,79,,,19/1/2022 7:23
1/5/2021,Bueng Kan,1,15,422395,211815,210580,2107,2107,0,,,19/1/2022 7:23
1/5/2021,Buri Ram,4,115,1580600,784622,795978,19949,19899,50,,,19/1/2022 7:23
1/5/2021,Pathum Thani,64,1659,1181742,559988,621754,2265,2237,28,65,28,19/1/2022 7:23
1/5/2021,Prachuap Khiri Khan,8,1107,550568,272298,278270,51821,51734,87,,,19/1/2022 7:23
1/5/2021,Prachin Buri,23,216,494216,244010,250206,5966,5966,0,57,32,19/1/2022 7:23
1/5/2021,Pattani,1,182,727981,359468,368513,1288,1288,0,,,19/1/2022 7:23
1/5/2021,Phra Nakhon Si Ayutthaya,30,514,819893,393933,425960,61595,61233,362,54,53,19/1/2022 7:23
1/5/2021,Phayao,0,87,466006,226859,239147,11143,11122,21,35,23,19/1/2022 7:23
1/5/2021,Phang-nga,0,40,268719,134080,134639,8721,8100,621,,,19/1/2022 7:23
1/5/2021,Phatthalung,25,211,523135,254907,268228,1911,1911,0,,,19/1/2022 7:23
1/5/2021,Phichit,2,63,531511,259350,272161,7231,7231,0,,,19/1/2022 7:23
1/5/2021,Phitsanulok,5,286,847403,414611,432792,30519,30433,86,,,19/1/2022 7:23
1/5/2021,Phuket,12,626,414526,195824,218702,5291,4766,525,58,24,19/1/2022 7:23
1/5/2021,Maha Sarakham,15,225,951267,466548,484719,4341,4341,0,,,19/1/2022 7:23
1/5/2021,Mukdahan,3,28,351099,175412,175687,6784,6784,0,,,19/1/2022 7:23
1/5/2021,Yala,4,207,540317,268883,271434,2178,2178,0,44,22,19/1/2022 7:23
1/5/2021,Yasothon,6,64,534080,266625,267455,952,952,0,,,19/1/2022 7:23
1/5/2021,Ranong,33,193,194750,98304,96446,1678,1678,0,,,19/1/2022 7:23
1/5/2021,Rayong,9,1124,746202,366668,379534,22710,22497,213,45,32,19/1/2022 7:23
1/5/2021,Ratchaburi,9,348,869157,422653,446504,7378,7378,0,,,19/1/2022 7:23
1/5/2021,Roi Et,2,155,1297760,643167,654593,6265,6265,0,,,19/1/2022 7:23
1/5/2021,Lop Buri,8,155,739849,368410,371439,10549,10510,39,,,19/1/2022 7:23
1/5/2021,Lampang,5,209,727262,354467,372795,9481,9078,403,56,21,19/1/2022 7:23
1/5/2021,Lamphun,3,279,401851,193249,208602,8607,8482,125,,,19/1/2022 7:23
1/5/2021,Si Sa Ket,13,184,1457888,725954,731934,3439,3439,0,,,19/1/2022 7:23
1/5/2021,Sakon Nakhon,0,70,1147056,570138,576918,3867,3867,0,,,19/1/2022 7:23
1/5/2021,Songkhla,27,809,1429188,696564,732624,2754,2723,31,63,26,19/1/2022 7:23
1/5/2021,Satun,0,41,324400,161412,162988,5525,5489,36,32,15,19/1/2022 7:23
1/5/2021,Samut Prakarn,142,2683,1354816,645683,709133,3744,3666,78,,,19/1/2022 7:23
1/5/2021,Samut Songkhram,1,118,191777,91661,100116,13850,13794,56,24,12,19/1/2022 7:23
1/5/2021,Samut Sakhon,46,18086,586821,282842,303979,1725,1725,0,60,34,19/1/2022 7:23
1/5/2021,Saraburi,2,172,643778,316334,327444,17834,17781,53,65,74,19/1/2022 7:23
1/5/2021,Sa kaeo,9,355,561072,279991,281081,3712,3712,0,22,14,19/1/2022 7:23
1/5/2021,Sing Buri,5,68,205391,97605,107786,3742,3742,0,,,19/1/2022 7:23
1/5/2021,Suphan Buri,16,268,837411,404175,433236,12597,12597,0,,,19/1/2022 7:23
1/5/2021,Surat Thani,52,735,1068431,526206,542225,3429,3408,21,80,35,19/1/2022 7:23
1/5/2021,Surin,1,112,1377702,685565,692137,8806,8806,0,,,19/1/2022 7:23
1/5/2021,Sukhothai,1,95,586803,284381,302422,4869,4747,122,,,19/1/2022 7:23
1/5/2021,Nong Khai,3,69,517275,256665,260610,13264,13246,18,25,11,19/1/2022 7:23
1/5/2021,Nong Bua Lam Phu,0,29,509382,254164,255218,2186,2186,0,,,19/1/2022 7:23
1/5/2021,Amnat Charoen,2,38,376342,187394,188948,1140,1140,0,,,19/1/2022 7:23
1/5/2021,Udon Thani,9,367,1567699,776819,790880,11676,11669,7,,,19/1/2022 7:23
1/5/2021,Uttaradit,0,67,447682,218270,229412,8216,8216,0,,,19/1/2022 7:23
1/5/2021,Uthai Thani,0,17,325555,159138,166417,2668,2668,0,,,19/1/2022 7:23
1/5/2021,Ubon Ratchathani,8,239,1867034,932378,934656,17785,17785,0,60,27,19/1/2022 7:23
1/5/2021,Ang Thong,0,206,275934,132137,143797,2679,2679,0,,,19/1/2022 7:23
1/5/2021,Chiang Rai,8,446,1296741,630516,666225,33777,33431,346,49,19,19/1/2022 7:23
1/5/2021,Chiang Mai,61,3630,1785286,862939,922347,97868,95795,2073,58,31,19/1/2022 7:23
1/5/2021,Phetchaburi,7,516,482261,232800,249461,48502,48311,191,,,19/1/2022 7:23
1/5/2021,Phetchabun,0,69,980259,483622,496637,30774,30774,0,,,19/1/2022 7:23
1/5/2021,Loei,9,62,638528,320030,318498,6303,6296,7,28,24,19/1/2022 7:23
1/5/2021,Phrae,2,69,436092,210253,225839,7717,7717,0,39,21,19/1/2022 7:23
1/5/2021,Mae Hong Son,0,42,285641,144762,140879,13138,12870,268,53,12,19/1/2022 7:23
1/5/2021,,0,153,,,,,,,,,19/1/2022 7:23
2/5/2021,Krabi,11,114,478425,237576,240849,2222,2082,140,,,19/1/2022 7:23
2/5/2021,Bangkok,544,18242,5565337,2611984,2953353,353401,323907,29494,73,35,19/1/2022 7:23
2/5/2021,Kanchanaburi,15,165,892304,447427,444877,38060,37817,243,55,14,19/1/2022 7:23
2/5/2021,Kalasin,1,73,977098,483228,493870,2258,2258,0,,,19/1/2022 7:23
2/5/2021,Kamphaeng Phet,2,105,713612,352508,361104,8775,8775,0,,,19/1/2022 7:23
2/5/2021,Khon Kaen,14,384,1793078,881616,911462,46729,46690,39,74,44,19/1/2022 7:23
2/5/2021,Chanthaburi,25,482,535709,261994,273715,22331,22275,56,,,19/1/2022 7:23
2/5/2021,Chachoengsao,37,388,721880,353941,367939,5688,5688,0,81,40,19/1/2022 7:23
2/5/2021,Chon Buri,94,4154,1572844,766647,806197,29860,29153,707,73,33,19/1/2022 7:23
2/5/2021,Chai Nat,2,47,321640,154663,166977,5843,5843,0,,,19/1/2022 7:23
2/5/2021,Chaiyaphum,11,152,1124135,555470,568665,7737,7725,12,,,19/1/2022 7:23
2/5/2021,Chumphon,0,94,509660,251522,258138,1501,1501,0,,,19/1/2022 7:23
2/5/2021,Trang,35,182,640335,313195,327140,1786,1786,0,,,19/1/2022 7:23
2/5/2021,Trat,8,105,228577,113056,115521,25099,24970,129,,,19/1/2022 7:23
2/5/2021,Tak,6,399,673504,340558,332946,19138,19115,23,,,19/1/2022 7:23
2/5/2021,Nakhon Nayok,6,108,259663,128076,131587,7533,7533,0,,,19/1/2022 7:23
2/5/2021,Nakhon Pathom,35,778,922477,443242,479235,13279,13263,16,56,30,19/1/2022 7:23
2/5/2021,Nakhon Phanom,3,109,717008,357388,359620,4972,4963,9,,,19/1/2022 7:23
2/5/2021,Nakhon Ratchasima,34,596,2633898,1294636,1339262,95155,94599,556,53,31,19/1/2022 7:23
2/5/2021,Nakhon Si Thammarat,18,375,1550685,765026,785659,7956,7956,0,,,19/1/2022 7:23
2/5/2021,Nakhon Sawan,14,373,1038321,506625,531696,21893,21893,0,74,34,19/1/2022 7:23
2/5/2021,Nonthaburi,276,2208,1282168,596750,685418,3634,3613,21,57,26,19/1/2022 7:23
2/5/2021,Narathiwat,1,577,807640,399607,408033,1063,1063,0,28,18,19/1/2022 7:23
2/5/2021,Nan,1,104,476276,238368,237908,6955,6876,79,,,19/1/2022 7:23
2/5/2021,Bueng Kan,0,15,422395,211815,210580,2107,2107,0,,,19/1/2022 7:23
2/5/2021,Buri Ram,11,126,1580600,784622,795978,19949,19899,50,,,19/1/2022 7:23
2/5/2021,Pathum Thani,62,1721,1181742,559988,621754,2265,2237,28,73,36,19/1/2022 7:23
2/5/2021,Prachuap Khiri Khan,6,1113,550568,272298,278270,51821,51734,87,,,19/1/2022 7:23
2/5/2021,Prachin Buri,1,217,494216,244010,250206,5966,5966,0,67,35,19/1/2022 7:23
2/5/2021,Pattani,12,194,727981,359468,368513,1288,1288,0,,,19/1/2022 7:23
2/5/2021,Phra Nakhon Si Ayutthaya,24,538,819893,393933,425960,61595,61233,362,66,49,19/1/2022 7:23
2/5/2021,Phayao,1,88,466006,226859,239147,11143,11122,21,49,24,19/1/2022 7:23
2/5/2021,Phang-nga,0,40,268719,134080,134639,8721,8100,621,,,19/1/2022 7:23
2/5/2021,Phatthalung,30,241,523135,254907,268228,1911,1911,0,,,19/1/2022 7:23
2/5/2021,Phichit,8,71,531511,259350,272161,7231,7231,0,,,19/1/2022 7:23
2/5/2021,Phitsanulok,3,289,847403,414611,432792,30519,30433,86,,,19/1/2022 7:23
2/5/2021,Phuket,20,646,414526,195824,218702,5291,4766,525,57,24,19/1/2022 7:23
2/5/2021,Maha Sarakham,7,232,951267,466548,484719,4341,4341,0,,,19/1/2022 7:23
2/5/2021,Mukdahan,0,28,351099,175412,175687,6784,6784,0,,,19/1/2022 7:23
2/5/2021,Yala,16,223,540317,268883,271434,2178,2178,0,47,23,19/1/2022 7:23
2/5/2021,Yasothon,5,69,534080,266625,267455,952,952,0,,,19/1/2022 7:23
2/5/2021,Ranong,45,238,194750,98304,96446,1678,1678,0,,,19/1/2022 7:23
2/5/2021,Rayong,18,1142,746202,366668,379534,22710,22497,213,78,31,19/1/2022 7:23
2/5/2021,Ratchaburi,11,359,869157,422653,446504,7378,7378,0,,,19/1/2022 7:23
2/5/2021,Roi Et,2,157,1297760,643167,654593,6265,6265,0,,,19/1/2022 7:23
2/5/2021,Lop Buri,3,158,739849,368410,371439,10549,10510,39,,,19/1/2022 7:23
2/5/2021,Lampang,3,212,727262,354467,372795,9481,9078,403,28,24,19/1/2022 7:23
2/5/2021,Lamphun,1,280,401851,193249,208602,8607,8482,125,,,19/1/2022 7:23
2/5/2021,Si Sa Ket,4,188,1457888,725954,731934,3439,3439,0,,,19/1/2022 7:23
2/5/2021,Sakon Nakhon,1,71,1147056,570138,576918,3867,3867,0,,,19/1/2022 7:23
2/5/2021,Songkhla,31,840,1429188,696564,732624,2754,2723,31,52,27,19/1/2022 7:23
2/5/2021,Satun,0,41,324400,161412,162988,5525,5489,36,39,17,19/1/2022 7:23
2/5/2021,Samut Prakarn,145,2828,1354816,645683,709133,3744,3666,78,,,19/1/2022 7:23
2/5/2021,Samut Songkhram,0,118,191777,91661,100116,13850,13794,56,36,11,19/1/2022 7:23
2/5/2021,Samut Sakhon,52,18138,586821,282842,303979,1725,1725,0,70,42,19/1/2022 7:23
2/5/2021,Saraburi,13,185,643778,316334,327444,17834,17781,53,82,102,19/1/2022 7:23
2/5/2021,Sa kaeo,6,361,561072,279991,281081,3712,3712,0,32,17,19/1/2022 7:23
2/5/2021,Sing Buri,0,68,205391,97605,107786,3742,3742,0,,,19/1/2022 7:23
2/5/2021,Suphan Buri,26,294,837411,404175,433236,12597,12597,0,,,19/1/2022 7:23
2/5/2021,Surat Thani,48,783,1068431,526206,542225,3429,3408,21,71,34,19/1/2022 7:23
2/5/2021,Surin,1,113,1377702,685565,692137,8806,8806,0,,,19/1/2022 7:23
2/5/2021,Sukhothai,0,95,586803,284381,302422,4869,4747,122,,,19/1/2022 7:23
2/5/2021,Nong Khai,2,71,517275,256665,260610,13264,13246,18,28,12,19/1/2022 7:23
2/5/2021,Nong Bua Lam Phu,1,30,509382,254164,255218,2186,2186,0,,,19/1/2022 7:23
2/5/2021,Amnat Charoen,2,40,376342,187394,188948,1140,1140,0,,,19/1/2022 7:23
2/5/2021,Udon Thani,4,371,1567699,776819,790880,11676,11669,7,,,19/1/2022 7:23
2/5/2021,Uttaradit,0,67,447682,218270,229412,8216,8216,0,,,19/1/2022 7:23
2/5/2021,Uthai Thani,0,17,325555,159138,166417,2668,2668,0,,,19/1/2022 7:23
2/5/2021,Ubon Ratchathani,11,250,1867034,932378,934656,17785,17785,0,61,26,19/1/2022 7:23
2/5/2021,Ang Thong,13,219,275934,132137,143797,2679,2679,0,,,19/1/2022 7:23
2/5/2021,Chiang Rai,23,469,1296741,630516,666225,33777,33431,346,50,22,19/1/2022 7:23
2/5/2021,Chiang Mai,55,3685,1785286,862939,922347,97868,95795,2073,64,30,19/1/2022 7:23
2/5/2021,Phetchaburi,7,523,482261,232800,249461,48502,48311,191,,,19/1/2022 7:23
2/5/2021,Phetchabun,3,72,980259,483622,496637,30774,30774,0,,,19/1/2022 7:23
2/5/2021,Loei,8,70,638528,320030,318498,6303,6296,7,40,26,19/1/2022 7:23
2/5/2021,Phrae,0,69,436092,210253,225839,7717,7717,0,41,28,19/1/2022 7:23
2/5/2021,Mae Hong Son,2,44,285641,144762,140879,13138,12870,268,44,21,19/1/2022 7:23
2/5/2021,,0,153,,,,,,,,,19/1/2022 7:23
3/5/2021,Krabi,14,128,478425,237576,240849,2222,2082,140,,,19/1/2022 7:23
3/5/2021,Bangkok,674,18916,5565337,2611984,2953353,353401,323907,29494,69,42,19/1/2022 7:23
3/5/2021,Kanchanaburi,10,175,892304,447427,444877,38060,37817,243,36,33,19/1/2022 7:23
3/5/2021,Kalasin,0,73,977098,483228,493870,2258,2258,0,,,19/1/2022 7:23
3/5/2021,Kamphaeng Phet,1,106,713612,352508,361104,8775,8775,0,,,19/1/2022 7:23
3/5/2021,Khon Kaen,21,405,1793078,881616,911462,46729,46690,39,75,42,19/1/2022 7:23
3/5/2021,Chanthaburi,19,501,535709,261994,273715,22331,22275,56,,,19/1/2022 7:23
3/5/2021,Chachoengsao,5,393,721880,353941,367939,5688,5688,0,63,42,19/1/2022 7:23
3/5/2021,Chon Buri,153,4307,1572844,766647,806197,29860,29153,707,65,32,19/1/2022 7:23
3/5/2021,Chai Nat,23,70,321640,154663,166977,5843,5843,0,,,19/1/2022 7:23
3/5/2021,Chaiyaphum,1,153,1124135,555470,568665,7737,7725,12,,,19/1/2022 7:23
3/5/2021,Chumphon,0,94,509660,251522,258138,1501,1501,0,,,19/1/2022 7:23
3/5/2021,Trang,14,196,640335,313195,327140,1786,1786,0,,,19/1/2022 7:23
3/5/2021,Trat,11,116,228577,113056,115521,25099,24970,129,,,19/1/2022 7:23
3/5/2021,Tak,7,406,673504,340558,332946,19138,19115,23,,,19/1/2022 7:23
3/5/2021,Nakhon Nayok,7,115,259663,128076,131587,7533,7533,0,,,19/1/2022 7:23
3/5/2021,Nakhon Pathom,23,801,922477,443242,479235,13279,13263,16,56,36,19/1/2022 7:23
3/5/2021,Nakhon Phanom,0,109,717008,357388,359620,4972,4963,9,,,19/1/2022 7:23
3/5/2021,Nakhon Ratchasima,21,617,2633898,1294636,1339262,95155,94599,556,59,38,19/1/2022 7:23
3/5/2021,Nakhon Si Thammarat,48,423,1550685,765026,785659,7956,7956,0,,,19/1/2022 7:23
3/5/2021,Nakhon Sawan,7,380,1038321,506625,531696,21893,21893,0,72,38,19/1/2022 7:23
3/5/2021,Nonthaburi,277,2485,1282168,596750,685418,3634,3613,21,61,27,19/1/2022 7:23
3/5/2021,Narathiwat,1,578,807640,399607,408033,1063,1063,0,40,18,19/1/2022 7:23
3/5/2021,Nan,1,105,476276,238368,237908,6955,6876,79,,,19/1/2022 7:23
3/5/2021,Bueng Kan,1,16,422395,211815,210580,2107,2107,0,,,19/1/2022 7:23
3/5/2021,Buri Ram,12,138,1580600,784622,795978,19949,19899,50,,,19/1/2022 7:23
3/5/2021,Pathum Thani,51,1772,1181742,559988,621754,2265,2237,28,68,34,19/1/2022 7:23
3/5/2021,Prachuap Khiri Khan,6,1119,550568,272298,278270,51821,51734,87,,,19/1/2022 7:23
3/5/2021,Prachin Buri,2,219,494216,244010,250206,5966,5966,0,67,43,19/1/2022 7:23
3/5/2021,Pattani,6,200,727981,359468,368513,1288,1288,0,,,19/1/2022 7:23
3/5/2021,Phra Nakhon Si Ayutthaya,19,557,819893,393933,425960,61595,61233,362,63,58,19/1/2022 7:23
3/5/2021,Phayao,1,89,466006,226859,239147,11143,11122,21,58,32,19/1/2022 7:23
3/5/2021,Phang-nga,3,43,268719,134080,134639,8721,8100,621,,,19/1/2022 7:23
3/5/2021,Phatthalung,43,284,523135,254907,268228,1911,1911,0,,,19/1/2022 7:23
3/5/2021,Phichit,6,77,531511,259350,272161,7231,7231,0,,,19/1/2022 7:23
3/5/2021,Phitsanulok,3,292,847403,414611,432792,30519,30433,86,,,19/1/2022 7:23
3/5/2021,Phuket,15,661,414526,195824,218702,5291,4766,525,55,30,19/1/2022 7:23
3/5/2021,Maha Sarakham,8,240,951267,466548,484719,4341,4341,0,,,19/1/2022 7:23
3/5/2021,Mukdahan,0,28,351099,175412,175687,6784,6784,0,,,19/1/2022 7:23
3/5/2021,Yala,12,235,540317,268883,271434,2178,2178,0,52,24,19/1/2022 7:23
3/5/2021,Yasothon,4,73,534080,266625,267455,952,952,0,,,19/1/2022 7:23
3/5/2021,Ranong,12,250,194750,98304,96446,1678,1678,0,,,19/1/2022 7:23
3/5/2021,Rayong,12,1154,746202,366668,379534,22710,22497,213,67,44,19/1/2022 7:23
3/5/2021,Ratchaburi,7,366,869157,422653,446504,7378,7378,0,,,19/1/2022 7:23
3/5/2021,Roi Et,6,163,1297760,643167,654593,6265,6265,0,,,19/1/2022 7:23
3/5/2021,Lop Buri,0,158,739849,368410,371439,10549,10510,39,,,19/1/2022 7:23
3/5/2021,Lampang,10,222,727262,354467,372795,9481,9078,403,43,31,19/1/2022 7:23
3/5/2021,Lamphun,0,280,401851,193249,208602,8607,8482,125,,,19/1/2022 7:23
3/5/2021,Si Sa Ket,4,192,1457888,725954,731934,3439,3439,0,,,19/1/2022 7:23
3/5/2021,Sakon Nakhon,1,72,1147056,570138,576918,3867,3867,0,,,19/1/2022 7:23
3/5/2021,Songkhla,27,867,1429188,696564,732624,2754,2723,31,54,26,19/1/2022 7:23
3/5/2021,Satun,0,41,324400,161412,162988,5525,5489,36,37,22,19/1/2022 7:23
3/5/2021,Samut Prakarn,162,2990,1354816,645683,709133,3744,3666,78,,,19/1/2022 7:23
3/5/2021,Samut Songkhram,3,121,191777,91661,100116,13850,13794,56,29,15,19/1/2022 7:23
3/5/2021,Samut Sakhon,45,18183,586821,282842,303979,1725,1725,0,85,43,19/1/2022 7:23
3/5/2021,Saraburi,5,190,643778,316334,327444,17834,17781,53,93,101,19/1/2022 7:23
3/5/2021,Sa kaeo,11,372,561072,279991,281081,3712,3712,0,30,26,19/1/2022 7:23
3/5/2021,Sing Buri,5,73,205391,97605,107786,3742,3742,0,,,19/1/2022 7:23
3/5/2021,Suphan Buri,5,299,837411,404175,433236,12597,12597,0,,,19/1/2022 7:23
3/5/2021,Surat Thani,69,852,1068431,526206,542225,3429,3408,21,63,40,19/1/2022 7:23
3/5/2021,Surin,2,115,1377702,685565,692137,8806,8806,0,,,19/1/2022 7:23
3/5/2021,Sukhothai,2,97,586803,284381,302422,4869,4747,122,,,19/1/2022 7:23
3/5/2021,Nong Khai,0,71,517275,256665,260610,13264,13246,18,30,14,19/1/2022 7:23
3/5/2021,Nong Bua Lam Phu,0,30,509382,254164,255218,2186,2186,0,,,19/1/2022 7:23
3/5/2021,Amnat Charoen,0,40,376342,187394,188948,1140,1140,0,,,19/1/2022 7:23
3/5/2021,Udon Thani,9,380,1567699,776819,790880,11676,11669,7,,,19/1/2022 7:23
3/5/2021,Uttaradit,0,67,447682,218270,229412,8216,8216,0,,,19/1/2022 7:23
3/5/2021,Uthai Thani,0,17,325555,159138,166417,2668,2668,0,,,19/1/2022 7:23
3/5/2021,Ubon Ratchathani,11,261,1867034,932378,934656,17785,17785,0,55,51,19/1/2022 7:23
3/5/2021,Ang Thong,5,224,275934,132137,143797,2679,2679,0,,,19/1/2022 7:23
3/5/2021,Chiang Rai,14,483,1296741,630516,666225,33777,33431,346,57,40,19/1/2022 7:23
3/5/2021,Chiang Mai,55,3740,1785286,862939,922347,97868,95795,2073,65,33,19/1/2022 7:23
3/5/2021,Phetchaburi,21,544,482261,232800,249461,48502,48311,191,,,19/1/2022 7:23
3/5/2021,Phetchabun,2,74,980259,483622,496637,30774,30774,0,,,19/1/2022 7:23
3/5/2021,Loei,5,75,638528,320030,318498,6303,6296,7,32,30,19/1/2022 7:23
3/5/2021,Phrae,1,70,436092,210253,225839,7717,7717,0,64,34,19/1/2022 7:23
3/5/2021,Mae Hong Son,0,44,285641,144762,140879,13138,12870,268,71,29,19/1/2022 7:23
3/5/2021,,0,153,,,,,,,,,19/1/2022 7:23
4/5/2021,Krabi,38,166,478425,237576,240849,2222,2082,140,,,19/1/2022 7:23
4/5/2021,Bangkok,566,19482,5565337,2611984,2953353,353401,323907,29494,80,44,19/1/2022 7:23
4/5/2021,Kanchanaburi,6,181,892304,447427,444877,38060,37817,243,68,22,19/1/2022 7:23
4/5/2021,Kalasin,3,76,977098,483228,493870,2258,2258,0,,,19/1/2022 7:23
4/5/2021,Kamphaeng Phet,4,110,713612,352508,361104,8775,8775,0,,,19/1/2022 7:23
4/5/2021,Khon Kaen,2,407,1793078,881616,911462,46729,46690,39,80,47,19/1/2022 7:23
4/5/2021,Chanthaburi,15,516,535709,261994,273715,22331,22275,56,,,19/1/2022 7:23
4/5/2021,Chachoengsao,2,395,721880,353941,367939,5688,5688,0,70,44,19/1/2022 7:23
4/5/2021,Chon Buri,94,4401,1572844,766647,806197,29860,29153,707,64,41,19/1/2022 7:23
4/5/2021,Chai Nat,0,70,321640,154663,166977,5843,5843,0,,,19/1/2022 7:23
4/5/2021,Chaiyaphum,2,155,1124135,555470,568665,7737,7725,12,,,19/1/2022 7:23
4/5/2021,Chumphon,2,96,509660,251522,258138,1501,1501,0,,,19/1/2022 7:23
4/5/2021,Trang,22,218,640335,313195,327140,1786,1786,0,,,19/1/2022 7:23
4/5/2021,Trat,5,121,228577,113056,115521,25099,24970,129,,,19/1/2022 7:23
4/5/2021,Tak,12,418,673504,340558,332946,19138,19115,23,,,19/1/2022 7:23
4/5/2021,Nakhon Nayok,17,132,259663,128076,131587,7533,7533,0,,,19/1/2022 7:23
4/5/2021,Nakhon Pathom,50,851,922477,443242,479235,13279,13263,16,73,34,19/1/2022 7:23
4/5/2021,Nakhon Phanom,9,118,717008,357388,359620,4972,4963,9,,,19/1/2022 7:23
4/5/2021,Nakhon Ratchasima,17,634,2633898,1294636,1339262,95155,94599,556,68,34,19/1/2022 7:23
4/5/2021,Nakhon Si Thammarat,28,451,1550685,765026,785659,7956,7956,0,,,19/1/2022 7:23
4/5/2021,Nakhon Sawan,11,391,1038321,506625,531696,21893,21893,0,78,38,19/1/2022 7:23
4/5/2021,Nonthaburi,170,2655,1282168,596750,685418,3634,3613,21,66,29,19/1/2022 7:23
4/5/2021,Narathiwat,5,583,807640,399607,408033,1063,1063,0,43,18,19/1/2022 7:23
4/5/2021,Nan,2,107,476276,238368,237908,6955,6876,79,,,19/1/2022 7:23
4/5/2021,Bueng Kan,0,16,422395,211815,210580,2107,2107,0,,,19/1/2022 7:23
4/5/2021,Buri Ram,2,140,1580600,784622,795978,19949,19899,50,,,19/1/2022 7:23
4/5/2021,Pathum Thani,25,1797,1181742,559988,621754,2265,2237,28,92,29,19/1/2022 7:23
4/5/2021,Prachuap Khiri Khan,10,1129,550568,272298,278270,51821,51734,87,,,19/1/2022 7:23
4/5/2021,Prachin Buri,2,221,494216,244010,250206,5966,5966,0,83,46,19/1/2022 7:23
4/5/2021,Pattani,22,222,727981,359468,368513,1288,1288,0,,,19/1/2022 7:23
4/5/2021,Phra Nakhon Si Ayutthaya,23,580,819893,393933,425960,61595,61233,362,77,55,19/1/2022 7:23
4/5/2021,Phayao,1,90,466006,226859,239147,11143,11122,21,68,30,19/1/2022 7:23
4/5/2021,Phang-nga,1,44,268719,134080,134639,8721,8100,621,,,19/1/2022 7:23
4/5/2021,Phatthalung,28,312,523135,254907,268228,1911,1911,0,,,19/1/2022 7:23
4/5/2021,Phichit,1,78,531511,259350,272161,7231,7231,0,,,19/1/2022 7:23
4/5/2021,Phitsanulok,3,295,847403,414611,432792,30519,30433,86,,,19/1/2022 7:23
4/5/2021,Phuket,25,686,414526,195824,218702,5291,4766,525,67,33,19/1/2022 7:23
4/5/2021,Maha Sarakham,3,243,951267,466548,484719,4341,4341,0,,,19/1/2022 7:23
4/5/2021,Mukdahan,1,29,351099,175412,175687,6784,6784,0,,,19/1/2022 7:23
4/5/2021,Yala,3,238,540317,268883,271434,2178,2178,0,53,28,19/1/2022 7:23
4/5/2021,Yasothon,6,79,534080,266625,267455,952,952,0,,,19/1/2022 7:23
4/5/2021,Ranong,37,287,194750,98304,96446,1678,1678,0,,,19/1/2022 7:23
4/5/2021,Rayong,24,1178,746202,366668,379534,22710,22497,213,85,45,19/1/2022 7:23
4/5/2021,Ratchaburi,8,374,869157,422653,446504,7378,7378,0,,,19/1/2022 7:23
4/5/2021,Roi Et,4,167,1297760,643167,654593,6265,6265,0,,,19/1/2022 7:23
4/5/2021,Lop Buri,7,165,739849,368410,371439,10549,10510,39,,,19/1/2022 7:23
4/5/2021,Lampang,5,227,727262,354467,372795,9481,9078,403,61,35,19/1/2022 7:23
4/5/2021,Lamphun,2,282,401851,193249,208602,8607,8482,125,,,19/1/2022 7:23
4/5/2021,Si Sa Ket,0,192,1457888,725954,731934,3439,3439,0,,,19/1/2022 7:23
4/5/2021,Sakon Nakhon,1,73,1147056,570138,576918,3867,3867,0,,,19/1/2022 7:23
4/5/2021,Songkhla,10,877,1429188,696564,732624,2754,2723,31,51,22,19/1/2022 7:23
4/5/2021,Satun,0,41,324400,161412,162988,5525,5489,36,51,17,19/1/2022 7:23
4/5/2021,Samut Prakarn,201,3191,1354816,645683,709133,3744,3666,78,,,19/1/2022 7:23
4/5/2021,Samut Songkhram,5,126,191777,91661,100116,13850,13794,56,41,15,19/1/2022 7:23
4/5/2021,Samut Sakhon,55,18238,586821,282842,303979,1725,1725,0,92,43,19/1/2022 7:23
4/5/2021,Saraburi,7,197,643778,316334,327444,17834,17781,53,101,98,19/1/2022 7:23
4/5/2021,Sa kaeo,2,374,561072,279991,281081,3712,3712,0,56,26,19/1/2022 7:23
4/5/2021,Sing Buri,2,75,205391,97605,107786,3742,3742,0,,,19/1/2022 7:23
4/5/2021,Suphan Buri,14,313,837411,404175,433236,12597,12597,0,,,19/1/2022 7:23
4/5/2021,Surat Thani,35,887,1068431,526206,542225,3429,3408,21,77,38,19/1/2022 7:23
4/5/2021,Surin,4,119,1377702,685565,692137,8806,8806,0,,,19/1/2022 7:23
4/5/2021,Sukhothai,0,97,586803,284381,302422,4869,4747,122,,,19/1/2022 7:23
4/5/2021,Nong Khai,0,71,517275,256665,260610,13264,13246,18,35,12,19/1/2022 7:23
4/5/2021,Nong Bua Lam Phu,0,30,509382,254164,255218,2186,2186,0,,,19/1/2022 7:23
4/5/2021,Amnat Charoen,4,44,376342,187394,188948,1140,1140,0,,,19/1/2022 7:23
4/5/2021,Udon Thani,3,383,1567699,776819,790880,11676,11669,7,,,19/1/2022 7:23
4/5/2021,Uttaradit,1,68,447682,218270,229412,8216,8216,0,,,19/1/2022 7:23
4/5/2021,Uthai Thani,1,18,325555,159138,166417,2668,2668,0,,,19/1/2022 7:23
4/5/2021,Ubon Ratchathani,7,268,1867034,932378,934656,17785,17785,0,115,48,19/1/2022 7:23
4/5/2021,Ang Thong,6,230,275934,132137,143797,2679,2679,0,,,19/1/2022 7:23
4/5/2021,Chiang Rai,26,509,1296741,630516,666225,33777,33431,346,94,28,19/1/2022 7:23
4/5/2021,Chiang Mai,41,3781,1785286,862939,922347,97868,95795,2073,77,35,19/1/2022 7:23
4/5/2021,Phetchaburi,8,552,482261,232800,249461,48502,48311,191,,,19/1/2022 7:23
4/5/2021,Phetchabun,2,76,980259,483622,496637,30774,30774,0,,,19/1/2022 7:23
4/5/2021,Loei,0,75,638528,320030,318498,6303,6296,7,46,32,19/1/2022 7:23
4/5/2021,Phrae,2,72,436092,210253,225839,7717,7717,0,80,36,19/1/2022 7:23
4/5/2021,Mae Hong Son,1,45,285641,144762,140879,13138,12870,268,86,19,19/1/2022 7:23
4/5/2021,,0,153,,,,,,,,,19/1/2022 7:23
5/5/2021,Krabi,28,194,478425,237576,240849,2222,2082,140,,,19/1/2022 7:23
5/5/2021,Bangkok,791,20273,5565337,2611984,2953353,353401,323907,29494,90,35,19/1/2022 7:23
5/5/2021,Kanchanaburi,5,186,892304,447427,444877,38060,37817,243,52,23,19/1/2022 7:23
5/5/2021,Kalasin,3,79,977098,483228,493870,2258,2258,0,,,19/1/2022 7:23
5/5/2021,Kamphaeng Phet,2,112,713612,352508,361104,8775,8775,0,,,19/1/2022 7:23
5/5/2021,Khon Kaen,21,428,1793078,881616,911462,46729,46690,39,84,40,19/1/2022 7:23
5/5/2021,Chanthaburi,16,532,535709,261994,273715,22331,22275,56,,,19/1/2022 7:23
5/5/2021,Chachoengsao,17,412,721880,353941,367939,5688,5688,0,73,38,19/1/2022 7:23
5/5/2021,Chon Buri,111,4512,1572844,766647,806197,29860,29153,707,75,28,19/1/2022 7:23
5/5/2021,Chai Nat,7,77,321640,154663,166977,5843,5843,0,,,19/1/2022 7:23
5/5/2021,Chaiyaphum,2,157,1124135,555470,568665,7737,7725,12,,,19/1/2022 7:23
5/5/2021,Chumphon,3,99,509660,251522,258138,1501,1501,0,,,19/1/2022 7:23
5/5/2021,Trang,9,227,640335,313195,327140,1786,1786,0,,,19/1/2022 7:23
5/5/2021,Trat,10,131,228577,113056,115521,25099,24970,129,,,19/1/2022 7:23
5/5/2021,Tak,10,428,673504,340558,332946,19138,19115,23,,,19/1/2022 7:23
5/5/2021,Nakhon Nayok,5,137,259663,128076,131587,7533,7533,0,,,19/1/2022 7:23
5/5/2021,Nakhon Pathom,11,862,922477,443242,479235,13279,13263,16,59,33,19/1/2022 7:23
5/5/2021,Nakhon Phanom,2,120,717008,357388,359620,4972,4963,9,,,19/1/2022 7:23
5/5/2021,Nakhon Ratchasima,18,652,2633898,1294636,1339262,95155,94599,556,67,29,19/1/2022 7:23
5/5/2021,Nakhon Si Thammarat,32,483,1550685,765026,785659,7956,7956,0,,,19/1/2022 7:23
5/5/2021,Nakhon Sawan,6,397,1038321,506625,531696,21893,21893,0,75,36,19/1/2022 7:23
5/5/2021,Nonthaburi,251,2906,1282168,596750,685418,3634,3613,21,66,23,19/1/2022 7:23
5/5/2021,Narathiwat,2,585,807640,399607,408033,1063,1063,0,40,15,19/1/2022 7:23
5/5/2021,Nan,1,108,476276,238368,237908,6955,6876,79,,,19/1/2022 7:23
5/5/2021,Bueng Kan,2,18,422395,211815,210580,2107,2107,0,,,19/1/2022 7:23
5/5/2021,Buri Ram,0,140,1580600,784622,795978,19949,19899,50,,,19/1/2022 7:23
5/5/2021,Pathum Thani,50,1847,1181742,559988,621754,2265,2237,28,78,20,19/1/2022 7:23
5/5/2021,Prachuap Khiri Khan,13,1142,550568,272298,278270,51821,51734,87,,,19/1/2022 7:23
5/5/2021,Prachin Buri,3,224,494216,244010,250206,5966,5966,0,85,32,19/1/2022 7:23
5/5/2021,Pattani,32,254,727981,359468,368513,1288,1288,0,,,19/1/2022 7:23
5/5/2021,Phra Nakhon Si Ayutthaya,29,609,819893,393933,425960,61595,61233,362,69,47,19/1/2022 7:23
5/5/2021,Phayao,1,91,466006,226859,239147,11143,11122,21,71,28,19/1/2022 7:23
5/5/2021,Phang-nga,1,45,268719,134080,134639,8721,8100,621,,,19/1/2022 7:23
5/5/2021,Phatthalung,18,330,523135,254907,268228,1911,1911,0,,,19/1/2022 7:23
5/5/2021,Phichit,3,81,531511,259350,272161,7231,7231,0,,,19/1/2022 7:23
5/5/2021,Phitsanulok,1,296,847403,414611,432792,30519,30433,86,,,19/1/2022 7:23
5/5/2021,Phuket,12,698,414526,195824,218702,5291,4766,525,66,27,19/1/2022 7:23
5/5/2021,Maha Sarakham,5,248,951267,466548,484719,4341,4341,0,,,19/1/2022 7:23
5/5/2021,Mukdahan,2,31,351099,175412,175687,6784,6784,0,,,19/1/2022 7:23
5/5/2021,Yala,18,256,540317,268883,271434,2178,2178,0,54,20,19/1/2022 7:23
5/5/2021,Yasothon,1,80,534080,266625,267455,952,952,0,,,19/1/2022 7:23
5/5/2021,Ranong,9,296,194750,98304,96446,1678,1678,0,,,19/1/2022 7:23
5/5/2021,Rayong,22,1200,746202,366668,379534,22710,22497,213,76,31,19/1/2022 7:23
5/5/2021,Ratchaburi,20,394,869157,422653,446504,7378,7378,0,,,19/1/2022 7:23
5/5/2021,Roi Et,5,172,1297760,643167,654593,6265,6265,0,,,19/1/2022 7:23
5/5/2021,Lop Buri,5,170,739849,368410,371439,10549,10510,39,,,19/1/2022 7:23
5/5/2021,Lampang,8,235,727262,354467,372795,9481,9078,403,64,36,19/1/2022 7:23
5/5/2021,Lamphun,7,289,401851,193249,208602,8607,8482,125,,,19/1/2022 7:23
5/5/2021,Si Sa Ket,6,198,1457888,725954,731934,3439,3439,0,,,19/1/2022 7:23
5/5/2021,Sakon Nakhon,4,77,1147056,570138,576918,3867,3867,0,,,19/1/2022 7:23
5/5/2021,Songkhla,36,913,1429188,696564,732624,2754,2723,31,41,25,19/1/2022 7:23
5/5/2021,Satun,0,41,324400,161412,162988,5525,5489,36,29,16,19/1/2022 7:23
5/5/2021,Samut Prakarn,226,3417,1354816,645683,709133,3744,3666,78,,,19/1/2022 7:23
5/5/2021,Samut Songkhram,3,129,191777,91661,100116,13850,13794,56,38,27,19/1/2022 7:23
5/5/2021,Samut Sakhon,51,18289,586821,282842,303979,1725,1725,0,82,37,19/1/2022 7:23
5/5/2021,Saraburi,11,208,643778,316334,327444,17834,17781,53,83,96,19/1/2022 7:23
5/5/2021,Sa kaeo,6,380,561072,279991,281081,3712,3712,0,53,18,19/1/2022 7:23
5/5/2021,Sing Buri,0,75,205391,97605,107786,3742,3742,0,,,19/1/2022 7:23
5/5/2021,Suphan Buri,9,322,837411,404175,433236,12597,12597,0,,,19/1/2022 7:23
5/5/2021,Surat Thani,65,952,1068431,526206,542225,3429,3408,21,75,32,19/1/2022 7:23
5/5/2021,Surin,1,120,1377702,685565,692137,8806,8806,0,,,19/1/2022 7:23
5/5/2021,Sukhothai,3,100,586803,284381,302422,4869,4747,122,,,19/1/2022 7:23
5/5/2021,Nong Khai,0,71,517275,256665,260610,13264,13246,18,32,13,19/1/2022 7:23
5/5/2021,Nong Bua Lam Phu,1,31,509382,254164,255218,2186,2186,0,,,19/1/2022 7:23
5/5/2021,Amnat Charoen,0,44,376342,187394,188948,1140,1140,0,,,19/1/2022 7:23
5/5/2021,Udon Thani,0,383,1567699,776819,790880,11676,11669,7,,,19/1/2022 7:23
5/5/2021,Uttaradit,1,69,447682,218270,229412,8216,8216,0,,,19/1/2022 7:23
5/5/2021,Uthai Thani,0,18,325555,159138,166417,2668,2668,0,,,19/1/2022 7:23
5/5/2021,Ubon Ratchathani,6,274,1867034,932378,934656,17785,17785,0,105,34,19/1/2022 7:23
5/5/2021,Ang Thong,0,230,275934,132137,143797,2679,2679,0,,,19/1/2022 7:23
5/5/2021,Chiang Rai,3,512,1296741,630516,666225,33777,33431,346,72,14,19/1/2022 7:23
5/5/2021,Chiang Mai,40,3821,1785286,862939,922347,97868,95795,2073,77,35,19/1/2022 7:23
5/5/2021,Phetchaburi,6,558,482261,232800,249461,48502,48311,191,,,19/1/2022 7:23
5/5/2021,Phetchabun,2,78,980259,483622,496637,30774,30774,0,,,19/1/2022 7:23
5/5/2021,Loei,1,76,638528,320030,318498,6303,6296,7,51,28,19/1/2022 7:23
5/5/2021,Phrae,1,73,436092,210253,225839,7717,7717,0,79,26,19/1/2022 7:23
5/5/2021,Mae Hong Son,0,45,285641,144762,140879,13138,12870,268,66,22,19/1/2022 7:23
5/5/2021,,0,153,,,,,,,,,19/1/2022 7:23
6/5/2021,Krabi,7,201,478425,237576,240849,2222,2082,140,,,19/1/2022 7:23
6/5/2021,Bangkok,740,21013,5565337,2611984,2953353,353401,323907,29494,69,28,19/1/2022 7:23
6/5/2021,Kanchanaburi,14,200,892304,447427,444877,38060,37817,243,56,17,19/1/2022 7:23
6/5/2021,Kalasin,1,80,977098,483228,493870,2258,2258,0,,,19/1/2022 7:23
6/5/2021,Kamphaeng Phet,2,114,713612,352508,361104,8775,8775,0,,,19/1/2022 7:23
6/5/2021,Khon Kaen,6,434,1793078,881616,911462,46729,46690,39,73,47,19/1/2022 7:23
6/5/2021,Chanthaburi,7,539,535709,261994,273715,22331,22275,56,,,19/1/2022 7:23
6/5/2021,Chachoengsao,35,447,721880,353941,367939,5688,5688,0,66,34,19/1/2022 7:23
6/5/2021,Chon Buri,78,4590,1572844,766647,806197,29860,29153,707,60,24,19/1/2022 7:23
6/5/2021,Chai Nat,1,78,321640,154663,166977,5843,5843,0,,,19/1/2022 7:23
6/5/2021,Chaiyaphum,0,157,1124135,555470,568665,7737,7725,12,,,19/1/2022 7:23
6/5/2021,Chumphon,1,100,509660,251522,258138,1501,1501,0,,,19/1/2022 7:23
6/5/2021,Trang,12,239,640335,313195,327140,1786,1786,0,,,19/1/2022 7:23
6/5/2021,Trat,1,132,228577,113056,115521,25099,24970,129,,,19/1/2022 7:23
6/5/2021,Tak,0,428,673504,340558,332946,19138,19115,23,,,19/1/2022 7:23
6/5/2021,Nakhon Nayok,9,146,259663,128076,131587,7533,7533,0,,,19/1/2022 7:23
6/5/2021,Nakhon Pathom,47,909,922477,443242,479235,13279,13263,16,60,23,19/1/2022 7:23
6/5/2021,Nakhon Phanom,2,122,717008,357388,359620,4972,4963,9,,,19/1/2022 7:23
6/5/2021,Nakhon Ratchasima,12,664,2633898,1294636,1339262,95155,94599,556,61,26,19/1/2022 7:23
6/5/2021,Nakhon Si Thammarat,31,514,1550685,765026,785659,7956,7956,0,,,19/1/2022 7:23
6/5/2021,Nakhon Sawan,7,404,1038321,506625,531696,21893,21893,0,77,30,19/1/2022 7:23
6/5/2021,Nonthaburi,276,3182,1282168,596750,685418,3634,3613,21,53,18,19/1/2022 7:23
6/5/2021,Narathiwat,11,596,807640,399607,408033,1063,1063,0,34,13,19/1/2022 7:23
6/5/2021,Nan,2,110,476276,238368,237908,6955,6876,79,,,19/1/2022 7:23
6/5/2021,Bueng Kan,1,19,422395,211815,210580,2107,2107,0,,,19/1/2022 7:23
6/5/2021,Buri Ram,2,142,1580600,784622,795978,19949,19899,50,,,19/1/2022 7:23
6/5/2021,Pathum Thani,31,1878,1181742,559988,621754,2265,2237,28,60,21,19/1/2022 7:23
6/5/2021,Prachuap Khiri Khan,22,1164,550568,272298,278270,51821,51734,87,,,19/1/2022 7:23
6/5/2021,Prachin Buri,5,229,494216,244010,250206,5966,5966,0,70,26,19/1/2022 7:23
6/5/2021,Pattani,13,267,727981,359468,368513,1288,1288,0,,,19/1/2022 7:23
6/5/2021,Phra Nakhon Si Ayutthaya,35,644,819893,393933,425960,61595,61233,362,56,39,19/1/2022 7:23
6/5/2021,Phayao,0,91,466006,226859,239147,11143,11122,21,66,27,19/1/2022 7:23
6/5/2021,Phang-nga,2,47,268719,134080,134639,8721,8100,621,,,19/1/2022 7:23
6/5/2021,Phatthalung,18,348,523135,254907,268228,1911,1911,0,,,19/1/2022 7:23
6/5/2021,Phichit,1,82,531511,259350,272161,7231,7231,0,,,19/1/2022 7:23
6/5/2021,Phitsanulok,1,297,847403,414611,432792,30519,30433,86,,,19/1/2022 7:23
6/5/2021,Phuket,18,716,414526,195824,218702,5291,4766,525,65,23,19/1/2022 7:23
6/5/2021,Maha Sarakham,9,257,951267,466548,484719,4341,4341,0,,,19/1/2022 7:23
6/5/2021,Mukdahan,0,31,351099,175412,175687,6784,6784,0,,,19/1/2022 7:23
6/5/2021,Yala,6,262,540317,268883,271434,2178,2178,0,45,18,19/1/2022 7:23
6/5/2021,Yasothon,4,84,534080,266625,267455,952,952,0,,,19/1/2022 7:23
6/5/2021,Ranong,5,301,194750,98304,96446,1678,1678,0,,,19/1/2022 7:23
6/5/2021,Rayong,13,1213,746202,366668,379534,22710,22497,213,61,32,19/1/2022 7:23
6/5/2021,Ratchaburi,12,406,869157,422653,446504,7378,7378,0,,,19/1/2022 7:23
6/5/2021,Roi Et,3,175,1297760,643167,654593,6265,6265,0,,,19/1/2022 7:23
6/5/2021,Lop Buri,0,170,739849,368410,371439,10549,10510,39,,,19/1/2022 7:23
6/5/2021,Lampang,1,236,727262,354467,372795,9481,9078,403,60,26,19/1/2022 7:23
6/5/2021,Lamphun,2,291,401851,193249,208602,8607,8482,125,,,19/1/2022 7:23
6/5/2021,Si Sa Ket,4,202,1457888,725954,731934,3439,3439,0,,,19/1/2022 7:23
6/5/2021,Sakon Nakhon,1,78,1147056,570138,576918,3867,3867,0,,,19/1/2022 7:23
6/5/2021,Songkhla,14,927,1429188,696564,732624,2754,2723,31,46,20,19/1/2022 7:23
6/5/2021,Satun,0,41,324400,161412,162988,5525,5489,36,34,16,19/1/2022 7:23
6/5/2021,Samut Prakarn,144,3561,1354816,645683,709133,3744,3666,78,,,19/1/2022 7:23
6/5/2021,Samut Songkhram,6,135,191777,91661,100116,13850,13794,56,61,16,19/1/2022 7:23
6/5/2021,Samut Sakhon,65,18354,586821,282842,303979,1725,1725,0,73,28,19/1/2022 7:23
6/5/2021,Saraburi,10,218,643778,316334,327444,17834,17781,53,94,87,19/1/2022 7:23
6/5/2021,Sa kaeo,8,388,561072,279991,281081,3712,3712,0,41,9,19/1/2022 7:23
6/5/2021,Sing Buri,1,76,205391,97605,107786,3742,3742,0,,,19/1/2022 7:23
6/5/2021,Suphan Buri,18,340,837411,404175,433236,12597,12597,0,,,19/1/2022 7:23
6/5/2021,Surat Thani,53,1005,1068431,526206,542225,3429,3408,21,76,30,19/1/2022 7:23
6/5/2021,Surin,0,120,1377702,685565,692137,8806,8806,0,,,19/1/2022 7:23
6/5/2021,Sukhothai,1,101,586803,284381,302422,4869,4747,122,,,19/1/2022 7:23
6/5/2021,Nong Khai,0,71,517275,256665,260610,13264,13246,18,34,10,19/1/2022 7:23
6/5/2021,Nong Bua Lam Phu,0,31,509382,254164,255218,2186,2186,0,,,19/1/2022 7:23
6/5/2021,Amnat Charoen,0,44,376342,187394,188948,1140,1140,0,,,19/1/2022 7:23
6/5/2021,Udon Thani,1,384,1567699,776819,790880,11676,11669,7,,,19/1/2022 7:23
6/5/2021,Uttaradit,4,73,447682,218270,229412,8216,8216,0,,,19/1/2022 7:23
6/5/2021,Uthai Thani,0,18,325555,159138,166417,2668,2668,0,,,19/1/2022 7:23
6/5/2021,Ubon Ratchathani,8,282,1867034,932378,934656,17785,17785,0,72,45,19/1/2022 7:23
6/5/2021,Ang Thong,11,241,275934,132137,143797,2679,2679,0,,,19/1/2022 7:23
6/5/2021,Chiang Rai,17,529,1296741,630516,666225,33777,33431,346,40,16,19/1/2022 7:23
6/5/2021,Chiang Mai,23,3844,1785286,862939,922347,97868,95795,2073,75,31,19/1/2022 7:23
6/5/2021,Phetchaburi,12,570,482261,232800,249461,48502,48311,191,,,19/1/2022 7:23
6/5/2021,Phetchabun,1,79,980259,483622,496637,30774,30774,0,,,19/1/2022 7:23
6/5/2021,Loei,2,78,638528,320030,318498,6303,6296,7,50,32,19/1/2022 7:23
6/5/2021,Phrae,1,74,436092,210253,225839,7717,7717,0,60,23,19/1/2022 7:23
6/5/2021,Mae Hong Son,0,45,285641,144762,140879,13138,12870,268,74,18,19/1/2022 7:23
6/5/2021,,0,153,,,,,,,,,19/1/2022 7:23
7/5/2021,Krabi,20,221,478425,237576,240849,2222,2082,140,,,19/1/2022 7:23
7/5/2021,Bangkok,869,21882,5565337,2611984,2953353,353401,323907,29494,48,42,19/1/2022 7:23
7/5/2021,Kanchanaburi,16,216,892304,447427,444877,38060,37817,243,43,19,19/1/2022 7:23
7/5/2021,Kalasin,6,86,977098,483228,493870,2258,2258,0,,,19/1/2022 7:23
7/5/2021,Kamphaeng Phet,0,114,713612,352508,361104,8775,8775,0,,,19/1/2022 7:23
7/5/2021,Khon Kaen,2,436,1793078,881616,911462,46729,46690,39,80,52,19/1/2022 7:23
7/5/2021,Chanthaburi,25,564,535709,261994,273715,22331,22275,56,,,19/1/2022 7:23
7/5/2021,Chachoengsao,12,459,721880,353941,367939,5688,5688,0,53,53,19/1/2022 7:23
7/5/2021,Chon Buri,90,4680,1572844,766647,806197,29860,29153,707,51,30,19/1/2022 7:23
7/5/2021,Chai Nat,5,83,321640,154663,166977,5843,5843,0,,,19/1/2022 7:23
7/5/2021,Chaiyaphum,1,158,1124135,555470,568665,7737,7725,12,,,19/1/2022 7:23
7/5/2021,Chumphon,1,101,509660,251522,258138,1501,1501,0,,,19/1/2022 7:23
7/5/2021,Trang,8,247,640335,313195,327140,1786,1786,0,,,19/1/2022 7:23
7/5/2021,Trat,8,140,228577,113056,115521,25099,24970,129,,,19/1/2022 7:23
7/5/2021,Tak,2,430,673504,340558,332946,19138,19115,23,,,19/1/2022 7:23
7/5/2021,Nakhon Nayok,6,152,259663,128076,131587,7533,7533,0,,,19/1/2022 7:23
7/5/2021,Nakhon Pathom,29,938,922477,443242,479235,13279,13263,16,42,26,19/1/2022 7:23
7/5/2021,Nakhon Phanom,2,124,717008,357388,359620,4972,4963,9,,,19/1/2022 7:23
7/5/2021,Nakhon Ratchasima,10,674,2633898,1294636,1339262,95155,94599,556,54,30,19/1/2022 7:23
7/5/2021,Nakhon Si Thammarat,27,541,1550685,765026,785659,7956,7956,0,,,19/1/2022 7:23
7/5/2021,Nakhon Sawan,8,412,1038321,506625,531696,21893,21893,0,68,35,19/1/2022 7:23
7/5/2021,Nonthaburi,201,3383,1282168,596750,685418,3634,3613,21,35,21,19/1/2022 7:23
7/5/2021,Narathiwat,8,604,807640,399607,408033,1063,1063,0,20,20,19/1/2022 7:23
7/5/2021,Nan,1,111,476276,238368,237908,6955,6876,79,,,19/1/2022 7:23
7/5/2021,Bueng Kan,2,21,422395,211815,210580,2107,2107,0,,,19/1/2022 7:23
7/5/2021,Buri Ram,5,147,1580600,784622,795978,19949,19899,50,,,19/1/2022 7:23
7/5/2021,Pathum Thani,39,1917,1181742,559988,621754,2265,2237,28,54,26,19/1/2022 7:23
7/5/2021,Prachuap Khiri Khan,27,1191,550568,272298,278270,51821,51734,87,,,19/1/2022 7:23
7/5/2021,Prachin Buri,13,242,494216,244010,250206,5966,5966,0,50,41,19/1/2022 7:23
7/5/2021,Pattani,12,279,727981,359468,368513,1288,1288,0,,,19/1/2022 7:23
7/5/2021,Phra Nakhon Si Ayutthaya,32,676,819893,393933,425960,61595,61233,362,36,46,19/1/2022 7:23
7/5/2021,Phayao,0,91,466006,226859,239147,11143,11122,21,58,38,19/1/2022 7:23
7/5/2021,Phang-nga,0,47,268719,134080,134639,8721,8100,621,,,19/1/2022 7:23
7/5/2021,Phatthalung,6,354,523135,254907,268228,1911,1911,0,,,19/1/2022 7:23
7/5/2021,Phichit,2,84,531511,259350,272161,7231,7231,0,,,19/1/2022 7:23
7/5/2021,Phitsanulok,4,301,847403,414611,432792,30519,30433,86,,,19/1/2022 7:23
7/5/2021,Phuket,5,721,414526,195824,218702,5291,4766,525,55,22,19/1/2022 7:23
7/5/2021,Maha Sarakham,4,261,951267,466548,484719,4341,4341,0,,,19/1/2022 7:23
7/5/2021,Mukdahan,0,31,351099,175412,175687,6784,6784,0,,,19/1/2022 7:23
7/5/2021,Yala,5,267,540317,268883,271434,2178,2178,0,41,23,19/1/2022 7:23
7/5/2021,Yasothon,3,87,534080,266625,267455,952,952,0,,,19/1/2022 7:23
7/5/2021,Ranong,29,330,194750,98304,96446,1678,1678,0,,,19/1/2022 7:23
7/5/2021,Rayong,13,1226,746202,366668,379534,22710,22497,213,55,35,19/1/2022 7:23
7/5/2021,Ratchaburi,15,421,869157,422653,446504,7378,7378,0,,,19/1/2022 7:23
7/5/2021,Roi Et,7,182,1297760,643167,654593,6265,6265,0,,,19/1/2022 7:23
7/5/2021,Lop Buri,5,175,739849,368410,371439,10549,10510,39,,,19/1/2022 7:23
7/5/2021,Lampang,7,243,727262,354467,372795,9481,9078,403,44,38,19/1/2022 7:23
7/5/2021,Lamphun,3,294,401851,193249,208602,8607,8482,125,,,19/1/2022 7:23
7/5/2021,Si Sa Ket,16,218,1457888,725954,731934,3439,3439,0,,,19/1/2022 7:23
7/5/2021,Sakon Nakhon,1,79,1147056,570138,576918,3867,3867,0,,,19/1/2022 7:23
7/5/2021,Songkhla,23,950,1429188,696564,732624,2754,2723,31,35,26,19/1/2022 7:23
7/5/2021,Satun,0,41,324400,161412,162988,5525,5489,36,35,22,19/1/2022 7:23
7/5/2021,Samut Prakarn,165,3726,1354816,645683,709133,3744,3666,78,,,19/1/2022 7:23
7/5/2021,Samut Songkhram,5,140,191777,91661,100116,13850,13794,56,38,14,19/1/2022 7:23
7/5/2021,Samut Sakhon,69,18423,586821,282842,303979,1725,1725,0,59,47,19/1/2022 7:23
7/5/2021,Saraburi,12,230,643778,316334,327444,17834,17781,53,78,109,19/1/2022 7:23
7/5/2021,Sa kaeo,10,398,561072,279991,281081,3712,3712,0,21,22,19/1/2022 7:23
7/5/2021,Sing Buri,2,78,205391,97605,107786,3742,3742,0,,,19/1/2022 7:23
7/5/2021,Suphan Buri,12,352,837411,404175,433236,12597,12597,0,,,19/1/2022 7:23
7/5/2021,Surat Thani,60,1065,1068431,526206,542225,3429,3408,21,56,35,19/1/2022 7:23
7/5/2021,Surin,1,121,1377702,685565,692137,8806,8806,0,,,19/1/2022 7:23
7/5/2021,Sukhothai,1,102,586803,284381,302422,4869,4747,122,,,19/1/2022 7:23
7/5/2021,Nong Khai,1,72,517275,256665,260610,13264,13246,18,24,10,19/1/2022 7:23
7/5/2021,Nong Bua Lam Phu,0,31,509382,254164,255218,2186,2186,0,,,19/1/2022 7:23
7/5/2021,Amnat Charoen,0,44,376342,187394,188948,1140,1140,0,,,19/1/2022 7:23
7/5/2021,Udon Thani,4,388,1567699,776819,790880,11676,11669,7,,,19/1/2022 7:23
7/5/2021,Uttaradit,3,76,447682,218270,229412,8216,8216,0,,,19/1/2022 7:23
7/5/2021,Uthai Thani,1,19,325555,159138,166417,2668,2668,0,,,19/1/2022 7:23
7/5/2021,Ubon Ratchathani,4,286,1867034,932378,934656,17785,17785,0,101,56,19/1/2022 7:23
7/5/2021,Ang Thong,5,246,275934,132137,143797,2679,2679,0,,,19/1/2022 7:23
7/5/2021,Chiang Rai,3,532,1296741,630516,666225,33777,33431,346,36,23,19/1/2022 7:23
7/5/2021,Chiang Mai,33,3877,1785286,862939,922347,97868,95795,2073,65,33,19/1/2022 7:23
7/5/2021,Phetchaburi,13,583,482261,232800,249461,48502,48311,191,,,19/1/2022 7:23
7/5/2021,Phetchabun,4,83,980259,483622,496637,30774,30774,0,,,19/1/2022 7:23
7/5/2021,Loei,1,79,638528,320030,318498,6303,6296,7,56,36,19/1/2022 7:23
7/5/2021,Phrae,0,74,436092,210253,225839,7717,7717,0,63,33,19/1/2022 7:23
7/5/2021,Mae Hong Son,0,45,285641,144762,140879,13138,12870,268,65,17,19/1/2022 7:23
7/5/2021,,0,153,,,,,,,,,19/1/2022 7:23
8/5/2021,Krabi,15,236,478425,237576,240849,2222,2082,140,,,19/1/2022 7:23
8/5/2021,Bangkok,1116,22998,5565337,2611984,2953353,353401,323907,29494,83,34,19/1/2022 7:23
8/5/2021,Kanchanaburi,4,220,892304,447427,444877,38060,37817,243,48,12,19/1/2022 7:23
8/5/2021,Kalasin,1,87,977098,483228,493870,2258,2258,0,,,19/1/2022 7:23
8/5/2021,Kamphaeng Phet,1,115,713612,352508,361104,8775,8775,0,,,19/1/2022 7:23
8/5/2021,Khon Kaen,5,441,1793078,881616,911462,46729,46690,39,92,49,19/1/2022 7:23
8/5/2021,Chanthaburi,27,591,535709,261994,273715,22331,22275,56,,,19/1/2022 7:23
8/5/2021,Chachoengsao,27,486,721880,353941,367939,5688,5688,0,82,48,19/1/2022 7:23
8/5/2021,Chon Buri,73,4753,1572844,766647,806197,29860,29153,707,58,37,19/1/2022 7:23
8/5/2021,Chai Nat,3,86,321640,154663,166977,5843,5843,0,,,19/1/2022 7:23
8/5/2021,Chaiyaphum,3,161,1124135,555470,568665,7737,7725,12,,,19/1/2022 7:23
8/5/2021,Chumphon,0,101,509660,251522,258138,1501,1501,0,,,19/1/2022 7:23
8/5/2021,Trang,10,257,640335,313195,327140,1786,1786,0,,,19/1/2022 7:23
8/5/2021,Trat,5,145,228577,113056,115521,25099,24970,129,,,19/1/2022 7:23
8/5/2021,Tak,4,434,673504,340558,332946,19138,19115,23,,,19/1/2022 7:23
8/5/2021,Nakhon Nayok,3,155,259663,128076,131587,7533,7533,0,,,19/1/2022 7:23
8/5/2021,Nakhon Pathom,28,966,922477,443242,479235,13279,13263,16,52,24,19/1/2022 7:23
8/5/2021,Nakhon Phanom,0,124,717008,357388,359620,4972,4963,9,,,19/1/2022 7:23
8/5/2021,Nakhon Ratchasima,15,689,2633898,1294636,1339262,95155,94599,556,58,26,19/1/2022 7:23
8/5/2021,Nakhon Si Thammarat,24,565,1550685,765026,785659,7956,7956,0,,,19/1/2022 7:23
8/5/2021,Nakhon Sawan,6,418,1038321,506625,531696,21893,21893,0,75,21,19/1/2022 7:23
8/5/2021,Nonthaburi,218,3601,1282168,596750,685418,3634,3613,21,53,20,19/1/2022 7:23
8/5/2021,Narathiwat,1,605,807640,399607,408033,1063,1063,0,30,16,19/1/2022 7:23
8/5/2021,Nan,0,111,476276,238368,237908,6955,6876,79,,,19/1/2022 7:23
8/5/2021,Bueng Kan,1,22,422395,211815,210580,2107,2107,0,,,19/1/2022 7:23
8/5/2021,Buri Ram,3,150,1580600,784622,795978,19949,19899,50,,,19/1/2022 7:23
8/5/2021,Pathum Thani,93,2010,1181742,559988,621754,2265,2237,28,65,19,19/1/2022 7:23
8/5/2021,Prachuap Khiri Khan,100,1291,550568,272298,278270,51821,51734,87,,,19/1/2022 7:23
8/5/2021,Prachin Buri,63,305,494216,244010,250206,5966,5966,0,74,37,19/1/2022 7:23
8/5/2021,Pattani,9,288,727981,359468,368513,1288,1288,0,,,19/1/2022 7:23
8/5/2021,Phra Nakhon Si Ayutthaya,29,705,819893,393933,425960,61595,61233,362,50,42,19/1/2022 7:23
8/5/2021,Phayao,0,91,466006,226859,239147,11143,11122,21,79,28,19/1/2022 7:23
8/5/2021,Phang-nga,0,47,268719,134080,134639,8721,8100,621,,,19/1/2022 7:23
8/5/2021,Phatthalung,12,366,523135,254907,268228,1911,1911,0,,,19/1/2022 7:23
8/5/2021,Phichit,6,90,531511,259350,272161,7231,7231,0,,,19/1/2022 7:23
8/5/2021,Phitsanulok,4,305,847403,414611,432792,30519,30433,86,,,19/1/2022 7:23
8/5/2021,Phuket,10,731,414526,195824,218702,5291,4766,525,51,23,19/1/2022 7:23
8/5/2021,Maha Sarakham,6,267,951267,466548,484719,4341,4341,0,,,19/1/2022 7:23
8/5/2021,Mukdahan,1,32,351099,175412,175687,6784,6784,0,,,19/1/2022 7:23
8/5/2021,Yala,6,273,540317,268883,271434,2178,2178,0,50,19,19/1/2022 7:23
8/5/2021,Yasothon,4,91,534080,266625,267455,952,952,0,,,19/1/2022 7:23
8/5/2021,Ranong,50,380,194750,98304,96446,1678,1678,0,,,19/1/2022 7:23
8/5/2021,Rayong,19,1245,746202,366668,379534,22710,22497,213,53,40,19/1/2022 7:23
8/5/2021,Ratchaburi,16,437,869157,422653,446504,7378,7378,0,,,19/1/2022 7:23
8/5/2021,Roi Et,5,187,1297760,643167,654593,6265,6265,0,,,19/1/2022 7:23
8/5/2021,Lop Buri,6,181,739849,368410,371439,10549,10510,39,,,19/1/2022 7:23
8/5/2021,Lampang,2,245,727262,354467,372795,9481,9078,403,69,24,19/1/2022 7:23
8/5/2021,Lamphun,0,294,401851,193249,208602,8607,8482,125,,,19/1/2022 7:23
8/5/2021,Si Sa Ket,11,229,1457888,725954,731934,3439,3439,0,,,19/1/2022 7:23
8/5/2021,Sakon Nakhon,4,83,1147056,570138,576918,3867,3867,0,,,19/1/2022 7:23
8/5/2021,Songkhla,19,969,1429188,696564,732624,2754,2723,31,49,26,19/1/2022 7:23
8/5/2021,Satun,0,41,324400,161412,162988,5525,5489,36,49,15,19/1/2022 7:23
8/5/2021,Samut Prakarn,116,3842,1354816,645683,709133,3744,3666,78,,,19/1/2022 7:23
8/5/2021,Samut Songkhram,4,144,191777,91661,100116,13850,13794,56,35,16,19/1/2022 7:23
8/5/2021,Samut Sakhon,77,18500,586821,282842,303979,1725,1725,0,91,28,19/1/2022 7:23
8/5/2021,Saraburi,5,235,643778,316334,327444,17834,17781,53,93,67,19/1/2022 7:23
8/5/2021,Sa kaeo,12,410,561072,279991,281081,3712,3712,0,47,17,19/1/2022 7:23
8/5/2021,Sing Buri,3,81,205391,97605,107786,3742,3742,0,,,19/1/2022 7:23
8/5/2021,Suphan Buri,9,361,837411,404175,433236,12597,12597,0,,,19/1/2022 7:23
8/5/2021,Surat Thani,35,1100,1068431,526206,542225,3429,3408,21,64,34,19/1/2022 7:23
8/5/2021,Surin,3,124,1377702,685565,692137,8806,8806,0,,,19/1/2022 7:23
8/5/2021,Sukhothai,2,104,586803,284381,302422,4869,4747,122,,,19/1/2022 7:23
8/5/2021,Nong Khai,2,74,517275,256665,260610,13264,13246,18,25,10,19/1/2022 7:23
8/5/2021,Nong Bua Lam Phu,0,31,509382,254164,255218,2186,2186,0,,,19/1/2022 7:23
8/5/2021,Amnat Charoen,1,45,376342,187394,188948,1140,1140,0,,,19/1/2022 7:23
8/5/2021,Udon Thani,5,393,1567699,776819,790880,11676,11669,7,,,19/1/2022 7:23
8/5/2021,Uttaradit,2,78,447682,218270,229412,8216,8216,0,,,19/1/2022 7:23
8/5/2021,Uthai Thani,2,21,325555,159138,166417,2668,2668,0,,,19/1/2022 7:23
8/5/2021,Ubon Ratchathani,22,308,1867034,932378,934656,17785,17785,0,134,39,19/1/2022 7:23
8/5/2021,Ang Thong,5,251,275934,132137,143797,2679,2679,0,,,19/1/2022 7:23
8/5/2021,Chiang Rai,7,539,1296741,630516,666225,33777,33431,346,61,16,19/1/2022 7:23
8/5/2021,Chiang Mai,21,3898,1785286,862939,922347,97868,95795,2073,74,28,19/1/2022 7:23
8/5/2021,Phetchaburi,12,595,482261,232800,249461,48502,48311,191,,,19/1/2022 7:23
8/5/2021,Phetchabun,3,86,980259,483622,496637,30774,30774,0,,,19/1/2022 7:23
8/5/2021,Loei,2,81,638528,320030,318498,6303,6296,7,65,31,19/1/2022 7:23
8/5/2021,Phrae,1,75,436092,210253,225839,7717,7717,0,82,24,19/1/2022 7:23
8/5/2021,Mae Hong Son,0,45,285641,144762,140879,13138,12870,268,62,18,19/1/2022 7:23
8/5/2021,,0,153,,,,,,,,,19/1/2022 7:23
9/5/2021,Krabi,13,249,478425,237576,240849,2222,2082,140,,,19/1/2022 7:23
9/5/2021,Bangkok,983,23981,5565337,2611984,2953353,353401,323907,29494,71,31,19/1/2022 7:23
9/5/2021,Kanchanaburi,9,229,892304,447427,444877,38060,37817,243,32,12,19/1/2022 7:23
9/5/2021,Kalasin,2,89,977098,483228,493870,2258,2258,0,,,19/1/2022 7:23
9/5/2021,Kamphaeng Phet,1,116,713612,352508,361104,8775,8775,0,,,19/1/2022 7:23
9/5/2021,Khon Kaen,6,447,1793078,881616,911462,46729,46690,39,95,49,19/1/2022 7:23
9/5/2021,Chanthaburi,38,629,535709,261994,273715,22331,22275,56,,,19/1/2022 7:23
9/5/2021,Chachoengsao,7,493,721880,353941,367939,5688,5688,0,69,52,19/1/2022 7:23
9/5/2021,Chon Buri,101,4854,1572844,766647,806197,29860,29153,707,66,33,19/1/2022 7:23
9/5/2021,Chai Nat,1,87,321640,154663,166977,5843,5843,0,,,19/1/2022 7:23
9/5/2021,Chaiyaphum,8,169,1124135,555470,568665,7737,7725,12,,,19/1/2022 7:23
9/5/2021,Chumphon,0,101,509660,251522,258138,1501,1501,0,,,19/1/2022 7:23
9/5/2021,Trang,4,261,640335,313195,327140,1786,1786,0,,,19/1/2022 7:23
9/5/2021,Trat,4,149,228577,113056,115521,25099,24970,129,,,19/1/2022 7:23
9/5/2021,Tak,4,438,673504,340558,332946,19138,19115,23,,,19/1/2022 7:23
9/5/2021,Nakhon Nayok,2,157,259663,128076,131587,7533,7533,0,,,19/1/2022 7:23
9/5/2021,Nakhon Pathom,22,988,922477,443242,479235,13279,13263,16,48,22,19/1/2022 7:23
9/5/2021,Nakhon Phanom,2,126,717008,357388,359620,4972,4963,9,,,19/1/2022 7:23
9/5/2021,Nakhon Ratchasima,20,709,2633898,1294636,1339262,95155,94599,556,59,31,19/1/2022 7:23
9/5/2021,Nakhon Si Thammarat,14,579,1550685,765026,785659,7956,7956,0,,,19/1/2022 7:23
9/5/2021,Nakhon Sawan,11,429,1038321,506625,531696,21893,21893,0,56,34,19/1/2022 7:23
9/5/2021,Nonthaburi,221,3822,1282168,596750,685418,3634,3613,21,52,24,19/1/2022 7:23
9/5/2021,Narathiwat,2,607,807640,399607,408033,1063,1063,0,39,16,19/1/2022 7:23
9/5/2021,Nan,0,111,476276,238368,237908,6955,6876,79,,,19/1/2022 7:23
9/5/2021,Bueng Kan,0,22,422395,211815,210580,2107,2107,0,,,19/1/2022 7:23
9/5/2021,Buri Ram,2,152,1580600,784622,795978,19949,19899,50,,,19/1/2022 7:23
9/5/2021,Pathum Thani,31,2041,1181742,559988,621754,2265,2237,28,54,23,19/1/2022 7:23
9/5/2021,Prachuap Khiri Khan,28,1319,550568,272298,278270,51821,51734,87,,,19/1/2022 7:23
9/5/2021,Prachin Buri,5,310,494216,244010,250206,5966,5966,0,76,37,19/1/2022 7:23
9/5/2021,Pattani,12,300,727981,359468,368513,1288,1288,0,,,19/1/2022 7:23
9/5/2021,Phra Nakhon Si Ayutthaya,17,722,819893,393933,425960,61595,61233,362,49,49,19/1/2022 7:23
9/5/2021,Phayao,0,91,466006,226859,239147,11143,11122,21,55,22,19/1/2022 7:23
9/5/2021,Phang-nga,1,48,268719,134080,134639,8721,8100,621,,,19/1/2022 7:23
9/5/2021,Phatthalung,4,370,523135,254907,268228,1911,1911,0,,,19/1/2022 7:23
9/5/2021,Phichit,10,100,531511,259350,272161,7231,7231,0,,,19/1/2022 7:23
9/5/2021,Phitsanulok,2,307,847403,414611,432792,30519,30433,86,,,19/1/2022 7:23
9/5/2021,Phuket,12,743,414526,195824,218702,5291,4766,525,54,25,19/1/2022 7:23
9/5/2021,Maha Sarakham,5,272,951267,466548,484719,4341,4341,0,,,19/1/2022 7:23
9/5/2021,Mukdahan,1,33,351099,175412,175687,6784,6784,0,,,19/1/2022 7:23
9/5/2021,Yala,3,276,540317,268883,271434,2178,2178,0,42,23,19/1/2022 7:23
9/5/2021,Yasothon,4,95,534080,266625,267455,952,952,0,,,19/1/2022 7:23
9/5/2021,Ranong,48,428,194750,98304,96446,1678,1678,0,,,19/1/2022 7:23
9/5/2021,Rayong,11,1256,746202,366668,379534,22710,22497,213,68,35,19/1/2022 7:23
9/5/2021,Ratchaburi,14,451,869157,422653,446504,7378,7378,0,,,19/1/2022 7:23
9/5/2021,Roi Et,6,193,1297760,643167,654593,6265,6265,0,,,19/1/2022 7:23
9/5/2021,Lop Buri,5,186,739849,368410,371439,10549,10510,39,,,19/1/2022 7:23
9/5/2021,Lampang,1,246,727262,354467,372795,9481,9078,403,39,27,19/1/2022 7:23
9/5/2021,Lamphun,2,296,401851,193249,208602,8607,8482,125,,,19/1/2022 7:23
9/5/2021,Si Sa Ket,13,242,1457888,725954,731934,3439,3439,0,,,19/1/2022 7:23
9/5/2021,Sakon Nakhon,0,83,1147056,570138,576918,3867,3867,0,,,19/1/2022 7:23
9/5/2021,Songkhla,15,984,1429188,696564,732624,2754,2723,31,60,26,19/1/2022 7:23
9/5/2021,Satun,0,41,324400,161412,162988,5525,5489,36,38,22,19/1/2022 7:23
9/5/2021,Samut Prakarn,110,3952,1354816,645683,709133,3744,3666,78,,,19/1/2022 7:23
9/5/2021,Samut Songkhram,4,148,191777,91661,100116,13850,13794,56,42,16,19/1/2022 7:23
9/5/2021,Samut Sakhon,95,18595,586821,282842,303979,1725,1725,0,66,41,19/1/2022 7:23
9/5/2021,Saraburi,14,249,643778,316334,327444,17834,17781,53,72,68,19/1/2022 7:23
9/5/2021,Sa kaeo,15,425,561072,279991,281081,3712,3712,0,41,18,19/1/2022 7:23
9/5/2021,Sing Buri,0,81,205391,97605,107786,3742,3742,0,,,19/1/2022 7:23
9/5/2021,Suphan Buri,5,366,837411,404175,433236,12597,12597,0,,,19/1/2022 7:23
9/5/2021,Surat Thani,50,1150,1068431,526206,542225,3429,3408,21,65,38,19/1/2022 7:23
9/5/2021,Surin,3,127,1377702,685565,692137,8806,8806,0,,,19/1/2022 7:23
9/5/2021,Sukhothai,0,104,586803,284381,302422,4869,4747,122,,,19/1/2022 7:23
9/5/2021,Nong Khai,0,74,517275,256665,260610,13264,13246,18,24,8,19/1/2022 7:23
9/5/2021,Nong Bua Lam Phu,1,32,509382,254164,255218,2186,2186,0,,,19/1/2022 7:23
9/5/2021,Amnat Charoen,2,47,376342,187394,188948,1140,1140,0,,,19/1/2022 7:23
9/5/2021,Udon Thani,4,397,1567699,776819,790880,11676,11669,7,,,19/1/2022 7:23
9/5/2021,Uttaradit,1,79,447682,218270,229412,8216,8216,0,,,19/1/2022 7:23
9/5/2021,Uthai Thani,0,21,325555,159138,166417,2668,2668,0,,,19/1/2022 7:23
9/5/2021,Ubon Ratchathani,13,321,1867034,932378,934656,17785,17785,0,86,37,19/1/2022 7:23
9/5/2021,Ang Thong,6,257,275934,132137,143797,2679,2679,0,,,19/1/2022 7:23
9/5/2021,Chiang Rai,5,544,1296741,630516,666225,33777,33431,346,39,22,19/1/2022 7:23
9/5/2021,Chiang Mai,26,3924,1785286,862939,922347,97868,95795,2073,66,32,19/1/2022 7:23
9/5/2021,Phetchaburi,10,605,482261,232800,249461,48502,48311,191,,,19/1/2022 7:23
9/5/2021,Phetchabun,1,87,980259,483622,496637,30774,30774,0,,,19/1/2022 7:23
9/5/2021,Loei,8,89,638528,320030,318498,6303,6296,7,54,26,19/1/2022 7:23
9/5/2021,Phrae,1,76,436092,210253,225839,7717,7717,0,58,25,19/1/2022 7:23
9/5/2021,Mae Hong Son,0,45,285641,144762,140879,13138,12870,268,65,21,19/1/2022 7:23
9/5/2021,,0,153,,,,,,,,,19/1/2022 7:23
10/5/2021,Krabi,8,257,478425,237576,240849,2222,2082,140,,,19/1/2022 7:23
10/5/2021,Bangkok,569,24550,5565337,2611984,2953353,353401,323907,29494,67,30,19/1/2022 7:23
10/5/2021,Kanchanaburi,23,252,892304,447427,444877,38060,37817,243,32,15,19/1/2022 7:23
10/5/2021,Kalasin,1,90,977098,483228,493870,2258,2258,0,,,19/1/2022 7:23
10/5/2021,Kamphaeng Phet,0,116,713612,352508,361104,8775,8775,0,,,19/1/2022 7:23
10/5/2021,Khon Kaen,3,450,1793078,881616,911462,46729,46690,39,90,47,19/1/2022 7:23
10/5/2021,Chanthaburi,36,665,535709,261994,273715,22331,22275,56,,,19/1/2022 7:23
10/5/2021,Chachoengsao,2,495,721880,353941,367939,5688,5688,0,78,39,19/1/2022 7:23
10/5/2021,Chon Buri,67,4921,1572844,766647,806197,29860,29153,707,59,36,19/1/2022 7:23
10/5/2021,Chai Nat,0,87,321640,154663,166977,5843,5843,0,,,19/1/2022 7:23
10/5/2021,Chaiyaphum,31,200,1124135,555470,568665,7737,7725,12,,,19/1/2022 7:23
10/5/2021,Chumphon,1,102,509660,251522,258138,1501,1501,0,,,19/1/2022 7:23
10/5/2021,Trang,8,269,640335,313195,327140,1786,1786,0,,,19/1/2022 7:23
10/5/2021,Trat,1,150,228577,113056,115521,25099,24970,129,,,19/1/2022 7:23
10/5/2021,Tak,1,439,673504,340558,332946,19138,19115,23,,,19/1/2022 7:23
10/5/2021,Nakhon Nayok,5,162,259663,128076,131587,7533,7533,0,,,19/1/2022 7:23
10/5/2021,Nakhon Pathom,11,999,922477,443242,479235,13279,13263,16,43,22,19/1/2022 7:23
10/5/2021,Nakhon Phanom,0,126,717008,357388,359620,4972,4963,9,,,19/1/2022 7:23
10/5/2021,Nakhon Ratchasima,10,719,2633898,1294636,1339262,95155,94599,556,66,29,19/1/2022 7:23
10/5/2021,Nakhon Si Thammarat,39,618,1550685,765026,785659,7956,7956,0,,,19/1/2022 7:23
10/5/2021,Nakhon Sawan,4,433,1038321,506625,531696,21893,21893,0,72,25,19/1/2022 7:23
10/5/2021,Nonthaburi,158,3980,1282168,596750,685418,3634,3613,21,52,17,19/1/2022 7:23
10/5/2021,Narathiwat,32,639,807640,399607,408033,1063,1063,0,37,15,19/1/2022 7:23
10/5/2021,Nan,0,111,476276,238368,237908,6955,6876,79,,,19/1/2022 7:23
10/5/2021,Bueng Kan,1,23,422395,211815,210580,2107,2107,0,,,19/1/2022 7:23
10/5/2021,Buri Ram,6,158,1580600,784622,795978,19949,19899,50,,,19/1/2022 7:23
10/5/2021,Pathum Thani,65,2106,1181742,559988,621754,2265,2237,28,66,26,19/1/2022 7:23
10/5/2021,Prachuap Khiri Khan,10,1329,550568,272298,278270,51821,51734,87,,,19/1/2022 7:23
10/5/2021,Prachin Buri,1,311,494216,244010,250206,5966,5966,0,84,31,19/1/2022 7:23
10/5/2021,Pattani,3,303,727981,359468,368513,1288,1288,0,,,19/1/2022 7:23
10/5/2021,Phra Nakhon Si Ayutthaya,27,749,819893,393933,425960,61595,61233,362,63,45,19/1/2022 7:23
10/5/2021,Phayao,1,92,466006,226859,239147,11143,11122,21,50,23,19/1/2022 7:23
10/5/2021,Phang-nga,3,51,268719,134080,134639,8721,8100,621,,,19/1/2022 7:23
10/5/2021,Phatthalung,7,377,523135,254907,268228,1911,1911,0,,,19/1/2022 7:23
10/5/2021,Phichit,2,102,531511,259350,272161,7231,7231,0,,,19/1/2022 7:23
10/5/2021,Phitsanulok,1,308,847403,414611,432792,30519,30433,86,,,19/1/2022 7:23
10/5/2021,Phuket,10,753,414526,195824,218702,5291,4766,525,58,26,19/1/2022 7:23
10/5/2021,Maha Sarakham,5,277,951267,466548,484719,4341,4341,0,,,19/1/2022 7:23
10/5/2021,Mukdahan,1,34,351099,175412,175687,6784,6784,0,,,19/1/2022 7:23
10/5/2021,Yala,2,278,540317,268883,271434,2178,2178,0,48,22,19/1/2022 7:23
10/5/2021,Yasothon,0,95,534080,266625,267455,952,952,0,,,19/1/2022 7:23
10/5/2021,Ranong,45,473,194750,98304,96446,1678,1678,0,,,19/1/2022 7:23
10/5/2021,Rayong,21,1277,746202,366668,379534,22710,22497,213,53,30,19/1/2022 7:23
10/5/2021,Ratchaburi,20,471,869157,422653,446504,7378,7378,0,,,19/1/2022 7:23
10/5/2021,Roi Et,4,197,1297760,643167,654593,6265,6265,0,,,19/1/2022 7:23
10/5/2021,Lop Buri,7,193,739849,368410,371439,10549,10510,39,,,19/1/2022 7:23
10/5/2021,Lampang,5,251,727262,354467,372795,9481,9078,403,51,25,19/1/2022 7:23
10/5/2021,Lamphun,1,297,401851,193249,208602,8607,8482,125,,,19/1/2022 7:23
10/5/2021,Si Sa Ket,1,243,1457888,725954,731934,3439,3439,0,,,19/1/2022 7:23
10/5/2021,Sakon Nakhon,1,84,1147056,570138,576918,3867,3867,0,,,19/1/2022 7:23
10/5/2021,Songkhla,20,1004,1429188,696564,732624,2754,2723,31,54,21,19/1/2022 7:23
10/5/2021,Satun,0,41,324400,161412,162988,5525,5489,36,49,17,19/1/2022 7:23
10/5/2021,Samut Prakarn,116,4068,1354816,645683,709133,3744,3666,78,,,19/1/2022 7:23
10/5/2021,Samut Songkhram,6,154,191777,91661,100116,13850,13794,56,42,16,19/1/2022 7:23
10/5/2021,Samut Sakhon,85,18680,586821,282842,303979,1725,1725,0,80,37,19/1/2022 7:23
10/5/2021,Saraburi,1,250,643778,316334,327444,17834,17781,53,85,65,19/1/2022 7:23
10/5/2021,Sa kaeo,18,443,561072,279991,281081,3712,3712,0,45,14,19/1/2022 7:23
10/5/2021,Sing Buri,0,81,205391,97605,107786,3742,3742,0,,,19/1/2022 7:23
10/5/2021,Suphan Buri,6,372,837411,404175,433236,12597,12597,0,,,19/1/2022 7:23
10/5/2021,Surat Thani,41,1191,1068431,526206,542225,3429,3408,21,71,39,19/1/2022 7:23
10/5/2021,Surin,4,131,1377702,685565,692137,8806,8806,0,,,19/1/2022 7:23
10/5/2021,Sukhothai,0,104,586803,284381,302422,4869,4747,122,,,19/1/2022 7:23
10/5/2021,Nong Khai,0,74,517275,256665,260610,13264,13246,18,19,9,19/1/2022 7:23
10/5/2021,Nong Bua Lam Phu,2,34,509382,254164,255218,2186,2186,0,,,19/1/2022 7:23
10/5/2021,Amnat Charoen,1,48,376342,187394,188948,1140,1140,0,,,19/1/2022 7:23
10/5/2021,Udon Thani,1,398,1567699,776819,790880,11676,11669,7,,,19/1/2022 7:23
10/5/2021,Uttaradit,0,79,447682,218270,229412,8216,8216,0,,,19/1/2022 7:23
10/5/2021,Uthai Thani,0,21,325555,159138,166417,2668,2668,0,,,19/1/2022 7:23
10/5/2021,Ubon Ratchathani,2,323,1867034,932378,934656,17785,17785,0,82,46,19/1/2022 7:23
10/5/2021,Ang Thong,6,263,275934,132137,143797,2679,2679,0,,,19/1/2022 7:23
10/5/2021,Chiang Rai,11,555,1296741,630516,666225,33777,33431,346,61,19,19/1/2022 7:23
10/5/2021,Chiang Mai,25,3949,1785286,862939,922347,97868,95795,2073,73,29,19/1/2022 7:23
10/5/2021,Phetchaburi,20,625,482261,232800,249461,48502,48311,191,,,19/1/2022 7:23
10/5/2021,Phetchabun,5,92,980259,483622,496637,30774,30774,0,,,19/1/2022 7:23
10/5/2021,Loei,0,89,638528,320030,318498,6303,6296,7,41,24,19/1/2022 7:23
10/5/2021,Phrae,0,76,436092,210253,225839,7717,7717,0,63,25,19/1/2022 7:23
10/5/2021,Mae Hong Son,0,45,285641,144762,140879,13138,12870,268,72,15,19/1/2022 7:23
10/5/2021,,0,153,,,,,,,,,19/1/2022 7:23
11/5/2021,Krabi,7,264,478425,237576,240849,2222,2082,140,,,19/1/2022 7:23
11/5/2021,Bangkok,862,25412,5565337,2611984,2953353,353401,323907,29494,62,26,19/1/2022 7:23
11/5/2021,Kanchanaburi,6,258,892304,447427,444877,38060,37817,243,41,15,19/1/2022 7:23
11/5/2021,Kalasin,2,92,977098,483228,493870,2258,2258,0,,,19/1/2022 7:23
11/5/2021,Kamphaeng Phet,1,117,713612,352508,361104,8775,8775,0,,,19/1/2022 7:23
11/5/2021,Khon Kaen,1,451,1793078,881616,911462,46729,46690,39,84,46,19/1/2022 7:23
11/5/2021,Chanthaburi,89,754,535709,261994,273715,22331,22275,56,,,19/1/2022 7:23
11/5/2021,Chachoengsao,21,516,721880,353941,367939,5688,5688,0,66,35,19/1/2022 7:23
11/5/2021,Chon Buri,73,4994,1572844,766647,806197,29860,29153,707,58,33,19/1/2022 7:23
11/5/2021,Chai Nat,0,87,321640,154663,166977,5843,5843,0,,,19/1/2022 7:23
11/5/2021,Chaiyaphum,23,223,1124135,555470,568665,7737,7725,12,,,19/1/2022 7:23
11/5/2021,Chumphon,4,106,509660,251522,258138,1501,1501,0,,,19/1/2022 7:23
11/5/2021,Trang,8,277,640335,313195,327140,1786,1786,0,,,19/1/2022 7:23
11/5/2021,Trat,0,150,228577,113056,115521,25099,24970,129,,,19/1/2022 7:23
11/5/2021,Tak,2,441,673504,340558,332946,19138,19115,23,,,19/1/2022 7:23
11/5/2021,Nakhon Nayok,8,170,259663,128076,131587,7533,7533,0,,,19/1/2022 7:23
11/5/2021,Nakhon Pathom,20,1019,922477,443242,479235,13279,13263,16,45,23,19/1/2022 7:23
11/5/2021,Nakhon Phanom,0,126,717008,357388,359620,4972,4963,9,,,19/1/2022 7:23
11/5/2021,Nakhon Ratchasima,38,757,2633898,1294636,1339262,95155,94599,556,66,29,19/1/2022 7:23
11/5/2021,Nakhon Si Thammarat,16,634,1550685,765026,785659,7956,7956,0,,,19/1/2022 7:23
11/5/2021,Nakhon Sawan,5,438,1038321,506625,531696,21893,21893,0,65,29,19/1/2022 7:23
11/5/2021,Nonthaburi,141,4121,1282168,596750,685418,3634,3613,21,46,15,19/1/2022 7:23
11/5/2021,Narathiwat,3,642,807640,399607,408033,1063,1063,0,34,14,19/1/2022 7:23
11/5/2021,Nan,1,112,476276,238368,237908,6955,6876,79,,,19/1/2022 7:23
11/5/2021,Bueng Kan,0,23,422395,211815,210580,2107,2107,0,,,19/1/2022 7:23
11/5/2021,Buri Ram,5,163,1580600,784622,795978,19949,19899,50,,,19/1/2022 7:23
11/5/2021,Pathum Thani,160,2266,1181742,559988,621754,2265,2237,28,70,22,19/1/2022 7:23
11/5/2021,Prachuap Khiri Khan,18,1347,550568,272298,278270,51821,51734,87,,,19/1/2022 7:23
11/5/2021,Prachin Buri,4,315,494216,244010,250206,5966,5966,0,66,33,19/1/2022 7:23
11/5/2021,Pattani,7,310,727981,359468,368513,1288,1288,0,,,19/1/2022 7:23
11/5/2021,Phra Nakhon Si Ayutthaya,25,774,819893,393933,425960,61595,61233,362,55,47,19/1/2022 7:23
11/5/2021,Phayao,2,94,466006,226859,239147,11143,11122,21,50,24,19/1/2022 7:23
11/5/2021,Phang-nga,9,60,268719,134080,134639,8721,8100,621,,,19/1/2022 7:23
11/5/2021,Phatthalung,0,377,523135,254907,268228,1911,1911,0,,,19/1/2022 7:23
11/5/2021,Phichit,5,107,531511,259350,272161,7231,7231,0,,,19/1/2022 7:23
11/5/2021,Phitsanulok,1,309,847403,414611,432792,30519,30433,86,,,19/1/2022 7:23
11/5/2021,Phuket,8,761,414526,195824,218702,5291,4766,525,56,20,19/1/2022 7:23
11/5/2021,Maha Sarakham,1,278,951267,466548,484719,4341,4341,0,,,19/1/2022 7:23
11/5/2021,Mukdahan,2,36,351099,175412,175687,6784,6784,0,,,19/1/2022 7:23
11/5/2021,Yala,7,285,540317,268883,271434,2178,2178,0,49,16,19/1/2022 7:23
11/5/2021,Yasothon,3,98,534080,266625,267455,952,952,0,,,19/1/2022 7:23
11/5/2021,Ranong,44,517,194750,98304,96446,1678,1678,0,,,19/1/2022 7:23
11/5/2021,Rayong,8,1285,746202,366668,379534,22710,22497,213,48,28,19/1/2022 7:23
11/5/2021,Ratchaburi,15,486,869157,422653,446504,7378,7378,0,,,19/1/2022 7:23
11/5/2021,Roi Et,3,200,1297760,643167,654593,6265,6265,0,,,19/1/2022 7:23
11/5/2021,Lop Buri,4,197,739849,368410,371439,10549,10510,39,,,19/1/2022 7:23
11/5/2021,Lampang,1,252,727262,354467,372795,9481,9078,403,51,24,19/1/2022 7:23
11/5/2021,Lamphun,0,297,401851,193249,208602,8607,8482,125,,,19/1/2022 7:23
11/5/2021,Si Sa Ket,0,243,1457888,725954,731934,3439,3439,0,,,19/1/2022 7:23
11/5/2021,Sakon Nakhon,0,84,1147056,570138,576918,3867,3867,0,,,19/1/2022 7:23
11/5/2021,Songkhla,11,1015,1429188,696564,732624,2754,2723,31,42,34,19/1/2022 7:23
11/5/2021,Satun,0,41,324400,161412,162988,5525,5489,36,36,16,19/1/2022 7:23
11/5/2021,Samut Prakarn,77,4145,1354816,645683,709133,3744,3666,78,,,19/1/2022 7:23
11/5/2021,Samut Songkhram,5,159,191777,91661,100116,13850,13794,56,40,14,19/1/2022 7:23
11/5/2021,Samut Sakhon,35,18715,586821,282842,303979,1725,1725,0,70,34,19/1/2022 7:23
11/5/2021,Saraburi,6,256,643778,316334,327444,17834,17781,53,79,59,19/1/2022 7:23
11/5/2021,Sa kaeo,12,455,561072,279991,281081,3712,3712,0,27,14,19/1/2022 7:23
11/5/2021,Sing Buri,1,82,205391,97605,107786,3742,3742,0,,,19/1/2022 7:23
11/5/2021,Suphan Buri,2,374,837411,404175,433236,12597,12597,0,,,19/1/2022 7:23
11/5/2021,Surat Thani,42,1233,1068431,526206,542225,3429,3408,21,75,37,19/1/2022 7:23
11/5/2021,Surin,1,132,1377702,685565,692137,8806,8806,0,,,19/1/2022 7:23
11/5/2021,Sukhothai,3,107,586803,284381,302422,4869,4747,122,,,19/1/2022 7:23
11/5/2021,Nong Khai,0,74,517275,256665,260610,13264,13246,18,23,7,19/1/2022 7:23
11/5/2021,Nong Bua Lam Phu,0,34,509382,254164,255218,2186,2186,0,,,19/1/2022 7:23
11/5/2021,Amnat Charoen,0,48,376342,187394,188948,1140,1140,0,,,19/1/2022 7:23
11/5/2021,Udon Thani,7,405,1567699,776819,790880,11676,11669,7,,,19/1/2022 7:23
11/5/2021,Uttaradit,0,79,447682,218270,229412,8216,8216,0,,,19/1/2022 7:23
11/5/2021,Uthai Thani,0,21,325555,159138,166417,2668,2668,0,,,19/1/2022 7:23
11/5/2021,Ubon Ratchathani,6,329,1867034,932378,934656,17785,17785,0,100,26,19/1/2022 7:23
11/5/2021,Ang Thong,4,267,275934,132137,143797,2679,2679,0,,,19/1/2022 7:23
11/5/2021,Chiang Rai,9,564,1296741,630516,666225,33777,33431,346,51,19,19/1/2022 7:23
11/5/2021,Chiang Mai,22,3971,1785286,862939,922347,97868,95795,2073,61,28,19/1/2022 7:23
11/5/2021,Phetchaburi,5,630,482261,232800,249461,48502,48311,191,,,19/1/2022 7:23
11/5/2021,Phetchabun,8,100,980259,483622,496637,30774,30774,0,,,19/1/2022 7:23
11/5/2021,Loei,0,89,638528,320030,318498,6303,6296,7,46,26,19/1/2022 7:23
11/5/2021,Phrae,0,76,436092,210253,225839,7717,7717,0,62,26,19/1/2022 7:23
11/5/2021,Mae Hong Son,0,45,285641,144762,140879,13138,12870,268,57,14,19/1/2022 7:23
11/5/2021,,0,153,,,,,,,,,19/1/2022 7:23
12/5/2021,Krabi,1,265,478425,237576,240849,2222,2082,140,,,19/1/2022 7:23
12/5/2021,Bangkok,980,26392,5565337,2611984,2953353,353401,323907,29494,59,27,19/1/2022 7:23
12/5/2021,Kanchanaburi,8,266,892304,447427,444877,38060,37817,243,38,16,19/1/2022 7:23
12/5/2021,Kalasin,4,96,977098,483228,493870,2258,2258,0,,,19/1/2022 7:23
12/5/2021,Kamphaeng Phet,1,118,713612,352508,361104,8775,8775,0,,,19/1/2022 7:23
12/5/2021,Khon Kaen,1,452,1793078,881616,911462,46729,46690,39,80,48,19/1/2022 7:23
12/5/2021,Chanthaburi,32,786,535709,261994,273715,22331,22275,56,,,19/1/2022 7:23
12/5/2021,Chachoengsao,9,525,721880,353941,367939,5688,5688,0,83,40,19/1/2022 7:23
12/5/2021,Chon Buri,58,5052,1572844,766647,806197,29860,29153,707,53,25,19/1/2022 7:23
12/5/2021,Chai Nat,0,87,321640,154663,166977,5843,5843,0,,,19/1/2022 7:23
12/5/2021,Chaiyaphum,10,233,1124135,555470,568665,7737,7725,12,,,19/1/2022 7:23
12/5/2021,Chumphon,5,111,509660,251522,258138,1501,1501,0,,,19/1/2022 7:23
12/5/2021,Trang,1,278,640335,313195,327140,1786,1786,0,,,19/1/2022 7:23
12/5/2021,Trat,2,152,228577,113056,115521,25099,24970,129,,,19/1/2022 7:23
12/5/2021,Tak,1,442,673504,340558,332946,19138,19115,23,,,19/1/2022 7:23
12/5/2021,Nakhon Nayok,7,177,259663,128076,131587,7533,7533,0,,,19/1/2022 7:23
12/5/2021,Nakhon Pathom,7,1026,922477,443242,479235,13279,13263,16,41,20,19/1/2022 7:23
12/5/2021,Nakhon Phanom,0,126,717008,357388,359620,4972,4963,9,,,19/1/2022 7:23
12/5/2021,Nakhon Ratchasima,11,768,2633898,1294636,1339262,95155,94599,556,63,33,19/1/2022 7:23
12/5/2021,Nakhon Si Thammarat,17,651,1550685,765026,785659,7956,7956,0,,,19/1/2022 7:23
12/5/2021,Nakhon Sawan,2,440,1038321,506625,531696,21893,21893,0,74,32,19/1/2022 7:23
12/5/2021,Nonthaburi,266,4387,1282168,596750,685418,3634,3613,21,39,18,19/1/2022 7:23
12/5/2021,Narathiwat,25,667,807640,399607,408033,1063,1063,0,28,13,19/1/2022 7:23
12/5/2021,Nan,0,112,476276,238368,237908,6955,6876,79,,,19/1/2022 7:23
12/5/2021,Bueng Kan,0,23,422395,211815,210580,2107,2107,0,,,19/1/2022 7:23
12/5/2021,Buri Ram,6,169,1580600,784622,795978,19949,19899,50,,,19/1/2022 7:23
12/5/2021,Pathum Thani,29,2295,1181742,559988,621754,2265,2237,28,60,20,19/1/2022 7:23
12/5/2021,Prachuap Khiri Khan,15,1362,550568,272298,278270,51821,51734,87,,,19/1/2022 7:23
12/5/2021,Prachin Buri,1,316,494216,244010,250206,5966,5966,0,69,33,19/1/2022 7:23
12/5/2021,Pattani,28,338,727981,359468,368513,1288,1288,0,,,19/1/2022 7:23
12/5/2021,Phra Nakhon Si Ayutthaya,38,812,819893,393933,425960,61595,61233,362,53,41,19/1/2022 7:23
12/5/2021,Phayao,0,94,466006,226859,239147,11143,11122,21,52,24,19/1/2022 7:23
12/5/2021,Phang-nga,3,63,268719,134080,134639,8721,8100,621,,,19/1/2022 7:23
12/5/2021,Phatthalung,6,383,523135,254907,268228,1911,1911,0,,,19/1/2022 7:23
12/5/2021,Phichit,2,109,531511,259350,272161,7231,7231,0,,,19/1/2022 7:23
12/5/2021,Phitsanulok,1,310,847403,414611,432792,30519,30433,86,,,19/1/2022 7:23
12/5/2021,Phuket,18,779,414526,195824,218702,5291,4766,525,50,21,19/1/2022 7:23
12/5/2021,Maha Sarakham,6,284,951267,466548,484719,4341,4341,0,,,19/1/2022 7:23
12/5/2021,Mukdahan,0,36,351099,175412,175687,6784,6784,0,,,19/1/2022 7:23
12/5/2021,Yala,17,302,540317,268883,271434,2178,2178,0,40,17,19/1/2022 7:23
12/5/2021,Yasothon,0,98,534080,266625,267455,952,952,0,,,19/1/2022 7:23
12/5/2021,Ranong,25,542,194750,98304,96446,1678,1678,0,,,19/1/2022 7:23
12/5/2021,Rayong,16,1301,746202,366668,379534,22710,22497,213,43,29,19/1/2022 7:23
12/5/2021,Ratchaburi,19,505,869157,422653,446504,7378,7378,0,,,19/1/2022 7:23
12/5/2021,Roi Et,1,201,1297760,643167,654593,6265,6265,0,,,19/1/2022 7:23
12/5/2021,Lop Buri,3,200,739849,368410,371439,10549,10510,39,,,19/1/2022 7:23
12/5/2021,Lampang,0,252,727262,354467,372795,9481,9078,403,44,26,19/1/2022 7:23
12/5/2021,Lamphun,2,299,401851,193249,208602,8607,8482,125,,,19/1/2022 7:23
12/5/2021,Si Sa Ket,5,248,1457888,725954,731934,3439,3439,0,,,19/1/2022 7:23
12/5/2021,Sakon Nakhon,0,84,1147056,570138,576918,3867,3867,0,,,19/1/2022 7:23
12/5/2021,Songkhla,2,1017,1429188,696564,732624,2754,2723,31,64,33,19/1/2022 7:23
12/5/2021,Satun,0,41,324400,161412,162988,5525,5489,36,26,19,19/1/2022 7:23
12/5/2021,Samut Prakarn,110,4255,1354816,645683,709133,3744,3666,78,,,19/1/2022 7:23
12/5/2021,Samut Songkhram,4,163,191777,91661,100116,13850,13794,56,34,12,19/1/2022 7:23
12/5/2021,Samut Sakhon,36,18751,586821,282842,303979,1725,1725,0,64,36,19/1/2022 7:23
12/5/2021,Saraburi,18,274,643778,316334,327444,17834,17781,53,76,78,19/1/2022 7:23
12/5/2021,Sa kaeo,9,464,561072,279991,281081,3712,3712,0,26,16,19/1/2022 7:23
12/5/2021,Sing Buri,0,82,205391,97605,107786,3742,3742,0,,,19/1/2022 7:23
12/5/2021,Suphan Buri,5,379,837411,404175,433236,12597,12597,0,,,19/1/2022 7:23
12/5/2021,Surat Thani,53,1286,1068431,526206,542225,3429,3408,21,80,34,19/1/2022 7:23
12/5/2021,Surin,0,132,1377702,685565,692137,8806,8806,0,,,19/1/2022 7:23
12/5/2021,Sukhothai,0,107,586803,284381,302422,4869,4747,122,,,19/1/2022 7:23
12/5/2021,Nong Khai,0,74,517275,256665,260610,13264,13246,18,16,8,19/1/2022 7:23
12/5/2021,Nong Bua Lam Phu,1,35,509382,254164,255218,2186,2186,0,,,19/1/2022 7:23
12/5/2021,Amnat Charoen,1,49,376342,187394,188948,1140,1140,0,,,19/1/2022 7:23
12/5/2021,Udon Thani,6,411,1567699,776819,790880,11676,11669,7,,,19/1/2022 7:23
12/5/2021,Uttaradit,0,79,447682,218270,229412,8216,8216,0,,,19/1/2022 7:23
12/5/2021,Uthai Thani,1,22,325555,159138,166417,2668,2668,0,,,19/1/2022 7:23
12/5/2021,Ubon Ratchathani,4,333,1867034,932378,934656,17785,17785,0,61,32,19/1/2022 7:23
12/5/2021,Ang Thong,4,271,275934,132137,143797,2679,2679,0,,,19/1/2022 7:23
12/5/2021,Chiang Rai,10,574,1296741,630516,666225,33777,33431,346,49,19,19/1/2022 7:23
12/5/2021,Chiang Mai,18,3989,1785286,862939,922347,97868,95795,2073,66,28,19/1/2022 7:23
12/5/2021,Phetchaburi,2,632,482261,232800,249461,48502,48311,191,,,19/1/2022 7:23
12/5/2021,Phetchabun,10,110,980259,483622,496637,30774,30774,0,,,19/1/2022 7:23
12/5/2021,Loei,0,89,638528,320030,318498,6303,6296,7,55,26,19/1/2022 7:23
12/5/2021,Phrae,0,76,436092,210253,225839,7717,7717,0,66,26,19/1/2022 7:23
12/5/2021,Mae Hong Son,0,45,285641,144762,140879,13138,12870,268,51,16,19/1/2022 7:23
12/5/2021,,0,153,,,,,,,,,19/1/2022 7:23
13/5/2021,Krabi,8,273,478425,237576,240849,2222,2082,140,,,19/1/2022 7:23
13/5/2021,Bangkok,3905,30297,5565337,2611984,2953353,353401,323907,29494,61,23,19/1/2022 7:23
13/5/2021,Kanchanaburi,1,267,892304,447427,444877,38060,37817,243,42,15,19/1/2022 7:23
13/5/2021,Kalasin,0,96,977098,483228,493870,2258,2258,0,,,19/1/2022 7:23
13/5/2021,Kamphaeng Phet,1,119,713612,352508,361104,8775,8775,0,,,19/1/2022 7:23
13/5/2021,Khon Kaen,6,458,1793078,881616,911462,46729,46690,39,86,52,19/1/2022 7:23
13/5/2021,Chanthaburi,14,800,535709,261994,273715,22331,22275,56,,,19/1/2022 7:23
13/5/2021,Chachoengsao,9,534,721880,353941,367939,5688,5688,0,76,32,19/1/2022 7:23
13/5/2021,Chon Buri,58,5110,1572844,766647,806197,29860,29153,707,43,28,19/1/2022 7:23
13/5/2021,Chai Nat,1,88,321640,154663,166977,5843,5843,0,,,19/1/2022 7:23
13/5/2021,Chaiyaphum,10,243,1124135,555470,568665,7737,7725,12,,,19/1/2022 7:23
13/5/2021,Chumphon,0,111,509660,251522,258138,1501,1501,0,,,19/1/2022 7:23
13/5/2021,Trang,5,283,640335,313195,327140,1786,1786,0,,,19/1/2022 7:23
13/5/2021,Trat,0,152,228577,113056,115521,25099,24970,129,,,19/1/2022 7:23
13/5/2021,Tak,1,443,673504,340558,332946,19138,19115,23,,,19/1/2022 7:23
13/5/2021,Nakhon Nayok,5,182,259663,128076,131587,7533,7533,0,,,19/1/2022 7:23
13/5/2021,Nakhon Pathom,21,1047,922477,443242,479235,13279,13263,16,32,25,19/1/2022 7:23
13/5/2021,Nakhon Phanom,2,128,717008,357388,359620,4972,4963,9,,,19/1/2022 7:23
13/5/2021,Nakhon Ratchasima,11,779,2633898,1294636,1339262,95155,94599,556,71,34,19/1/2022 7:23
13/5/2021,Nakhon Si Thammarat,20,671,1550685,765026,785659,7956,7956,0,,,19/1/2022 7:23
13/5/2021,Nakhon Sawan,2,442,1038321,506625,531696,21893,21893,0,79,36,19/1/2022 7:23
13/5/2021,Nonthaburi,78,4465,1282168,596750,685418,3634,3613,21,32,18,19/1/2022 7:23
13/5/2021,Narathiwat,3,670,807640,399607,408033,1063,1063,0,30,13,19/1/2022 7:23
13/5/2021,Nan,0,112,476276,238368,237908,6955,6876,79,,,19/1/2022 7:23
13/5/2021,Bueng Kan,1,24,422395,211815,210580,2107,2107,0,,,19/1/2022 7:23
13/5/2021,Buri Ram,3,172,1580600,784622,795978,19949,19899,50,,,19/1/2022 7:23
13/5/2021,Pathum Thani,105,2400,1181742,559988,621754,2265,2237,28,54,20,19/1/2022 7:23
13/5/2021,Prachuap Khiri Khan,41,1403,550568,272298,278270,51821,51734,87,,,19/1/2022 7:23
13/5/2021,Prachin Buri,6,322,494216,244010,250206,5966,5966,0,66,32,19/1/2022 7:23
13/5/2021,Pattani,11,349,727981,359468,368513,1288,1288,0,,,19/1/2022 7:23
13/5/2021,Phra Nakhon Si Ayutthaya,39,851,819893,393933,425960,61595,61233,362,49,42,19/1/2022 7:23
13/5/2021,Phayao,0,94,466006,226859,239147,11143,11122,21,44,24,19/1/2022 7:23
13/5/2021,Phang-nga,1,64,268719,134080,134639,8721,8100,621,,,19/1/2022 7:23
13/5/2021,Phatthalung,5,388,523135,254907,268228,1911,1911,0,,,19/1/2022 7:23
13/5/2021,Phichit,2,111,531511,259350,272161,7231,7231,0,,,19/1/2022 7:23
13/5/2021,Phitsanulok,2,312,847403,414611,432792,30519,30433,86,,,19/1/2022 7:23
13/5/2021,Phuket,19,798,414526,195824,218702,5291,4766,525,50,24,19/1/2022 7:23
13/5/2021,Maha Sarakham,3,287,951267,466548,484719,4341,4341,0,,,19/1/2022 7:23
13/5/2021,Mukdahan,0,36,351099,175412,175687,6784,6784,0,,,19/1/2022 7:23
13/5/2021,Yala,2,304,540317,268883,271434,2178,2178,0,39,22,19/1/2022 7:23
13/5/2021,Yasothon,2,100,534080,266625,267455,952,952,0,,,19/1/2022 7:23
13/5/2021,Ranong,8,550,194750,98304,96446,1678,1678,0,,,19/1/2022 7:23
13/5/2021,Rayong,30,1331,746202,366668,379534,22710,22497,213,32,23,19/1/2022 7:23
13/5/2021,Ratchaburi,16,521,869157,422653,446504,7378,7378,0,,,19/1/2022 7:23
13/5/2021,Roi Et,3,204,1297760,643167,654593,6265,6265,0,,,19/1/2022 7:23
13/5/2021,Lop Buri,0,200,739849,368410,371439,10549,10510,39,,,19/1/2022 7:23
13/5/2021,Lampang,3,255,727262,354467,372795,9481,9078,403,50,27,19/1/2022 7:23
13/5/2021,Lamphun,1,300,401851,193249,208602,8607,8482,125,,,19/1/2022 7:23
13/5/2021,Si Sa Ket,3,251,1457888,725954,731934,3439,3439,0,,,19/1/2022 7:23
13/5/2021,Sakon Nakhon,1,85,1147056,570138,576918,3867,3867,0,,,19/1/2022 7:23
13/5/2021,Songkhla,33,1050,1429188,696564,732624,2754,2723,31,65,31,19/1/2022 7:23
13/5/2021,Satun,1,42,324400,161412,162988,5525,5489,36,31,15,19/1/2022 7:23
13/5/2021,Samut Prakarn,194,4449,1354816,645683,709133,3744,3666,78,,,19/1/2022 7:23
13/5/2021,Samut Songkhram,4,167,191777,91661,100116,13850,13794,56,29,13,19/1/2022 7:23
13/5/2021,Samut Sakhon,57,18808,586821,282842,303979,1725,1725,0,67,38,19/1/2022 7:23
13/5/2021,Saraburi,5,279,643778,316334,327444,17834,17781,53,81,74,19/1/2022 7:23
13/5/2021,Sa kaeo,7,471,561072,279991,281081,3712,3712,0,31,14,19/1/2022 7:23
13/5/2021,Sing Buri,1,83,205391,97605,107786,3742,3742,0,,,19/1/2022 7:23
13/5/2021,Suphan Buri,5,384,837411,404175,433236,12597,12597,0,,,19/1/2022 7:23
13/5/2021,Surat Thani,73,1359,1068431,526206,542225,3429,3408,21,73,39,19/1/2022 7:23
13/5/2021,Surin,1,133,1377702,685565,692137,8806,8806,0,,,19/1/2022 7:23
13/5/2021,Sukhothai,1,108,586803,284381,302422,4869,4747,122,,,19/1/2022 7:23
13/5/2021,Nong Khai,0,74,517275,256665,260610,13264,13246,18,19,6,19/1/2022 7:23
13/5/2021,Nong Bua Lam Phu,0,35,509382,254164,255218,2186,2186,0,,,19/1/2022 7:23
13/5/2021,Amnat Charoen,0,49,376342,187394,188948,1140,1140,0,,,19/1/2022 7:23
13/5/2021,Udon Thani,2,413,1567699,776819,790880,11676,11669,7,,,19/1/2022 7:23
13/5/2021,Uttaradit,0,79,447682,218270,229412,8216,8216,0,,,19/1/2022 7:23
13/5/2021,Uthai Thani,1,23,325555,159138,166417,2668,2668,0,,,19/1/2022 7:23
13/5/2021,Ubon Ratchathani,1,334,1867034,932378,934656,17785,17785,0,68,46,19/1/2022 7:23
13/5/2021,Ang Thong,8,279,275934,132137,143797,2679,2679,0,,,19/1/2022 7:23
13/5/2021,Chiang Rai,8,582,1296741,630516,666225,33777,33431,346,49,20,19/1/2022 7:23
13/5/2021,Chiang Mai,10,3999,1785286,862939,922347,97868,95795,2073,62,32,19/1/2022 7:23
13/5/2021,Phetchaburi,2,634,482261,232800,249461,48502,48311,191,,,19/1/2022 7:23
13/5/2021,Phetchabun,2,112,980259,483622,496637,30774,30774,0,,,19/1/2022 7:23
13/5/2021,Loei,1,90,638528,320030,318498,6303,6296,7,53,26,19/1/2022 7:23
13/5/2021,Phrae,2,78,436092,210253,225839,7717,7717,0,62,24,19/1/2022 7:23
13/5/2021,Mae Hong Son,0,45,285641,144762,140879,13138,12870,268,60,22,19/1/2022 7:23
13/5/2021,,0,153,,,,,,,,,19/1/2022 7:23
14/5/2021,Krabi,4,277,478425,237576,240849,2222,2082,140,,,19/1/2022 7:23
14/5/2021,Bangkok,1271,31568,5565337,2611984,2953353,353401,323907,29494,50,25,19/1/2022 7:23
14/5/2021,Kanchanaburi,4,271,892304,447427,444877,38060,37817,243,37,15,19/1/2022 7:23
14/5/2021,Kalasin,0,96,977098,483228,493870,2258,2258,0,,,19/1/2022 7:23
14/5/2021,Kamphaeng Phet,1,120,713612,352508,361104,8775,8775,0,,,19/1/2022 7:23
14/5/2021,Khon Kaen,6,464,1793078,881616,911462,46729,46690,39,98,55,19/1/2022 7:23
14/5/2021,Chanthaburi,21,821,535709,261994,273715,22331,22275,56,,,19/1/2022 7:23
14/5/2021,Chachoengsao,8,542,721880,353941,367939,5688,5688,0,73,42,19/1/2022 7:23
14/5/2021,Chon Buri,65,5175,1572844,766647,806197,29860,29153,707,46,30,19/1/2022 7:23
14/5/2021,Chai Nat,0,88,321640,154663,166977,5843,5843,0,,,19/1/2022 7:23
14/5/2021,Chaiyaphum,5,248,1124135,555470,568665,7737,7725,12,,,19/1/2022 7:23
14/5/2021,Chumphon,3,114,509660,251522,258138,1501,1501,0,,,19/1/2022 7:23
14/5/2021,Trang,3,286,640335,313195,327140,1786,1786,0,,,19/1/2022 7:23
14/5/2021,Trat,0,152,228577,113056,115521,25099,24970,129,,,19/1/2022 7:23
14/5/2021,Tak,0,443,673504,340558,332946,19138,19115,23,,,19/1/2022 7:23
14/5/2021,Nakhon Nayok,3,185,259663,128076,131587,7533,7533,0,,,19/1/2022 7:23
14/5/2021,Nakhon Pathom,21,1068,922477,443242,479235,13279,13263,16,54,23,19/1/2022 7:23
14/5/2021,Nakhon Phanom,2,130,717008,357388,359620,4972,4963,9,,,19/1/2022 7:23
14/5/2021,Nakhon Ratchasima,11,790,2633898,1294636,1339262,95155,94599,556,68,33,19/1/2022 7:23
14/5/2021,Nakhon Si Thammarat,25,696,1550685,765026,785659,7956,7956,0,,,19/1/2022 7:23
14/5/2021,Nakhon Sawan,4,446,1038321,506625,531696,21893,21893,0,82,106,19/1/2022 7:23
14/5/2021,Nonthaburi,131,4596,1282168,596750,685418,3634,3613,21,43,20,19/1/2022 7:23
14/5/2021,Narathiwat,3,673,807640,399607,408033,1063,1063,0,32,14,19/1/2022 7:23
14/5/2021,Nan,0,112,476276,238368,237908,6955,6876,79,,,19/1/2022 7:23
14/5/2021,Bueng Kan,0,24,422395,211815,210580,2107,2107,0,,,19/1/2022 7:23
14/5/2021,Buri Ram,7,179,1580600,784622,795978,19949,19899,50,,,19/1/2022 7:23
14/5/2021,Pathum Thani,156,2556,1181742,559988,621754,2265,2237,28,59,30,19/1/2022 7:23
14/5/2021,Prachuap Khiri Khan,52,1455,550568,272298,278270,51821,51734,87,,,19/1/2022 7:23
14/5/2021,Prachin Buri,10,332,494216,244010,250206,5966,5966,0,67,28,19/1/2022 7:23
14/5/2021,Pattani,13,362,727981,359468,368513,1288,1288,0,,,19/1/2022 7:23
14/5/2021,Phra Nakhon Si Ayutthaya,29,880,819893,393933,425960,61595,61233,362,48,43,19/1/2022 7:23
14/5/2021,Phayao,0,94,466006,226859,239147,11143,11122,21,50,29,19/1/2022 7:23
14/5/2021,Phang-nga,1,65,268719,134080,134639,8721,8100,621,,,19/1/2022 7:23
14/5/2021,Phatthalung,6,394,523135,254907,268228,1911,1911,0,,,19/1/2022 7:23
14/5/2021,Phichit,5,116,531511,259350,272161,7231,7231,0,,,19/1/2022 7:23
14/5/2021,Phitsanulok,3,315,847403,414611,432792,30519,30433,86,,,19/1/2022 7:23
14/5/2021,Phuket,12,810,414526,195824,218702,5291,4766,525,66,23,19/1/2022 7:23
14/5/2021,Maha Sarakham,2,289,951267,466548,484719,4341,4341,0,,,19/1/2022 7:23
14/5/2021,Mukdahan,1,37,351099,175412,175687,6784,6784,0,,,19/1/2022 7:23
14/5/2021,Yala,6,310,540317,268883,271434,2178,2178,0,48,17,19/1/2022 7:23
14/5/2021,Yasothon,2,102,534080,266625,267455,952,952,0,,,19/1/2022 7:23
14/5/2021,Ranong,6,556,194750,98304,96446,1678,1678,0,,,19/1/2022 7:23
14/5/2021,Rayong,33,1364,746202,366668,379534,22710,22497,213,32,29,19/1/2022 7:23
14/5/2021,Ratchaburi,7,528,869157,422653,446504,7378,7378,0,,,19/1/2022 7:23
14/5/2021,Roi Et,12,216,1297760,643167,654593,6265,6265,0,,,19/1/2022 7:23
14/5/2021,Lop Buri,0,200,739849,368410,371439,10549,10510,39,,,19/1/2022 7:23
14/5/2021,Lampang,1,256,727262,354467,372795,9481,9078,403,50,31,19/1/2022 7:23
14/5/2021,Lamphun,0,300,401851,193249,208602,8607,8482,125,,,19/1/2022 7:23
14/5/2021,Si Sa Ket,5,256,1457888,725954,731934,3439,3439,0,,,19/1/2022 7:23
14/5/2021,Sakon Nakhon,3,88,1147056,570138,576918,3867,3867,0,,,19/1/2022 7:23
14/5/2021,Songkhla,19,1069,1429188,696564,732624,2754,2723,31,60,28,19/1/2022 7:23
14/5/2021,Satun,0,42,324400,161412,162988,5525,5489,36,29,13,19/1/2022 7:23
14/5/2021,Samut Prakarn,121,4570,1354816,645683,709133,3744,3666,78,,,19/1/2022 7:23
14/5/2021,Samut Songkhram,3,170,191777,91661,100116,13850,13794,56,34,16,19/1/2022 7:23
14/5/2021,Samut Sakhon,46,18854,586821,282842,303979,1725,1725,0,76,36,19/1/2022 7:23
14/5/2021,Saraburi,16,295,643778,316334,327444,17834,17781,53,78,61,19/1/2022 7:23
14/5/2021,Sa kaeo,4,475,561072,279991,281081,3712,3712,0,26,12,19/1/2022 7:23
14/5/2021,Sing Buri,3,86,205391,97605,107786,3742,3742,0,,,19/1/2022 7:23
14/5/2021,Suphan Buri,2,386,837411,404175,433236,12597,12597,0,,,19/1/2022 7:23
14/5/2021,Surat Thani,24,1383,1068431,526206,542225,3429,3408,21,81,43,19/1/2022 7:23
14/5/2021,Surin,0,133,1377702,685565,692137,8806,8806,0,,,19/1/2022 7:23
14/5/2021,Sukhothai,1,109,586803,284381,302422,4869,4747,122,,,19/1/2022 7:23
14/5/2021,Nong Khai,0,74,517275,256665,260610,13264,13246,18,16,6,19/1/2022 7:23
14/5/2021,Nong Bua Lam Phu,0,35,509382,254164,255218,2186,2186,0,,,19/1/2022 7:23
14/5/2021,Amnat Charoen,1,50,376342,187394,188948,1140,1140,0,,,19/1/2022 7:23
14/5/2021,Udon Thani,2,415,1567699,776819,790880,11676,11669,7,,,19/1/2022 7:23
14/5/2021,Uttaradit,1,80,447682,218270,229412,8216,8216,0,,,19/1/2022 7:23
14/5/2021,Uthai Thani,0,23,325555,159138,166417,2668,2668,0,,,19/1/2022 7:23
14/5/2021,Ubon Ratchathani,7,341,1867034,932378,934656,17785,17785,0,106,37,19/1/2022 7:23
14/5/2021,Ang Thong,6,285,275934,132137,143797,2679,2679,0,,,19/1/2022 7:23
14/5/2021,Chiang Rai,1,583,1296741,630516,666225,33777,33431,346,52,31,19/1/2022 7:23
14/5/2021,Chiang Mai,16,4015,1785286,862939,922347,97868,95795,2073,69,38,19/1/2022 7:23
14/5/2021,Phetchaburi,8,642,482261,232800,249461,48502,48311,191,,,19/1/2022 7:23
14/5/2021,Phetchabun,10,122,980259,483622,496637,30774,30774,0,,,19/1/2022 7:23
14/5/2021,Loei,0,90,638528,320030,318498,6303,6296,7,50,28,19/1/2022 7:23
14/5/2021,Phrae,2,80,436092,210253,225839,7717,7717,0,58,34,19/1/2022 7:23
14/5/2021,Mae Hong Son,0,45,285641,144762,140879,13138,12870,268,73,27,19/1/2022 7:23
14/5/2021,,0,153,,,,,,,,,19/1/2022 7:23
15/5/2021,Krabi,5,282,478425,237576,240849,2222,2082,140,,,19/1/2022 7:23
15/5/2021,Bangkok,2040,33608,5565337,2611984,2953353,353401,323907,29494,53,21,19/1/2022 7:23
15/5/2021,Kanchanaburi,7,278,892304,447427,444877,38060,37817,243,39,15,19/1/2022 7:23
15/5/2021,Kalasin,2,98,977098,483228,493870,2258,2258,0,,,19/1/2022 7:23
15/5/2021,Kamphaeng Phet,0,120,713612,352508,361104,8775,8775,0,,,19/1/2022 7:23
15/5/2021,Khon Kaen,7,471,1793078,881616,911462,46729,46690,39,105,41,19/1/2022 7:23
15/5/2021,Chanthaburi,14,835,535709,261994,273715,22331,22275,56,,,19/1/2022 7:23
15/5/2021,Chachoengsao,19,561,721880,353941,367939,5688,5688,0,57,35,19/1/2022 7:23
15/5/2021,Chon Buri,33,5208,1572844,766647,806197,29860,29153,707,50,23,19/1/2022 7:23
15/5/2021,Chai Nat,0,88,321640,154663,166977,5843,5843,0,,,19/1/2022 7:23
15/5/2021,Chaiyaphum,9,257,1124135,555470,568665,7737,7725,12,,,19/1/2022 7:23
15/5/2021,Chumphon,0,114,509660,251522,258138,1501,1501,0,,,19/1/2022 7:23
15/5/2021,Trang,2,288,640335,313195,327140,1786,1786,0,,,19/1/2022 7:23
15/5/2021,Trat,0,152,228577,113056,115521,25099,24970,129,,,19/1/2022 7:23
15/5/2021,Tak,0,443,673504,340558,332946,19138,19115,23,,,19/1/2022 7:23
15/5/2021,Nakhon Nayok,4,189,259663,128076,131587,7533,7533,0,,,19/1/2022 7:23
15/5/2021,Nakhon Pathom,30,1098,922477,443242,479235,13279,13263,16,42,17,19/1/2022 7:23
15/5/2021,Nakhon Phanom,5,135,717008,357388,359620,4972,4963,9,,,19/1/2022 7:23
15/5/2021,Nakhon Ratchasima,7,797,2633898,1294636,1339262,95155,94599,556,68,29,19/1/2022 7:23
15/5/2021,Nakhon Si Thammarat,24,720,1550685,765026,785659,7956,7956,0,,,19/1/2022 7:23
15/5/2021,Nakhon Sawan,1,447,1038321,506625,531696,21893,21893,0,116,106,19/1/2022 7:23
15/5/2021,Nonthaburi,126,4722,1282168,596750,685418,3634,3613,21,40,17,19/1/2022 7:23
15/5/2021,Narathiwat,6,679,807640,399607,408033,1063,1063,0,34,13,19/1/2022 7:23
15/5/2021,Nan,1,113,476276,238368,237908,6955,6876,79,,,19/1/2022 7:23
15/5/2021,Bueng Kan,0,24,422395,211815,210580,2107,2107,0,,,19/1/2022 7:23
15/5/2021,Buri Ram,2,181,1580600,784622,795978,19949,19899,50,,,19/1/2022 7:23
15/5/2021,Pathum Thani,222,2778,1181742,559988,621754,2265,2237,28,73,33,19/1/2022 7:23
15/5/2021,Prachuap Khiri Khan,13,1468,550568,272298,278270,51821,51734,87,,,19/1/2022 7:23
15/5/2021,Prachin Buri,5,337,494216,244010,250206,5966,5966,0,63,23,19/1/2022 7:23
15/5/2021,Pattani,3,365,727981,359468,368513,1288,1288,0,,,19/1/2022 7:23
15/5/2021,Phra Nakhon Si Ayutthaya,29,909,819893,393933,425960,61595,61233,362,54,44,19/1/2022 7:23
15/5/2021,Phayao,0,94,466006,226859,239147,11143,11122,21,62,33,19/1/2022 7:23
15/5/2021,Phang-nga,1,66,268719,134080,134639,8721,8100,621,,,19/1/2022 7:23
15/5/2021,Phatthalung,9,403,523135,254907,268228,1911,1911,0,,,19/1/2022 7:23
15/5/2021,Phichit,2,118,531511,259350,272161,7231,7231,0,,,19/1/2022 7:23
15/5/2021,Phitsanulok,2,317,847403,414611,432792,30519,30433,86,,,19/1/2022 7:23
15/5/2021,Phuket,11,821,414526,195824,218702,5291,4766,525,56,25,19/1/2022 7:23
15/5/2021,Maha Sarakham,0,289,951267,466548,484719,4341,4341,0,,,19/1/2022 7:23
15/5/2021,Mukdahan,0,37,351099,175412,175687,6784,6784,0,,,19/1/2022 7:23
15/5/2021,Yala,8,318,540317,268883,271434,2178,2178,0,44,18,19/1/2022 7:23
15/5/2021,Yasothon,2,104,534080,266625,267455,952,952,0,,,19/1/2022 7:23
15/5/2021,Ranong,13,569,194750,98304,96446,1678,1678,0,,,19/1/2022 7:23
15/5/2021,Rayong,15,1379,746202,366668,379534,22710,22497,213,35,27,19/1/2022 7:23
15/5/2021,Ratchaburi,18,546,869157,422653,446504,7378,7378,0,,,19/1/2022 7:23
15/5/2021,Roi Et,4,220,1297760,643167,654593,6265,6265,0,,,19/1/2022 7:23
15/5/2021,Lop Buri,14,214,739849,368410,371439,10549,10510,39,,,19/1/2022 7:23
15/5/2021,Lampang,1,257,727262,354467,372795,9481,9078,403,57,38,19/1/2022 7:23
15/5/2021,Lamphun,0,300,401851,193249,208602,8607,8482,125,,,19/1/2022 7:23
15/5/2021,Si Sa Ket,2,258,1457888,725954,731934,3439,3439,0,,,19/1/2022 7:23
15/5/2021,Sakon Nakhon,7,95,1147056,570138,576918,3867,3867,0,,,19/1/2022 7:23
15/5/2021,Songkhla,23,1092,1429188,696564,732624,2754,2723,31,55,32,19/1/2022 7:23
15/5/2021,Satun,0,42,324400,161412,162988,5525,5489,36,30,17,19/1/2022 7:23
15/5/2021,Samut Prakarn,201,4771,1354816,645683,709133,3744,3666,78,,,19/1/2022 7:23
15/5/2021,Samut Songkhram,4,174,191777,91661,100116,13850,13794,56,41,13,19/1/2022 7:23
15/5/2021,Samut Sakhon,37,18891,586821,282842,303979,1725,1725,0,74,26,19/1/2022 7:23
15/5/2021,Saraburi,7,302,643778,316334,327444,17834,17781,53,67,64,19/1/2022 7:23
15/5/2021,Sa kaeo,9,484,561072,279991,281081,3712,3712,0,25,10,19/1/2022 7:23
15/5/2021,Sing Buri,3,89,205391,97605,107786,3742,3742,0,,,19/1/2022 7:23
15/5/2021,Suphan Buri,4,390,837411,404175,433236,12597,12597,0,,,19/1/2022 7:23
15/5/2021,Surat Thani,34,1417,1068431,526206,542225,3429,3408,21,88,43,19/1/2022 7:23
15/5/2021,Surin,0,133,1377702,685565,692137,8806,8806,0,,,19/1/2022 7:23
15/5/2021,Sukhothai,1,110,586803,284381,302422,4869,4747,122,,,19/1/2022 7:23
15/5/2021,Nong Khai,1,75,517275,256665,260610,13264,13246,18,18,8,19/1/2022 7:23
15/5/2021,Nong Bua Lam Phu,0,35,509382,254164,255218,2186,2186,0,,,19/1/2022 7:23
15/5/2021,Amnat Charoen,1,51,376342,187394,188948,1140,1140,0,,,19/1/2022 7:23
15/5/2021,Udon Thani,3,418,1567699,776819,790880,11676,11669,7,,,19/1/2022 7:23
15/5/2021,Uttaradit,4,84,447682,218270,229412,8216,8216,0,,,19/1/2022 7:23
15/5/2021,Uthai Thani,0,23,325555,159138,166417,2668,2668,0,,,19/1/2022 7:23
15/5/2021,Ubon Ratchathani,7,348,1867034,932378,934656,17785,17785,0,84,33,19/1/2022 7:23
15/5/2021,Ang Thong,8,293,275934,132137,143797,2679,2679,0,,,19/1/2022 7:23
15/5/2021,Chiang Rai,1,584,1296741,630516,666225,33777,33431,346,74,28,19/1/2022 7:23
15/5/2021,Chiang Mai,10,4025,1785286,862939,922347,97868,95795,2073,84,40,19/1/2022 7:23
15/5/2021,Phetchaburi,7,649,482261,232800,249461,48502,48311,191,,,19/1/2022 7:23
15/5/2021,Phetchabun,3,125,980259,483622,496637,30774,30774,0,,,19/1/2022 7:23
15/5/2021,Loei,0,90,638528,320030,318498,6303,6296,7,40,31,19/1/2022 7:23
15/5/2021,Phrae,2,82,436092,210253,225839,7717,7717,0,80,39,19/1/2022 7:23
15/5/2021,Mae Hong Son,0,45,285641,144762,140879,13138,12870,268,83,31,19/1/2022 7:23
15/5/2021,,0,153,,,,,,,,,19/1/2022 7:23
16/5/2021,Krabi,6,288,478425,237576,240849,2222,2082,140,,,19/1/2022 7:23
16/5/2021,Bangkok,1221,34829,5565337,2611984,2953353,353401,323907,29494,46,24,19/1/2022 7:23
16/5/2021,Kanchanaburi,3,281,892304,447427,444877,38060,37817,243,40,15,19/1/2022 7:23
16/5/2021,Kalasin,0,98,977098,483228,493870,2258,2258,0,,,19/1/2022 7:23
16/5/2021,Kamphaeng Phet,1,121,713612,352508,361104,8775,8775,0,,,19/1/2022 7:23
16/5/2021,Khon Kaen,15,486,1793078,881616,911462,46729,46690,39,77,43,19/1/2022 7:23
16/5/2021,Chanthaburi,6,841,535709,261994,273715,22331,22275,56,,,19/1/2022 7:23
16/5/2021,Chachoengsao,12,573,721880,353941,367939,5688,5688,0,56,40,19/1/2022 7:23
16/5/2021,Chon Buri,51,5259,1572844,766647,806197,29860,29153,707,47,26,19/1/2022 7:23
16/5/2021,Chai Nat,0,88,321640,154663,166977,5843,5843,0,,,19/1/2022 7:23
16/5/2021,Chaiyaphum,6,263,1124135,555470,568665,7737,7725,12,,,19/1/2022 7:23
16/5/2021,Chumphon,0,114,509660,251522,258138,1501,1501,0,,,19/1/2022 7:23
16/5/2021,Trang,1,289,640335,313195,327140,1786,1786,0,,,19/1/2022 7:23
16/5/2021,Trat,0,152,228577,113056,115521,25099,24970,129,,,19/1/2022 7:23
16/5/2021,Tak,1,444,673504,340558,332946,19138,19115,23,,,19/1/2022 7:23
16/5/2021,Nakhon Nayok,4,193,259663,128076,131587,7533,7533,0,,,19/1/2022 7:23
16/5/2021,Nakhon Pathom,16,1114,922477,443242,479235,13279,13263,16,39,19,19/1/2022 7:23
16/5/2021,Nakhon Phanom,0,135,717008,357388,359620,4972,4963,9,,,19/1/2022 7:23
16/5/2021,Nakhon Ratchasima,7,804,2633898,1294636,1339262,95155,94599,556,68,29,19/1/2022 7:23
16/5/2021,Nakhon Si Thammarat,12,732,1550685,765026,785659,7956,7956,0,,,19/1/2022 7:23
16/5/2021,Nakhon Sawan,1,448,1038321,506625,531696,21893,21893,0,73,117,19/1/2022 7:23
16/5/2021,Nonthaburi,103,4825,1282168,596750,685418,3634,3613,21,37,18,19/1/2022 7:23
16/5/2021,Narathiwat,7,686,807640,399607,408033,1063,1063,0,33,15,19/1/2022 7:23
16/5/2021,Nan,0,113,476276,238368,237908,6955,6876,79,,,19/1/2022 7:23
16/5/2021,Bueng Kan,0,24,422395,211815,210580,2107,2107,0,,,19/1/2022 7:23
16/5/2021,Buri Ram,6,187,1580600,784622,795978,19949,19899,50,,,19/1/2022 7:23
16/5/2021,Pathum Thani,243,3021,1181742,559988,621754,2265,2237,28,91,15,19/1/2022 7:23
16/5/2021,Prachuap Khiri Khan,66,1534,550568,272298,278270,51821,51734,87,,,19/1/2022 7:23
16/5/2021,Prachin Buri,6,343,494216,244010,250206,5966,5966,0,57,32,19/1/2022 7:23
16/5/2021,Pattani,2,367,727981,359468,368513,1288,1288,0,,,19/1/2022 7:23
16/5/2021,Phra Nakhon Si Ayutthaya,37,946,819893,393933,425960,61595,61233,362,60,44,19/1/2022 7:23
16/5/2021,Phayao,1,95,466006,226859,239147,11143,11122,21,62,35,19/1/2022 7:23
16/5/2021,Phang-nga,1,67,268719,134080,134639,8721,8100,621,,,19/1/2022 7:23
16/5/2021,Phatthalung,4,407,523135,254907,268228,1911,1911,0,,,19/1/2022 7:23
16/5/2021,Phichit,9,127,531511,259350,272161,7231,7231,0,,,19/1/2022 7:23
16/5/2021,Phitsanulok,1,318,847403,414611,432792,30519,30433,86,,,19/1/2022 7:23
16/5/2021,Phuket,4,825,414526,195824,218702,5291,4766,525,60,23,19/1/2022 7:23
16/5/2021,Maha Sarakham,1,290,951267,466548,484719,4341,4341,0,,,19/1/2022 7:23
16/5/2021,Mukdahan,3,40,351099,175412,175687,6784,6784,0,,,19/1/2022 7:23
16/5/2021,Yala,8,326,540317,268883,271434,2178,2178,0,39,22,19/1/2022 7:23
16/5/2021,Yasothon,3,107,534080,266625,267455,952,952,0,,,19/1/2022 7:23
16/5/2021,Ranong,21,590,194750,98304,96446,1678,1678,0,,,19/1/2022 7:23
16/5/2021,Rayong,25,1404,746202,366668,379534,22710,22497,213,42,27,19/1/2022 7:23
16/5/2021,Ratchaburi,24,570,869157,422653,446504,7378,7378,0,,,19/1/2022 7:23
16/5/2021,Roi Et,7,227,1297760,643167,654593,6265,6265,0,,,19/1/2022 7:23
16/5/2021,Lop Buri,9,223,739849,368410,371439,10549,10510,39,,,19/1/2022 7:23
16/5/2021,Lampang,1,258,727262,354467,372795,9481,9078,403,66,40,19/1/2022 7:23
16/5/2021,Lamphun,0,300,401851,193249,208602,8607,8482,125,,,19/1/2022 7:23
16/5/2021,Si Sa Ket,20,278,1457888,725954,731934,3439,3439,0,,,19/1/2022 7:23
16/5/2021,Sakon Nakhon,2,97,1147056,570138,576918,3867,3867,0,,,19/1/2022 7:23
16/5/2021,Songkhla,37,1129,1429188,696564,732624,2754,2723,31,67,32,19/1/2022 7:23
16/5/2021,Satun,0,42,324400,161412,162988,5525,5489,36,29,13,19/1/2022 7:23
16/5/2021,Samut Prakarn,117,4888,1354816,645683,709133,3744,3666,78,,,19/1/2022 7:23
16/5/2021,Samut Songkhram,0,174,191777,91661,100116,13850,13794,56,29,12,19/1/2022 7:23
16/5/2021,Samut Sakhon,47,18938,586821,282842,303979,1725,1725,0,52,33,19/1/2022 7:23
16/5/2021,Saraburi,5,307,643778,316334,327444,17834,17781,53,78,74,19/1/2022 7:23
16/5/2021,Sa kaeo,35,519,561072,279991,281081,3712,3712,0,16,12,19/1/2022 7:23
16/5/2021,Sing Buri,3,92,205391,97605,107786,3742,3742,0,,,19/1/2022 7:23
16/5/2021,Suphan Buri,4,394,837411,404175,433236,12597,12597,0,,,19/1/2022 7:23
16/5/2021,Surat Thani,27,1444,1068431,526206,542225,3429,3408,21,91,37,19/1/2022 7:23
16/5/2021,Surin,1,134,1377702,685565,692137,8806,8806,0,,,19/1/2022 7:23
16/5/2021,Sukhothai,0,110,586803,284381,302422,4869,4747,122,,,19/1/2022 7:23
16/5/2021,Nong Khai,0,75,517275,256665,260610,13264,13246,18,19,8,19/1/2022 7:23
16/5/2021,Nong Bua Lam Phu,0,35,509382,254164,255218,2186,2186,0,,,19/1/2022 7:23
16/5/2021,Amnat Charoen,0,51,376342,187394,188948,1140,1140,0,,,19/1/2022 7:23
16/5/2021,Udon Thani,4,422,1567699,776819,790880,11676,11669,7,,,19/1/2022 7:23
16/5/2021,Uttaradit,0,84,447682,218270,229412,8216,8216,0,,,19/1/2022 7:23
16/5/2021,Uthai Thani,0,23,325555,159138,166417,2668,2668,0,,,19/1/2022 7:23
16/5/2021,Ubon Ratchathani,1,349,1867034,932378,934656,17785,17785,0,75,31,19/1/2022 7:23
16/5/2021,Ang Thong,0,293,275934,132137,143797,2679,2679,0,,,19/1/2022 7:23
16/5/2021,Chiang Rai,6,590,1296741,630516,666225,33777,33431,346,67,41,19/1/2022 7:23
16/5/2021,Chiang Mai,21,4046,1785286,862939,922347,97868,95795,2073,84,47,19/1/2022 7:23
16/5/2021,Phetchaburi,7,656,482261,232800,249461,48502,48311,191,,,19/1/2022 7:23
16/5/2021,Phetchabun,7,132,980259,483622,496637,30774,30774,0,,,19/1/2022 7:23
16/5/2021,Loei,2,92,638528,320030,318498,6303,6296,7,57,32,19/1/2022 7:23
16/5/2021,Phrae,1,83,436092,210253,225839,7717,7717,0,88,36,19/1/2022 7:23
16/5/2021,Mae Hong Son,0,45,285641,144762,140879,13138,12870,268,91,35,19/1/2022 7:23
16/5/2021,,0,153,,,,,,,,,19/1/2022 7:23
17/5/2021,Krabi,7,295,478425,237576,240849,2222,2082,140,,,19/1/2022 7:23
17/5/2021,Bangkok,4707,39536,5565337,2611984,2953353,353401,323907,29494,56,21,19/1/2022 7:23
17/5/2021,Kanchanaburi,5,286,892304,447427,444877,38060,37817,243,42,16,19/1/2022 7:23
17/5/2021,Kalasin,3,101,977098,483228,493870,2258,2258,0,,,19/1/2022 7:23
17/5/2021,Kamphaeng Phet,1,122,713612,352508,361104,8775,8775,0,,,19/1/2022 7:23
17/5/2021,Khon Kaen,4,490,1793078,881616,911462,46729,46690,39,77,58,19/1/2022 7:23
17/5/2021,Chanthaburi,14,855,535709,261994,273715,22331,22275,56,,,19/1/2022 7:23
17/5/2021,Chachoengsao,23,596,721880,353941,367939,5688,5688,0,54,41,19/1/2022 7:23
17/5/2021,Chon Buri,45,5304,1572844,766647,806197,29860,29153,707,45,27,19/1/2022 7:23
17/5/2021,Chai Nat,0,88,321640,154663,166977,5843,5843,0,,,19/1/2022 7:23
17/5/2021,Chaiyaphum,0,263,1124135,555470,568665,7737,7725,12,,,19/1/2022 7:23
17/5/2021,Chumphon,0,114,509660,251522,258138,1501,1501,0,,,19/1/2022 7:23
17/5/2021,Trang,1,290,640335,313195,327140,1786,1786,0,,,19/1/2022 7:23
17/5/2021,Trat,2,154,228577,113056,115521,25099,24970,129,,,19/1/2022 7:23
17/5/2021,Tak,1,445,673504,340558,332946,19138,19115,23,,,19/1/2022 7:23
17/5/2021,Nakhon Nayok,7,200,259663,128076,131587,7533,7533,0,,,19/1/2022 7:23
17/5/2021,Nakhon Pathom,36,1150,922477,443242,479235,13279,13263,16,36,20,19/1/2022 7:23
17/5/2021,Nakhon Phanom,0,135,717008,357388,359620,4972,4963,9,,,19/1/2022 7:23
17/5/2021,Nakhon Ratchasima,4,808,2633898,1294636,1339262,95155,94599,556,62,29,19/1/2022 7:23
17/5/2021,Nakhon Si Thammarat,11,743,1550685,765026,785659,7956,7956,0,,,19/1/2022 7:23
17/5/2021,Nakhon Sawan,5,453,1038321,506625,531696,21893,21893,0,63,32,19/1/2022 7:23
17/5/2021,Nonthaburi,177,5002,1282168,596750,685418,3634,3613,21,39,14,19/1/2022 7:23
17/5/2021,Narathiwat,11,697,807640,399607,408033,1063,1063,0,37,22,19/1/2022 7:23
17/5/2021,Nan,0,113,476276,238368,237908,6955,6876,79,,,19/1/2022 7:23
17/5/2021,Bueng Kan,0,24,422395,211815,210580,2107,2107,0,,,19/1/2022 7:23
17/5/2021,Buri Ram,0,187,1580600,784622,795978,19949,19899,50,,,19/1/2022 7:23
17/5/2021,Pathum Thani,146,3167,1181742,559988,621754,2265,2237,28,37,19,19/1/2022 7:23
17/5/2021,Prachuap Khiri Khan,4,1538,550568,272298,278270,51821,51734,87,,,19/1/2022 7:23
17/5/2021,Prachin Buri,3,346,494216,244010,250206,5966,5966,0,68,25,19/1/2022 7:23
17/5/2021,Pattani,1,368,727981,359468,368513,1288,1288,0,,,19/1/2022 7:23
17/5/2021,Phra Nakhon Si Ayutthaya,31,977,819893,393933,425960,61595,61233,362,57,42,19/1/2022 7:23
17/5/2021,Phayao,1,96,466006,226859,239147,11143,11122,21,71,33,19/1/2022 7:23
17/5/2021,Phang-nga,0,67,268719,134080,134639,8721,8100,621,,,19/1/2022 7:23
17/5/2021,Phatthalung,2,409,523135,254907,268228,1911,1911,0,,,19/1/2022 7:23
17/5/2021,Phichit,4,131,531511,259350,272161,7231,7231,0,,,19/1/2022 7:23
17/5/2021,Phitsanulok,2,320,847403,414611,432792,30519,30433,86,,,19/1/2022 7:23
17/5/2021,Phuket,2,827,414526,195824,218702,5291,4766,525,54,21,19/1/2022 7:23
17/5/2021,Maha Sarakham,1,291,951267,466548,484719,4341,4341,0,,,19/1/2022 7:23
17/5/2021,Mukdahan,0,40,351099,175412,175687,6784,6784,0,,,19/1/2022 7:23
17/5/2021,Yala,1,327,540317,268883,271434,2178,2178,0,49,20,19/1/2022 7:23
17/5/2021,Yasothon,2,109,534080,266625,267455,952,952,0,,,19/1/2022 7:23
17/5/2021,Ranong,4,594,194750,98304,96446,1678,1678,0,,,19/1/2022 7:23
17/5/2021,Rayong,19,1423,746202,366668,379534,22710,22497,213,40,26,19/1/2022 7:23
17/5/2021,Ratchaburi,27,597,869157,422653,446504,7378,7378,0,,,19/1/2022 7:23
17/5/2021,Roi Et,4,231,1297760,643167,654593,6265,6265,0,,,19/1/2022 7:23
17/5/2021,Lop Buri,4,227,739849,368410,371439,10549,10510,39,,,19/1/2022 7:23
17/5/2021,Lampang,4,262,727262,354467,372795,9481,9078,403,73,41,19/1/2022 7:23
17/5/2021,Lamphun,0,300,401851,193249,208602,8607,8482,125,,,19/1/2022 7:23
17/5/2021,Si Sa Ket,3,281,1457888,725954,731934,3439,3439,0,,,19/1/2022 7:23
17/5/2021,Sakon Nakhon,2,99,1147056,570138,576918,3867,3867,0,,,19/1/2022 7:23
17/5/2021,Songkhla,43,1172,1429188,696564,732624,2754,2723,31,63,28,19/1/2022 7:23
17/5/2021,Satun,0,42,324400,161412,162988,5525,5489,36,27,14,19/1/2022 7:23
17/5/2021,Samut Prakarn,155,5043,1354816,645683,709133,3744,3666,78,,,19/1/2022 7:23
17/5/2021,Samut Songkhram,3,177,191777,91661,100116,13850,13794,56,29,13,19/1/2022 7:23
17/5/2021,Samut Sakhon,53,18991,586821,282842,303979,1725,1725,0,65,29,19/1/2022 7:23
17/5/2021,Saraburi,3,310,643778,316334,327444,17834,17781,53,84,58,19/1/2022 7:23
17/5/2021,Sa kaeo,7,526,561072,279991,281081,3712,3712,0,25,11,19/1/2022 7:23
17/5/2021,Sing Buri,7,99,205391,97605,107786,3742,3742,0,,,19/1/2022 7:23
17/5/2021,Suphan Buri,5,399,837411,404175,433236,12597,12597,0,,,19/1/2022 7:23
17/5/2021,Surat Thani,27,1471,1068431,526206,542225,3429,3408,21,81,31,19/1/2022 7:23
17/5/2021,Surin,4,138,1377702,685565,692137,8806,8806,0,,,19/1/2022 7:23
17/5/2021,Sukhothai,0,110,586803,284381,302422,4869,4747,122,,,19/1/2022 7:23
17/5/2021,Nong Khai,0,75,517275,256665,260610,13264,13246,18,20,9,19/1/2022 7:23
17/5/2021,Nong Bua Lam Phu,0,35,509382,254164,255218,2186,2186,0,,,19/1/2022 7:23
17/5/2021,Amnat Charoen,0,51,376342,187394,188948,1140,1140,0,,,19/1/2022 7:23
17/5/2021,Udon Thani,3,425,1567699,776819,790880,11676,11669,7,,,19/1/2022 7:23
17/5/2021,Uttaradit,0,84,447682,218270,229412,8216,8216,0,,,19/1/2022 7:23
17/5/2021,Uthai Thani,1,24,325555,159138,166417,2668,2668,0,,,19/1/2022 7:23
17/5/2021,Ubon Ratchathani,2,351,1867034,932378,934656,17785,17785,0,68,18,19/1/2022 7:23
17/5/2021,Ang Thong,4,297,275934,132137,143797,2679,2679,0,,,19/1/2022 7:23
17/5/2021,Chiang Rai,4,594,1296741,630516,666225,33777,33431,346,99,42,19/1/2022 7:23
17/5/2021,Chiang Mai,3937,7983,1785286,862939,922347,97868,95795,2073,97,41,19/1/2022 7:23
17/5/2021,Phetchaburi,39,695,482261,232800,249461,48502,48311,191,,,19/1/2022 7:23
17/5/2021,Phetchabun,2,134,980259,483622,496637,30774,30774,0,,,19/1/2022 7:23
17/5/2021,Loei,3,95,638528,320030,318498,6303,6296,7,67,29,19/1/2022 7:23
17/5/2021,Phrae,0,83,436092,210253,225839,7717,7717,0,83,34,19/1/2022 7:23
17/5/2021,Mae Hong Son,2,47,285641,144762,140879,13138,12870,268,98,52,19/1/2022 7:23
17/5/2021,,0,153,,,,,,,,,19/1/2022 7:23
18/5/2021,Krabi,5,300,478425,237576,240849,2222,2082,140,,,19/1/2022 7:23
18/5/2021,Bangkok,1327,40863,5565337,2611984,2953353,353401,323907,29494,45,27,19/1/2022 7:23
18/5/2021,Kanchanaburi,7,293,892304,447427,444877,38060,37817,243,42,13,19/1/2022 7:23
18/5/2021,Kalasin,0,101,977098,483228,493870,2258,2258,0,,,19/1/2022 7:23
18/5/2021,Kamphaeng Phet,3,125,713612,352508,361104,8775,8775,0,,,19/1/2022 7:23
18/5/2021,Khon Kaen,0,490,1793078,881616,911462,46729,46690,39,107,47,19/1/2022 7:23
18/5/2021,Chanthaburi,6,861,535709,261994,273715,22331,22275,56,,,19/1/2022 7:23
18/5/2021,Chachoengsao,13,609,721880,353941,367939,5688,5688,0,54,35,19/1/2022 7:23
18/5/2021,Chon Buri,34,5338,1572844,766647,806197,29860,29153,707,48,30,19/1/2022 7:23
18/5/2021,Chai Nat,0,88,321640,154663,166977,5843,5843,0,,,19/1/2022 7:23
18/5/2021,Chaiyaphum,4,267,1124135,555470,568665,7737,7725,12,,,19/1/2022 7:23
18/5/2021,Chumphon,0,114,509660,251522,258138,1501,1501,0,,,19/1/2022 7:23
18/5/2021,Trang,8,298,640335,313195,327140,1786,1786,0,,,19/1/2022 7:23
18/5/2021,Trat,0,154,228577,113056,115521,25099,24970,129,,,19/1/2022 7:23
18/5/2021,Tak,7,452,673504,340558,332946,19138,19115,23,,,19/1/2022 7:23
18/5/2021,Nakhon Nayok,2,202,259663,128076,131587,7533,7533,0,,,19/1/2022 7:23
18/5/2021,Nakhon Pathom,18,1168,922477,443242,479235,13279,13263,16,45,19,19/1/2022 7:23
18/5/2021,Nakhon Phanom,0,135,717008,357388,359620,4972,4963,9,,,19/1/2022 7:23
18/5/2021,Nakhon Ratchasima,8,816,2633898,1294636,1339262,95155,94599,556,66,25,19/1/2022 7:23
18/5/2021,Nakhon Si Thammarat,30,773,1550685,765026,785659,7956,7956,0,,,19/1/2022 7:23
18/5/2021,Nakhon Sawan,2,455,1038321,506625,531696,21893,21893,0,71,36,19/1/2022 7:23
18/5/2021,Nonthaburi,391,5393,1282168,596750,685418,3634,3613,21,24,19,19/1/2022 7:23
18/5/2021,Narathiwat,7,704,807640,399607,408033,1063,1063,0,48,15,19/1/2022 7:23
18/5/2021,Nan,0,113,476276,238368,237908,6955,6876,79,,,19/1/2022 7:23
18/5/2021,Bueng Kan,0,24,422395,211815,210580,2107,2107,0,,,19/1/2022 7:23
18/5/2021,Buri Ram,1,188,1580600,784622,795978,19949,19899,50,,,19/1/2022 7:23
18/5/2021,Pathum Thani,117,3284,1181742,559988,621754,2265,2237,28,53,25,19/1/2022 7:23
18/5/2021,Prachuap Khiri Khan,8,1546,550568,272298,278270,51821,51734,87,,,19/1/2022 7:23
18/5/2021,Prachin Buri,1,347,494216,244010,250206,5966,5966,0,58,27,19/1/2022 7:23
18/5/2021,Pattani,10,378,727981,359468,368513,1288,1288,0,,,19/1/2022 7:23
18/5/2021,Phra Nakhon Si Ayutthaya,28,1005,819893,393933,425960,61595,61233,362,49,41,19/1/2022 7:23
18/5/2021,Phayao,0,96,466006,226859,239147,11143,11122,21,70,33,19/1/2022 7:23
18/5/2021,Phang-nga,0,67,268719,134080,134639,8721,8100,621,,,19/1/2022 7:23
18/5/2021,Phatthalung,5,414,523135,254907,268228,1911,1911,0,,,19/1/2022 7:23
18/5/2021,Phichit,2,133,531511,259350,272161,7231,7231,0,,,19/1/2022 7:23
18/5/2021,Phitsanulok,0,320,847403,414611,432792,30519,30433,86,,,19/1/2022 7:23
18/5/2021,Phuket,4,831,414526,195824,218702,5291,4766,525,50,26,19/1/2022 7:23
18/5/2021,Maha Sarakham,1,292,951267,466548,484719,4341,4341,0,,,19/1/2022 7:23
18/5/2021,Mukdahan,1,41,351099,175412,175687,6784,6784,0,,,19/1/2022 7:23
18/5/2021,Yala,3,330,540317,268883,271434,2178,2178,0,46,20,19/1/2022 7:23
18/5/2021,Yasothon,6,115,534080,266625,267455,952,952,0,,,19/1/2022 7:23
18/5/2021,Ranong,19,613,194750,98304,96446,1678,1678,0,,,19/1/2022 7:23
18/5/2021,Rayong,10,1433,746202,366668,379534,22710,22497,213,38,31,19/1/2022 7:23
18/5/2021,Ratchaburi,13,610,869157,422653,446504,7378,7378,0,,,19/1/2022 7:23
18/5/2021,Roi Et,2,233,1297760,643167,654593,6265,6265,0,,,19/1/2022 7:23
18/5/2021,Lop Buri,15,242,739849,368410,371439,10549,10510,39,,,19/1/2022 7:23
18/5/2021,Lampang,0,262,727262,354467,372795,9481,9078,403,74,39,19/1/2022 7:23
18/5/2021,Lamphun,0,300,401851,193249,208602,8607,8482,125,,,19/1/2022 7:23
18/5/2021,Si Sa Ket,3,284,1457888,725954,731934,3439,3439,0,,,19/1/2022 7:23
18/5/2021,Sakon Nakhon,2,101,1147056,570138,576918,3867,3867,0,,,19/1/2022 7:23
18/5/2021,Songkhla,30,1202,1429188,696564,732624,2754,2723,31,52,31,19/1/2022 7:23
18/5/2021,Satun,0,42,324400,161412,162988,5525,5489,36,22,16,19/1/2022 7:23
18/5/2021,Samut Prakarn,123,5166,1354816,645683,709133,3744,3666,78,,,19/1/2022 7:23
18/5/2021,Samut Songkhram,5,182,191777,91661,100116,13850,13794,56,32,14,19/1/2022 7:23
18/5/2021,Samut Sakhon,63,19054,586821,282842,303979,1725,1725,0,54,25,19/1/2022 7:23
18/5/2021,Saraburi,3,313,643778,316334,327444,17834,17781,53,66,53,19/1/2022 7:23
18/5/2021,Sa kaeo,8,534,561072,279991,281081,3712,3712,0,16,12,19/1/2022 7:23
18/5/2021,Sing Buri,3,102,205391,97605,107786,3742,3742,0,,,19/1/2022 7:23
18/5/2021,Suphan Buri,3,402,837411,404175,433236,12597,12597,0,,,19/1/2022 7:23
18/5/2021,Surat Thani,18,1489,1068431,526206,542225,3429,3408,21,70,31,19/1/2022 7:23
18/5/2021,Surin,5,143,1377702,685565,692137,8806,8806,0,,,19/1/2022 7:23
18/5/2021,Sukhothai,1,111,586803,284381,302422,4869,4747,122,,,19/1/2022 7:23
18/5/2021,Nong Khai,0,75,517275,256665,260610,13264,13246,18,22,9,19/1/2022 7:23
18/5/2021,Nong Bua Lam Phu,0,35,509382,254164,255218,2186,2186,0,,,19/1/2022 7:23
18/5/2021,Amnat Charoen,0,51,376342,187394,188948,1140,1140,0,,,19/1/2022 7:23
18/5/2021,Udon Thani,12,437,1567699,776819,790880,11676,11669,7,,,19/1/2022 7:23
18/5/2021,Uttaradit,0,84,447682,218270,229412,8216,8216,0,,,19/1/2022 7:23
18/5/2021,Uthai Thani,1,25,325555,159138,166417,2668,2668,0,,,19/1/2022 7:23
18/5/2021,Ubon Ratchathani,0,351,1867034,932378,934656,17785,17785,0,41,22,19/1/2022 7:23
18/5/2021,Ang Thong,0,297,275934,132137,143797,2679,2679,0,,,19/1/2022 7:23
18/5/2021,Chiang Rai,17,611,1296741,630516,666225,33777,33431,346,103,38,19/1/2022 7:23
18/5/2021,Chiang Mai,12,7995,1785286,862939,922347,97868,95795,2073,88,39,19/1/2022 7:23
18/5/2021,Phetchaburi,43,738,482261,232800,249461,48502,48311,191,,,19/1/2022 7:23
18/5/2021,Phetchabun,0,134,980259,483622,496637,30774,30774,0,,,19/1/2022 7:23
18/5/2021,Loei,0,95,638528,320030,318498,6303,6296,7,57,28,19/1/2022 7:23
18/5/2021,Phrae,0,83,436092,210253,225839,7717,7717,0,77,33,19/1/2022 7:23
18/5/2021,Mae Hong Son,3,50,285641,144762,140879,13138,12870,268,134, ,19/1/2022 7:23
18/5/2021,,0,153,,,,,,,,,19/1/2022 7:23
19/5/2021,Krabi,1,301,478425,237576,240849,2222,2082,140,,,19/1/2022 7:23
19/5/2021,Bangkok,2012,42875,5565337,2611984,2953353,353401,323907,29494,54,26,19/1/2022 7:23
19/5/2021,Kanchanaburi,1,294,892304,447427,444877,38060,37817,243,37,12,19/1/2022 7:23
19/5/2021,Kalasin,1,102,977098,483228,493870,2258,2258,0,,,19/1/2022 7:23
19/5/2021,Kamphaeng Phet,11,136,713612,352508,361104,8775,8775,0,,,19/1/2022 7:23
19/5/2021,Khon Kaen,9,499,1793078,881616,911462,46729,46690,39,77,48,19/1/2022 7:23
19/5/2021,Chanthaburi,32,893,535709,261994,273715,22331,22275,56,,,19/1/2022 7:23
19/5/2021,Chachoengsao,15,624,721880,353941,367939,5688,5688,0,52,34,19/1/2022 7:23
19/5/2021,Chon Buri,39,5377,1572844,766647,806197,29860,29153,707,47,30,19/1/2022 7:23
19/5/2021,Chai Nat,0,88,321640,154663,166977,5843,5843,0,,,19/1/2022 7:23
19/5/2021,Chaiyaphum,4,271,1124135,555470,568665,7737,7725,12,,,19/1/2022 7:23
19/5/2021,Chumphon,0,114,509660,251522,258138,1501,1501,0,,,19/1/2022 7:23
19/5/2021,Trang,10,308,640335,313195,327140,1786,1786,0,,,19/1/2022 7:23
19/5/2021,Trat,0,154,228577,113056,115521,25099,24970,129,,,19/1/2022 7:23
19/5/2021,Tak,9,461,673504,340558,332946,19138,19115,23,,,19/1/2022 7:23
19/5/2021,Nakhon Nayok,2,204,259663,128076,131587,7533,7533,0,,,19/1/2022 7:23
19/5/2021,Nakhon Pathom,22,1190,922477,443242,479235,13279,13263,16,34,16,19/1/2022 7:23
19/5/2021,Nakhon Phanom,0,135,717008,357388,359620,4972,4963,9,,,19/1/2022 7:23
19/5/2021,Nakhon Ratchasima,5,821,2633898,1294636,1339262,95155,94599,556,52,29,19/1/2022 7:23
19/5/2021,Nakhon Si Thammarat,10,783,1550685,765026,785659,7956,7956,0,,,19/1/2022 7:23
19/5/2021,Nakhon Sawan,5,460,1038321,506625,531696,21893,21893,0,81,33,19/1/2022 7:23
19/5/2021,Nonthaburi,497,5890,1282168,596750,685418,3634,3613,21,40,17,19/1/2022 7:23
19/5/2021,Narathiwat,11,715,807640,399607,408033,1063,1063,0,40,17,19/1/2022 7:23
19/5/2021,Nan,1,114,476276,238368,237908,6955,6876,79,,,19/1/2022 7:23
19/5/2021,Bueng Kan,1,25,422395,211815,210580,2107,2107,0,,,19/1/2022 7:23
19/5/2021,Buri Ram,2,190,1580600,784622,795978,19949,19899,50,,,19/1/2022 7:23
19/5/2021,Pathum Thani,119,3403,1181742,559988,621754,2265,2237,28,62,21,19/1/2022 7:23
19/5/2021,Prachuap Khiri Khan,3,1549,550568,272298,278270,51821,51734,87,,,19/1/2022 7:23
19/5/2021,Prachin Buri,2,349,494216,244010,250206,5966,5966,0,62,23,19/1/2022 7:23
19/5/2021,Pattani,5,383,727981,359468,368513,1288,1288,0,,,19/1/2022 7:23
19/5/2021,Phra Nakhon Si Ayutthaya,18,1023,819893,393933,425960,61595,61233,362,42,40,19/1/2022 7:23
19/5/2021,Phayao,0,96,466006,226859,239147,11143,11122,21,69,31,19/1/2022 7:23
19/5/2021,Phang-nga,2,69,268719,134080,134639,8721,8100,621,,,19/1/2022 7:23
19/5/2021,Phatthalung,0,414,523135,254907,268228,1911,1911,0,,,19/1/2022 7:23
19/5/2021,Phichit,2,135,531511,259350,272161,7231,7231,0,,,19/1/2022 7:23
19/5/2021,Phitsanulok,3,323,847403,414611,432792,30519,30433,86,,,19/1/2022 7:23
19/5/2021,Phuket,2,833,414526,195824,218702,5291,4766,525,47,25,19/1/2022 7:23
19/5/2021,Maha Sarakham,4,296,951267,466548,484719,4341,4341,0,,,19/1/2022 7:23
19/5/2021,Mukdahan,0,41,351099,175412,175687,6784,6784,0,,,19/1/2022 7:23
19/5/2021,Yala,8,338,540317,268883,271434,2178,2178,0,46,17,19/1/2022 7:23
19/5/2021,Yasothon,4,119,534080,266625,267455,952,952,0,,,19/1/2022 7:23
19/5/2021,Ranong,25,638,194750,98304,96446,1678,1678,0,,,19/1/2022 7:23
19/5/2021,Rayong,12,1445,746202,366668,379534,22710,22497,213,51,32,19/1/2022 7:23
19/5/2021,Ratchaburi,12,622,869157,422653,446504,7378,7378,0,,,19/1/2022 7:23
19/5/2021,Roi Et,5,238,1297760,643167,654593,6265,6265,0,,,19/1/2022 7:23
19/5/2021,Lop Buri,7,249,739849,368410,371439,10549,10510,39,,,19/1/2022 7:23
19/5/2021,Lampang,2,264,727262,354467,372795,9481,9078,403,72,39,19/1/2022 7:23
19/5/2021,Lamphun,0,300,401851,193249,208602,8607,8482,125,,,19/1/2022 7:23
19/5/2021,Si Sa Ket,17,301,1457888,725954,731934,3439,3439,0,,,19/1/2022 7:23
19/5/2021,Sakon Nakhon,1,102,1147056,570138,576918,3867,3867,0,,,19/1/2022 7:23
19/5/2021,Songkhla,46,1248,1429188,696564,732624,2754,2723,31,58,29,19/1/2022 7:23
19/5/2021,Satun,1,43,324400,161412,162988,5525,5489,36,25,16,19/1/2022 7:23
19/5/2021,Samut Prakarn,154,5320,1354816,645683,709133,3744,3666,78,,,19/1/2022 7:23
19/5/2021,Samut Songkhram,1,183,191777,91661,100116,13850,13794,56,29,11,19/1/2022 7:23
19/5/2021,Samut Sakhon,57,19111,586821,282842,303979,1725,1725,0,54,31,19/1/2022 7:23
19/5/2021,Saraburi,13,326,643778,316334,327444,17834,17781,53,64,50,19/1/2022 7:23
19/5/2021,Sa kaeo,11,545,561072,279991,281081,3712,3712,0,21,11,19/1/2022 7:23
19/5/2021,Sing Buri,1,103,205391,97605,107786,3742,3742,0,,,19/1/2022 7:23
19/5/2021,Suphan Buri,7,409,837411,404175,433236,12597,12597,0,,,19/1/2022 7:23
19/5/2021,Surat Thani,24,1513,1068431,526206,542225,3429,3408,21,64,35,19/1/2022 7:23
19/5/2021,Surin,5,148,1377702,685565,692137,8806,8806,0,,,19/1/2022 7:23
19/5/2021,Sukhothai,0,111,586803,284381,302422,4869,4747,122,,,19/1/2022 7:23
19/5/2021,Nong Khai,0,75,517275,256665,260610,13264,13246,18,22,9,19/1/2022 7:23
19/5/2021,Nong Bua Lam Phu,0,35,509382,254164,255218,2186,2186,0,,,19/1/2022 7:23
19/5/2021,Amnat Charoen,1,52,376342,187394,188948,1140,1140,0,,,19/1/2022 7:23
19/5/2021,Udon Thani,15,452,1567699,776819,790880,11676,11669,7,,,19/1/2022 7:23
19/5/2021,Uttaradit,1,85,447682,218270,229412,8216,8216,0,,,19/1/2022 7:23
19/5/2021,Uthai Thani,0,25,325555,159138,166417,2668,2668,0,,,19/1/2022 7:23
19/5/2021,Ubon Ratchathani,1,352,1867034,932378,934656,17785,17785,0,55,19,19/1/2022 7:23
19/5/2021,Ang Thong,0,297,275934,132137,143797,2679,2679,0,,,19/1/2022 7:23
19/5/2021,Chiang Rai,6,617,1296741,630516,666225,33777,33431,346,95,41,19/1/2022 7:23
19/5/2021,Chiang Mai,9,8004,1785286,862939,922347,97868,95795,2073,81,40,19/1/2022 7:23
19/5/2021,Phetchaburi,76,814,482261,232800,249461,48502,48311,191,,,19/1/2022 7:23
19/5/2021,Phetchabun,9,143,980259,483622,496637,30774,30774,0,,,19/1/2022 7:23
19/5/2021,Loei,1,96,638528,320030,318498,6303,6296,7,56,26,19/1/2022 7:23
19/5/2021,Phrae,0,83,436092,210253,225839,7717,7717,0,75,36,19/1/2022 7:23
19/5/2021,Mae Hong Son,2,52,285641,144762,140879,13138,12870,268,,,19/1/2022 7:23
19/5/2021,,0,153,,,,,,,,,19/1/2022 7:23
20/5/2021,Krabi,2,303,478425,237576,240849,2222,2082,140,,,19/1/2022 7:23
20/5/2021,Bangkok,1604,44479,5565337,2611984,2953353,353401,323907,29494,48,20,19/1/2022 7:23
20/5/2021,Kanchanaburi,11,305,892304,447427,444877,38060,37817,243,31,4,19/1/2022 7:23
20/5/2021,Kalasin,2,104,977098,483228,493870,2258,2258,0,,,19/1/2022 7:23
20/5/2021,Kamphaeng Phet,1,137,713612,352508,361104,8775,8775,0,,,19/1/2022 7:23
20/5/2021,Khon Kaen,0,499,1793078,881616,911462,46729,46690,39,83,41,19/1/2022 7:23
20/5/2021,Chanthaburi,44,937,535709,261994,273715,22331,22275,56,,,19/1/2022 7:23
20/5/2021,Chachoengsao,35,659,721880,353941,367939,5688,5688,0,46,42,19/1/2022 7:23
20/5/2021,Chon Buri,66,5443,1572844,766647,806197,29860,29153,707,47,22,19/1/2022 7:23
20/5/2021,Chai Nat,0,88,321640,154663,166977,5843,5843,0,,,19/1/2022 7:23
20/5/2021,Chaiyaphum,1,272,1124135,555470,568665,7737,7725,12,,,19/1/2022 7:23
20/5/2021,Chumphon,0,114,509660,251522,258138,1501,1501,0,,,19/1/2022 7:23
20/5/2021,Trang,12,320,640335,313195,327140,1786,1786,0,,,19/1/2022 7:23
20/5/2021,Trat,2,156,228577,113056,115521,25099,24970,129,,,19/1/2022 7:23
20/5/2021,Tak,5,466,673504,340558,332946,19138,19115,23,,,19/1/2022 7:23
20/5/2021,Nakhon Nayok,6,210,259663,128076,131587,7533,7533,0,,,19/1/2022 7:23
20/5/2021,Nakhon Pathom,38,1228,922477,443242,479235,13279,13263,16,38,15,19/1/2022 7:23
20/5/2021,Nakhon Phanom,0,135,717008,357388,359620,4972,4963,9,,,19/1/2022 7:23
20/5/2021,Nakhon Ratchasima,19,840,2633898,1294636,1339262,95155,94599,556,62,29,19/1/2022 7:23
20/5/2021,Nakhon Si Thammarat,13,796,1550685,765026,785659,7956,7956,0,,,19/1/2022 7:23
20/5/2021,Nakhon Sawan,2,462,1038321,506625,531696,21893,21893,0,75,24,19/1/2022 7:23
20/5/2021,Nonthaburi,150,6040,1282168,596750,685418,3634,3613,21,35,9,19/1/2022 7:23
20/5/2021,Narathiwat,15,730,807640,399607,408033,1063,1063,0,32,30,19/1/2022 7:23
20/5/2021,Nan,0,114,476276,238368,237908,6955,6876,79,,,19/1/2022 7:23
20/5/2021,Bueng Kan,0,25,422395,211815,210580,2107,2107,0,,,19/1/2022 7:23
20/5/2021,Buri Ram,2,192,1580600,784622,795978,19949,19899,50,,,19/1/2022 7:23
20/5/2021,Pathum Thani,89,3492,1181742,559988,621754,2265,2237,28,53,10,19/1/2022 7:23
20/5/2021,Prachuap Khiri Khan,4,1553,550568,272298,278270,51821,51734,87,,,19/1/2022 7:23
20/5/2021,Prachin Buri,6,355,494216,244010,250206,5966,5966,0,56,31,19/1/2022 7:23
20/5/2021,Pattani,3,386,727981,359468,368513,1288,1288,0,,,19/1/2022 7:23
20/5/2021,Phra Nakhon Si Ayutthaya,30,1053,819893,393933,425960,61595,61233,362,45,37,19/1/2022 7:23
20/5/2021,Phayao,0,96,466006,226859,239147,11143,11122,21,61,31,19/1/2022 7:23
20/5/2021,Phang-nga,0,69,268719,134080,134639,8721,8100,621,,,19/1/2022 7:23
20/5/2021,Phatthalung,0,414,523135,254907,268228,1911,1911,0,,,19/1/2022 7:23
20/5/2021,Phichit,5,140,531511,259350,272161,7231,7231,0,,,19/1/2022 7:23
20/5/2021,Phitsanulok,0,323,847403,414611,432792,30519,30433,86,,,19/1/2022 7:23
20/5/2021,Phuket,0,833,414526,195824,218702,5291,4766,525,50,21,19/1/2022 7:23
20/5/2021,Maha Sarakham,7,303,951267,466548,484719,4341,4341,0,,,19/1/2022 7:23
20/5/2021,Mukdahan,0,41,351099,175412,175687,6784,6784,0,,,19/1/2022 7:23
20/5/2021,Yala,2,340,540317,268883,271434,2178,2178,0,41,22,19/1/2022 7:23
20/5/2021,Yasothon,0,119,534080,266625,267455,952,952,0,,,19/1/2022 7:23
20/5/2021,Ranong,0,638,194750,98304,96446,1678,1678,0,,,19/1/2022 7:23
20/5/2021,Rayong,12,1457,746202,366668,379534,22710,22497,213,41,26,19/1/2022 7:23
20/5/2021,Ratchaburi,20,642,869157,422653,446504,7378,7378,0,,,19/1/2022 7:23
20/5/2021,Roi Et,0,238,1297760,643167,654593,6265,6265,0,,,19/1/2022 7:23
20/5/2021,Lop Buri,10,259,739849,368410,371439,10549,10510,39,,,19/1/2022 7:23
20/5/2021,Lampang,0,264,727262,354467,372795,9481,9078,403,66,46,19/1/2022 7:23
20/5/2021,Lamphun,0,300,401851,193249,208602,8607,8482,125,,,19/1/2022 7:23
20/5/2021,Si Sa Ket,18,319,1457888,725954,731934,3439,3439,0,,,19/1/2022 7:23
20/5/2021,Sakon Nakhon,3,105,1147056,570138,576918,3867,3867,0,,,19/1/2022 7:23
20/5/2021,Songkhla,28,1276,1429188,696564,732624,2754,2723,31,53,36,19/1/2022 7:23
20/5/2021,Satun,0,43,324400,161412,162988,5525,5489,36,26,17,19/1/2022 7:23
20/5/2021,Samut Prakarn,61,5381,1354816,645683,709133,3744,3666,78,,,19/1/2022 7:23
20/5/2021,Samut Songkhram,4,187,191777,91661,100116,13850,13794,56,22,13,19/1/2022 7:23
20/5/2021,Samut Sakhon,57,19168,586821,282842,303979,1725,1725,0,60, ,19/1/2022 7:23
20/5/2021,Saraburi,10,336,643778,316334,327444,17834,17781,53,64,49,19/1/2022 7:23
20/5/2021,Sa kaeo,60,605,561072,279991,281081,3712,3712,0,20,5,19/1/2022 7:23
20/5/2021,Sing Buri,2,105,205391,97605,107786,3742,3742,0,,,19/1/2022 7:23
20/5/2021,Suphan Buri,2,411,837411,404175,433236,12597,12597,0,,,19/1/2022 7:23
20/5/2021,Surat Thani,10,1523,1068431,526206,542225,3429,3408,21,70,32,19/1/2022 7:23
20/5/2021,Surin,10,158,1377702,685565,692137,8806,8806,0,,,19/1/2022 7:23
20/5/2021,Sukhothai,1,112,586803,284381,302422,4869,4747,122,,,19/1/2022 7:23
20/5/2021,Nong Khai,0,75,517275,256665,260610,13264,13246,18,21,9,19/1/2022 7:23
20/5/2021,Nong Bua Lam Phu,0,35,509382,254164,255218,2186,2186,0,,,19/1/2022 7:23
20/5/2021,Amnat Charoen,0,52,376342,187394,188948,1140,1140,0,,,19/1/2022 7:23
20/5/2021,Udon Thani,4,456,1567699,776819,790880,11676,11669,7,,,19/1/2022 7:23
20/5/2021,Uttaradit,0,85,447682,218270,229412,8216,8216,0,,,19/1/2022 7:23
20/5/2021,Uthai Thani,2,27,325555,159138,166417,2668,2668,0,,,19/1/2022 7:23
20/5/2021,Ubon Ratchathani,2,354,1867034,932378,934656,17785,17785,0,44,23,19/1/2022 7:23
20/5/2021,Ang Thong,1,298,275934,132137,143797,2679,2679,0,,,19/1/2022 7:23
20/5/2021,Chiang Rai,10,627,1296741,630516,666225,33777,33431,346,96,33,19/1/2022 7:23
20/5/2021,Chiang Mai,5,8009,1785286,862939,922347,97868,95795,2073,78,34,19/1/2022 7:23
20/5/2021,Phetchaburi,124,938,482261,232800,249461,48502,48311,191,,,19/1/2022 7:23
20/5/2021,Phetchabun,2,145,980259,483622,496637,30774,30774,0,,,19/1/2022 7:23
20/5/2021,Loei,0,96,638528,320030,318498,6303,6296,7,49,20,19/1/2022 7:23
20/5/2021,Phrae,0,83,436092,210253,225839,7717,7717,0,81,40,19/1/2022 7:23
20/5/2021,Mae Hong Son,2,54,285641,144762,140879,13138,12870,268, ,18,19/1/2022 7:23
20/5/2021,,0,153,,,,,,,,,19/1/2022 7:23
21/5/2021,Krabi,0,303,478425,237576,240849,2222,2082,140,,,19/1/2022 7:23
21/5/2021,Bangkok,1758,46237,5565337,2611984,2953353,353401,323907,29494,43,23,19/1/2022 7:23
21/5/2021,Kanchanaburi,4,309,892304,447427,444877,38060,37817,243,12,8,19/1/2022 7:23
21/5/2021,Kalasin,0,104,977098,483228,493870,2258,2258,0,,,19/1/2022 7:23
21/5/2021,Kamphaeng Phet,1,138,713612,352508,361104,8775,8775,0,,,19/1/2022 7:23
21/5/2021,Khon Kaen,5,504,1793078,881616,911462,46729,46690,39,78,41,19/1/2022 7:23
21/5/2021,Chanthaburi,21,958,535709,261994,273715,22331,22275,56,,,19/1/2022 7:23
21/5/2021,Chachoengsao,24,683,721880,353941,367939,5688,5688,0,48,30,19/1/2022 7:23
21/5/2021,Chon Buri,127,5570,1572844,766647,806197,29860,29153,707,31,22,19/1/2022 7:23
21/5/2021,Chai Nat,2,90,321640,154663,166977,5843,5843,0,,,19/1/2022 7:23
21/5/2021,Chaiyaphum,8,280,1124135,555470,568665,7737,7725,12,,,19/1/2022 7:23
21/5/2021,Chumphon,4,118,509660,251522,258138,1501,1501,0,,,19/1/2022 7:23
21/5/2021,Trang,9,329,640335,313195,327140,1786,1786,0,,,19/1/2022 7:23
21/5/2021,Trat,1,157,228577,113056,115521,25099,24970,129,,,19/1/2022 7:23
21/5/2021,Tak,45,511,673504,340558,332946,19138,19115,23,,,19/1/2022 7:23
21/5/2021,Nakhon Nayok,3,213,259663,128076,131587,7533,7533,0,,,19/1/2022 7:23
21/5/2021,Nakhon Pathom,16,1244,922477,443242,479235,13279,13263,16,30,10,19/1/2022 7:23
21/5/2021,Nakhon Phanom,0,135,717008,357388,359620,4972,4963,9,,,19/1/2022 7:23
21/5/2021,Nakhon Ratchasima,11,851,2633898,1294636,1339262,95155,94599,556,68,25,19/1/2022 7:23
21/5/2021,Nakhon Si Thammarat,7,803,1550685,765026,785659,7956,7956,0,,,19/1/2022 7:23
21/5/2021,Nakhon Sawan,0,462,1038321,506625,531696,21893,21893,0,50,21,19/1/2022 7:23
21/5/2021,Nonthaburi,375,6415,1282168,596750,685418,3634,3613,21,23,11,19/1/2022 7:23
21/5/2021,Narathiwat,12,742,807640,399607,408033,1063,1063,0,42,18,19/1/2022 7:23
21/5/2021,Nan,0,114,476276,238368,237908,6955,6876,79,,,19/1/2022 7:23
21/5/2021,Bueng Kan,0,25,422395,211815,210580,2107,2107,0,,,19/1/2022 7:23
21/5/2021,Buri Ram,0,192,1580600,784622,795978,19949,19899,50,,,19/1/2022 7:23
21/5/2021,Pathum Thani,162,3654,1181742,559988,621754,2265,2237,28,33,12,19/1/2022 7:23
21/5/2021,Prachuap Khiri Khan,10,1563,550568,272298,278270,51821,51734,87,,,19/1/2022 7:23
21/5/2021,Prachin Buri,14,369,494216,244010,250206,5966,5966,0,63,24,19/1/2022 7:23
21/5/2021,Pattani,4,390,727981,359468,368513,1288,1288,0,,,19/1/2022 7:23
21/5/2021,Phra Nakhon Si Ayutthaya,28,1081,819893,393933,425960,61595,61233,362,45,33,19/1/2022 7:23
21/5/2021,Phayao,0,96,466006,226859,239147,11143,11122,21,68,31,19/1/2022 7:23
21/5/2021,Phang-nga,0,69,268719,134080,134639,8721,8100,621,,,19/1/2022 7:23
21/5/2021,Phatthalung,0,414,523135,254907,268228,1911,1911,0,,,19/1/2022 7:23
21/5/2021,Phichit,2,142,531511,259350,272161,7231,7231,0,,,19/1/2022 7:23
21/5/2021,Phitsanulok,0,323,847403,414611,432792,30519,30433,86,,,19/1/2022 7:23
21/5/2021,Phuket,3,836,414526,195824,218702,5291,4766,525,48,28,19/1/2022 7:23
21/5/2021,Maha Sarakham,9,312,951267,466548,484719,4341,4341,0,,,19/1/2022 7:23
21/5/2021,Mukdahan,0,41,351099,175412,175687,6784,6784,0,,,19/1/2022 7:23
21/5/2021,Yala,4,344,540317,268883,271434,2178,2178,0,52,18,19/1/2022 7:23
21/5/2021,Yasothon,5,124,534080,266625,267455,952,952,0,,,19/1/2022 7:23
21/5/2021,Ranong,54,692,194750,98304,96446,1678,1678,0,,,19/1/2022 7:23
21/5/2021,Rayong,13,1470,746202,366668,379534,22710,22497,213,32,27,19/1/2022 7:23
21/5/2021,Ratchaburi,18,660,869157,422653,446504,7378,7378,0,,,19/1/2022 7:23
21/5/2021,Roi Et,4,242,1297760,643167,654593,6265,6265,0,,,19/1/2022 7:23
21/5/2021,Lop Buri,6,265,739849,368410,371439,10549,10510,39,,,19/1/2022 7:23
21/5/2021,Lampang,0,264,727262,354467,372795,9481,9078,403,92,29,19/1/2022 7:23
21/5/2021,Lamphun,0,300,401851,193249,208602,8607,8482,125,,,19/1/2022 7:23
21/5/2021,Si Sa Ket,5,324,1457888,725954,731934,3439,3439,0,,,19/1/2022 7:23
21/5/2021,Sakon Nakhon,5,110,1147056,570138,576918,3867,3867,0,,,19/1/2022 7:23
21/5/2021,Songkhla,36,1312,1429188,696564,732624,2754,2723,31,70,33,19/1/2022 7:23
21/5/2021,Satun,0,43,324400,161412,162988,5525,5489,36,26,18,19/1/2022 7:23
21/5/2021,Samut Prakarn,457,5838,1354816,645683,709133,3744,3666,78,,,19/1/2022 7:23
21/5/2021,Samut Songkhram,7,194,191777,91661,100116,13850,13794,56,28,10,19/1/2022 7:23
21/5/2021,Samut Sakhon,40,19208,586821,282842,303979,1725,1725,0, ,29,19/1/2022 7:23
21/5/2021,Saraburi,13,349,643778,316334,327444,17834,17781,53,58,34,19/1/2022 7:23
21/5/2021,Sa kaeo,15,620,561072,279991,281081,3712,3712,0,9,11,19/1/2022 7:23
21/5/2021,Sing Buri,2,107,205391,97605,107786,3742,3742,0,,,19/1/2022 7:23
21/5/2021,Suphan Buri,3,414,837411,404175,433236,12597,12597,0,,,19/1/2022 7:23
21/5/2021,Surat Thani,18,1541,1068431,526206,542225,3429,3408,21,61,28,19/1/2022 7:23
21/5/2021,Surin,5,163,1377702,685565,692137,8806,8806,0,,,19/1/2022 7:23
21/5/2021,Sukhothai,1,113,586803,284381,302422,4869,4747,122,,,19/1/2022 7:23
21/5/2021,Nong Khai,0,75,517275,256665,260610,13264,13246,18,23,8,19/1/2022 7:23
21/5/2021,Nong Bua Lam Phu,5,40,509382,254164,255218,2186,2186,0,,,19/1/2022 7:23
21/5/2021,Amnat Charoen,0,52,376342,187394,188948,1140,1140,0,,,19/1/2022 7:23
21/5/2021,Udon Thani,2,458,1567699,776819,790880,11676,11669,7,,,19/1/2022 7:23
21/5/2021,Uttaradit,3,88,447682,218270,229412,8216,8216,0,,,19/1/2022 7:23
21/5/2021,Uthai Thani,2,29,325555,159138,166417,2668,2668,0,,,19/1/2022 7:23
21/5/2021,Ubon Ratchathani,1,355,1867034,932378,934656,17785,17785,0,59,20,19/1/2022 7:23
21/5/2021,Ang Thong,0,298,275934,132137,143797,2679,2679,0,,,19/1/2022 7:23
21/5/2021,Chiang Rai,4,631,1296741,630516,666225,33777,33431,346,89,37,19/1/2022 7:23
21/5/2021,Chiang Mai,8,8017,1785286,862939,922347,97868,95795,2073,76,34,19/1/2022 7:23
21/5/2021,Phetchaburi,77,1015,482261,232800,249461,48502,48311,191,,,19/1/2022 7:23
21/5/2021,Phetchabun,3,148,980259,483622,496637,30774,30774,0,,,19/1/2022 7:23
21/5/2021,Loei,0,96,638528,320030,318498,6303,6296,7,36,29,19/1/2022 7:23
21/5/2021,Phrae,0,83,436092,210253,225839,7717,7717,0,98,26,19/1/2022 7:23
21/5/2021,Mae Hong Son,0,54,285641,144762,140879,13138,12870,268,63, ,19/1/2022 7:23
21/5/2021,,0,153,,,,,,,,,19/1/2022 7:23
22/5/2021,Krabi,5,308,478425,237576,240849,2222,2082,140,,,19/1/2022 7:23
22/5/2021,Bangkok,1319,47556,5565337,2611984,2953353,353401,323907,29494,49,22,19/1/2022 7:23
22/5/2021,Kanchanaburi,5,314,892304,447427,444877,38060,37817,243,22,7,19/1/2022 7:23
22/5/2021,Kalasin,0,104,977098,483228,493870,2258,2258,0,,,19/1/2022 7:23
22/5/2021,Kamphaeng Phet,1,139,713612,352508,361104,8775,8775,0,,,19/1/2022 7:23
22/5/2021,Khon Kaen,4,508,1793078,881616,911462,46729,46690,39,71,40,19/1/2022 7:23
22/5/2021,Chanthaburi,14,972,535709,261994,273715,22331,22275,56,,,19/1/2022 7:23
22/5/2021,Chachoengsao,29,712,721880,353941,367939,5688,5688,0,40,33,19/1/2022 7:23
22/5/2021,Chon Buri,73,5643,1572844,766647,806197,29860,29153,707,26,21,19/1/2022 7:23
22/5/2021,Chai Nat,0,90,321640,154663,166977,5843,5843,0,,,19/1/2022 7:23
22/5/2021,Chaiyaphum,6,286,1124135,555470,568665,7737,7725,12,,,19/1/2022 7:23
22/5/2021,Chumphon,4,122,509660,251522,258138,1501,1501,0,,,19/1/2022 7:23
22/5/2021,Trang,6,335,640335,313195,327140,1786,1786,0,,,19/1/2022 7:23
22/5/2021,Trat,0,157,228577,113056,115521,25099,24970,129,,,19/1/2022 7:23
22/5/2021,Tak,20,531,673504,340558,332946,19138,19115,23,,,19/1/2022 7:23
22/5/2021,Nakhon Nayok,4,217,259663,128076,131587,7533,7533,0,,,19/1/2022 7:23
22/5/2021,Nakhon Pathom,20,1264,922477,443242,479235,13279,13263,16,19,13,19/1/2022 7:23
22/5/2021,Nakhon Phanom,2,137,717008,357388,359620,4972,4963,9,,,19/1/2022 7:23
22/5/2021,Nakhon Ratchasima,16,867,2633898,1294636,1339262,95155,94599,556,48,22,19/1/2022 7:23
22/5/2021,Nakhon Si Thammarat,8,811,1550685,765026,785659,7956,7956,0,,,19/1/2022 7:23
22/5/2021,Nakhon Sawan,0,462,1038321,506625,531696,21893,21893,0,41,19,19/1/2022 7:23
22/5/2021,Nonthaburi,559,6974,1282168,596750,685418,3634,3613,21,22,12,19/1/2022 7:23
22/5/2021,Narathiwat,4,746,807640,399607,408033,1063,1063,0,40,21,19/1/2022 7:23
22/5/2021,Nan,4,118,476276,238368,237908,6955,6876,79,,,19/1/2022 7:23
22/5/2021,Bueng Kan,2,27,422395,211815,210580,2107,2107,0,,,19/1/2022 7:23
22/5/2021,Buri Ram,4,196,1580600,784622,795978,19949,19899,50,,,19/1/2022 7:23
22/5/2021,Pathum Thani,68,3722,1181742,559988,621754,2265,2237,28,27,10,19/1/2022 7:23
22/5/2021,Prachuap Khiri Khan,14,1577,550568,272298,278270,51821,51734,87,,,19/1/2022 7:23
22/5/2021,Prachin Buri,6,375,494216,244010,250206,5966,5966,0,54,26,19/1/2022 7:23
22/5/2021,Pattani,1,391,727981,359468,368513,1288,1288,0,,,19/1/2022 7:23
22/5/2021,Phra Nakhon Si Ayutthaya,14,1095,819893,393933,425960,61595,61233,362,18,34,19/1/2022 7:23
22/5/2021,Phayao,0,96,466006,226859,239147,11143,11122,21,60,29,19/1/2022 7:23
22/5/2021,Phang-nga,0,69,268719,134080,134639,8721,8100,621,,,19/1/2022 7:23
22/5/2021,Phatthalung,1,415,523135,254907,268228,1911,1911,0,,,19/1/2022 7:23
22/5/2021,Phichit,3,145,531511,259350,272161,7231,7231,0,,,19/1/2022 7:23
22/5/2021,Phitsanulok,0,323,847403,414611,432792,30519,30433,86,,,19/1/2022 7:23
22/5/2021,Phuket,4,840,414526,195824,218702,5291,4766,525,57,32,19/1/2022 7:23
22/5/2021,Maha Sarakham,17,329,951267,466548,484719,4341,4341,0,,,19/1/2022 7:23
22/5/2021,Mukdahan,0,41,351099,175412,175687,6784,6784,0,,,19/1/2022 7:23
22/5/2021,Yala,44,388,540317,268883,271434,2178,2178,0,42,22,19/1/2022 7:23
22/5/2021,Yasothon,1,125,534080,266625,267455,952,952,0,,,19/1/2022 7:23
22/5/2021,Ranong,3,695,194750,98304,96446,1678,1678,0,,,19/1/2022 7:23
22/5/2021,Rayong,15,1485,746202,366668,379534,22710,22497,213,33,27,19/1/2022 7:23
22/5/2021,Ratchaburi,29,689,869157,422653,446504,7378,7378,0,,,19/1/2022 7:23
22/5/2021,Roi Et,6,248,1297760,643167,654593,6265,6265,0,,,19/1/2022 7:23
22/5/2021,Lop Buri,2,267,739849,368410,371439,10549,10510,39,,,19/1/2022 7:23
22/5/2021,Lampang,0,264,727262,354467,372795,9481,9078,403,58,22,19/1/2022 7:23
22/5/2021,Lamphun,0,300,401851,193249,208602,8607,8482,125,,,19/1/2022 7:23
22/5/2021,Si Sa Ket,15,339,1457888,725954,731934,3439,3439,0,,,19/1/2022 7:23
22/5/2021,Sakon Nakhon,5,115,1147056,570138,576918,3867,3867,0,,,19/1/2022 7:23
22/5/2021,Songkhla,20,1332,1429188,696564,732624,2754,2723,31,57,36,19/1/2022 7:23
22/5/2021,Satun,2,45,324400,161412,162988,5525,5489,36,31,28,19/1/2022 7:23
22/5/2021,Samut Prakarn,94,5932,1354816,645683,709133,3744,3666,78,,,19/1/2022 7:23
22/5/2021,Samut Songkhram,8,202,191777,91661,100116,13850,13794,56,18,10,19/1/2022 7:23
22/5/2021,Samut Sakhon,49,19257,586821,282842,303979,1725,1725,0,51,29,19/1/2022 7:23
22/5/2021,Saraburi,9,358,643778,316334,327444,17834,17781,53,34,43,19/1/2022 7:23
22/5/2021,Sa kaeo,41,661,561072,279991,281081,3712,3712,0,15,13,19/1/2022 7:23
22/5/2021,Sing Buri,0,107,205391,97605,107786,3742,3742,0,,,19/1/2022 7:23
22/5/2021,Suphan Buri,1,415,837411,404175,433236,12597,12597,0,,,19/1/2022 7:23
22/5/2021,Surat Thani,20,1561,1068431,526206,542225,3429,3408,21,62,32,19/1/2022 7:23
22/5/2021,Surin,1,164,1377702,685565,692137,8806,8806,0,,,19/1/2022 7:23
22/5/2021,Sukhothai,0,113,586803,284381,302422,4869,4747,122,,,19/1/2022 7:23
22/5/2021,Nong Khai,0,75,517275,256665,260610,13264,13246,18,20,10,19/1/2022 7:23
22/5/2021,Nong Bua Lam Phu,0,40,509382,254164,255218,2186,2186,0,,,19/1/2022 7:23
22/5/2021,Amnat Charoen,0,52,376342,187394,188948,1140,1140,0,,,19/1/2022 7:23
22/5/2021,Udon Thani,1,459,1567699,776819,790880,11676,11669,7,,,19/1/2022 7:23
22/5/2021,Uttaradit,0,88,447682,218270,229412,8216,8216,0,,,19/1/2022 7:23
22/5/2021,Uthai Thani,1,30,325555,159138,166417,2668,2668,0,,,19/1/2022 7:23
22/5/2021,Ubon Ratchathani,1,356,1867034,932378,934656,17785,17785,0,43,22,19/1/2022 7:23
22/5/2021,Ang Thong,1,299,275934,132137,143797,2679,2679,0,,,19/1/2022 7:23
22/5/2021,Chiang Rai,6,637,1296741,630516,666225,33777,33431,346,92,35,19/1/2022 7:23
22/5/2021,Chiang Mai,3,8020,1785286,862939,922347,97868,95795,2073,75,24,19/1/2022 7:23
22/5/2021,Phetchaburi,437,1452,482261,232800,249461,48502,48311,191,,,19/1/2022 7:23
22/5/2021,Phetchabun,0,148,980259,483622,496637,30774,30774,0,,,19/1/2022 7:23
22/5/2021,Loei,0,96,638528,320030,318498,6303,6296,7,57,26,19/1/2022 7:23
22/5/2021,Phrae,0,83,436092,210253,225839,7717,7717,0,61,22,19/1/2022 7:23
22/5/2021,Mae Hong Son,0,54,285641,144762,140879,13138,12870,268,,,19/1/2022 7:23
22/5/2021,,0,153,,,,,,,,,19/1/2022 7:23
23/5/2021,Krabi,2,310,478425,237576,240849,2222,2082,140,,,19/1/2022 7:23
23/5/2021,Bangkok,1054,48610,5565337,2611984,2953353,353401,323907,29494,44,25,19/1/2022 7:23
23/5/2021,Kanchanaburi,3,317,892304,447427,444877,38060,37817,243,20,12,19/1/2022 7:23
23/5/2021,Kalasin,1,105,977098,483228,493870,2258,2258,0,,,19/1/2022 7:23
23/5/2021,Kamphaeng Phet,1,140,713612,352508,361104,8775,8775,0,,,19/1/2022 7:23
23/5/2021,Khon Kaen,0,508,1793078,881616,911462,46729,46690,39,68,38,19/1/2022 7:23
23/5/2021,Chanthaburi,9,981,535709,261994,273715,22331,22275,56,,,19/1/2022 7:23
23/5/2021,Chachoengsao,155,867,721880,353941,367939,5688,5688,0,38,35,19/1/2022 7:23
23/5/2021,Chon Buri,91,5734,1572844,766647,806197,29860,29153,707,38,27,19/1/2022 7:23
23/5/2021,Chai Nat,0,90,321640,154663,166977,5843,5843,0,,,19/1/2022 7:23
23/5/2021,Chaiyaphum,4,290,1124135,555470,568665,7737,7725,12,,,19/1/2022 7:23
23/5/2021,Chumphon,1,123,509660,251522,258138,1501,1501,0,,,19/1/2022 7:23
23/5/2021,Trang,4,339,640335,313195,327140,1786,1786,0,,,19/1/2022 7:23
23/5/2021,Trat,0,157,228577,113056,115521,25099,24970,129,,,19/1/2022 7:23
23/5/2021,Tak,7,538,673504,340558,332946,19138,19115,23,,,19/1/2022 7:23
23/5/2021,Nakhon Nayok,7,224,259663,128076,131587,7533,7533,0,,,19/1/2022 7:23
23/5/2021,Nakhon Pathom,26,1290,922477,443242,479235,13279,13263,16,25,15,19/1/2022 7:23
23/5/2021,Nakhon Phanom,1,138,717008,357388,359620,4972,4963,9,,,19/1/2022 7:23
23/5/2021,Nakhon Ratchasima,22,889,2633898,1294636,1339262,95155,94599,556,41,25,19/1/2022 7:23
23/5/2021,Nakhon Si Thammarat,8,819,1550685,765026,785659,7956,7956,0,,,19/1/2022 7:23
23/5/2021,Nakhon Sawan,0,462,1038321,506625,531696,21893,21893,0,33,23,19/1/2022 7:23
23/5/2021,Nonthaburi,444,7418,1282168,596750,685418,3634,3613,21,24,22,19/1/2022 7:23
23/5/2021,Narathiwat,24,770,807640,399607,408033,1063,1063,0,38,26,19/1/2022 7:23
23/5/2021,Nan,1,119,476276,238368,237908,6955,6876,79,,,19/1/2022 7:23
23/5/2021,Bueng Kan,0,27,422395,211815,210580,2107,2107,0,,,19/1/2022 7:23
23/5/2021,Buri Ram,0,196,1580600,784622,795978,19949,19899,50,,,19/1/2022 7:23
23/5/2021,Pathum Thani,66,3788,1181742,559988,621754,2265,2237,28,26,14,19/1/2022 7:23
23/5/2021,Prachuap Khiri Khan,10,1587,550568,272298,278270,51821,51734,87,,,19/1/2022 7:23
23/5/2021,Prachin Buri,4,379,494216,244010,250206,5966,5966,0,54,32,19/1/2022 7:23
23/5/2021,Pattani,0,391,727981,359468,368513,1288,1288,0,,,19/1/2022 7:23
23/5/2021,Phra Nakhon Si Ayutthaya,9,1104,819893,393933,425960,61595,61233,362,27,39,19/1/2022 7:23
23/5/2021,Phayao,0,96,466006,226859,239147,11143,11122,21,60,19,19/1/2022 7:23
23/5/2021,Phang-nga,0,69,268719,134080,134639,8721,8100,621,,,19/1/2022 7:23
23/5/2021,Phatthalung,1,416,523135,254907,268228,1911,1911,0,,,19/1/2022 7:23
23/5/2021,Phichit,2,147,531511,259350,272161,7231,7231,0,,,19/1/2022 7:23
23/5/2021,Phitsanulok,0,323,847403,414611,432792,30519,30433,86,,,19/1/2022 7:23
23/5/2021,Phuket,4,844,414526,195824,218702,5291,4766,525,60,30,19/1/2022 7:23
23/5/2021,Maha Sarakham,10,339,951267,466548,484719,4341,4341,0,,,19/1/2022 7:23
23/5/2021,Mukdahan,0,41,351099,175412,175687,6784,6784,0,,,19/1/2022 7:23
23/5/2021,Yala,20,408,540317,268883,271434,2178,2178,0,48,31,19/1/2022 7:23
23/5/2021,Yasothon,3,128,534080,266625,267455,952,952,0,,,19/1/2022 7:23
23/5/2021,Ranong,13,708,194750,98304,96446,1678,1678,0,,,19/1/2022 7:23
23/5/2021,Rayong,6,1491,746202,366668,379534,22710,22497,213,43,34,19/1/2022 7:23
23/5/2021,Ratchaburi,29,718,869157,422653,446504,7378,7378,0,,,19/1/2022 7:23
23/5/2021,Roi Et,9,257,1297760,643167,654593,6265,6265,0,,,19/1/2022 7:23
23/5/2021,Lop Buri,0,267,739849,368410,371439,10549,10510,39,,,19/1/2022 7:23
23/5/2021,Lampang,0,264,727262,354467,372795,9481,9078,403,33,21,19/1/2022 7:23
23/5/2021,Lamphun,0,300,401851,193249,208602,8607,8482,125,,,19/1/2022 7:23
23/5/2021,Si Sa Ket,3,342,1457888,725954,731934,3439,3439,0,,,19/1/2022 7:23
23/5/2021,Sakon Nakhon,4,119,1147056,570138,576918,3867,3867,0,,,19/1/2022 7:23
23/5/2021,Songkhla,59,1391,1429188,696564,732624,2754,2723,31,74,35,19/1/2022 7:23
23/5/2021,Satun,0,45,324400,161412,162988,5525,5489,36,32,18,19/1/2022 7:23
23/5/2021,Samut Prakarn,181,6113,1354816,645683,709133,3744,3666,78,,,19/1/2022 7:23
23/5/2021,Samut Songkhram,6,208,191777,91661,100116,13850,13794,56,21,14,19/1/2022 7:23
23/5/2021,Samut Sakhon,38,19295,586821,282842,303979,1725,1725,0,51,30,19/1/2022 7:23
23/5/2021,Saraburi,9,367,643778,316334,327444,17834,17781,53,51,47,19/1/2022 7:23
23/5/2021,Sa kaeo,1,662,561072,279991,281081,3712,3712,0,22,19,19/1/2022 7:23
23/5/2021,Sing Buri,1,108,205391,97605,107786,3742,3742,0,,,19/1/2022 7:23
23/5/2021,Suphan Buri,2,417,837411,404175,433236,12597,12597,0,,,19/1/2022 7:23
23/5/2021,Surat Thani,30,1591,1068431,526206,542225,3429,3408,21,76,36,19/1/2022 7:23
23/5/2021,Surin,4,168,1377702,685565,692137,8806,8806,0,,,19/1/2022 7:23
23/5/2021,Sukhothai,0,113,586803,284381,302422,4869,4747,122,,,19/1/2022 7:23
23/5/2021,Nong Khai,2,77,517275,256665,260610,13264,13246,18,24,9,19/1/2022 7:23
23/5/2021,Nong Bua Lam Phu,0,40,509382,254164,255218,2186,2186,0,,,19/1/2022 7:23
23/5/2021,Amnat Charoen,2,54,376342,187394,188948,1140,1140,0,,,19/1/2022 7:23
23/5/2021,Udon Thani,1,460,1567699,776819,790880,11676,11669,7,,,19/1/2022 7:23
23/5/2021,Uttaradit,0,88,447682,218270,229412,8216,8216,0,,,19/1/2022 7:23
23/5/2021,Uthai Thani,3,33,325555,159138,166417,2668,2668,0,,,19/1/2022 7:23
23/5/2021,Ubon Ratchathani,2,358,1867034,932378,934656,17785,17785,0,47,16,19/1/2022 7:23
23/5/2021,Ang Thong,0,299,275934,132137,143797,2679,2679,0,,,19/1/2022 7:23
23/5/2021,Chiang Rai,7,644,1296741,630516,666225,33777,33431,346,91,21,19/1/2022 7:23
23/5/2021,Chiang Mai,4,8024,1785286,862939,922347,97868,95795,2073,54,20,19/1/2022 7:23
23/5/2021,Phetchaburi,968,2420,482261,232800,249461,48502,48311,191,,,19/1/2022 7:23
23/5/2021,Phetchabun,3,151,980259,483622,496637,30774,30774,0,,,19/1/2022 7:23
23/5/2021,Loei,0,96,638528,320030,318498,6303,6296,7,47,25,19/1/2022 7:23
23/5/2021,Phrae,1,84,436092,210253,225839,7717,7717,0,53,18,19/1/2022 7:23
23/5/2021,Mae Hong Son,0,54,285641,144762,140879,13138,12870,268, ,5,19/1/2022 7:23
23/5/2021,,0,153,,,,,,,,,19/1/2022 7:23
24/5/2021,Krabi,0,310,478425,237576,240849,2222,2082,140,,,19/1/2022 7:23
24/5/2021,Bangkok,1034,49644,5565337,2611984,2953353,353401,323907,29494,48,26,19/1/2022 7:23
24/5/2021,Kanchanaburi,3,320,892304,447427,444877,38060,37817,243,31,12,19/1/2022 7:23
24/5/2021,Kalasin,0,105,977098,483228,493870,2258,2258,0,,,19/1/2022 7:23
24/5/2021,Kamphaeng Phet,0,140,713612,352508,361104,8775,8775,0,,,19/1/2022 7:23
24/5/2021,Khon Kaen,0,508,1793078,881616,911462,46729,46690,39,68,28,19/1/2022 7:23
24/5/2021,Chanthaburi,10,991,535709,261994,273715,22331,22275,56,,,19/1/2022 7:23
24/5/2021,Chachoengsao,53,920,721880,353941,367939,5688,5688,0,40,36,19/1/2022 7:23
24/5/2021,Chon Buri,107,5841,1572844,766647,806197,29860,29153,707,40,32,19/1/2022 7:23
24/5/2021,Chai Nat,0,90,321640,154663,166977,5843,5843,0,,,19/1/2022 7:23
24/5/2021,Chaiyaphum,2,292,1124135,555470,568665,7737,7725,12,,,19/1/2022 7:23
24/5/2021,Chumphon,0,123,509660,251522,258138,1501,1501,0,,,19/1/2022 7:23
24/5/2021,Trang,3,342,640335,313195,327140,1786,1786,0,,,19/1/2022 7:23
24/5/2021,Trat,1,158,228577,113056,115521,25099,24970,129,,,19/1/2022 7:23
24/5/2021,Tak,14,552,673504,340558,332946,19138,19115,23,,,19/1/2022 7:23
24/5/2021,Nakhon Nayok,15,239,259663,128076,131587,7533,7533,0,,,19/1/2022 7:23
24/5/2021,Nakhon Pathom,28,1318,922477,443242,479235,13279,13263,16,31,18,19/1/2022 7:23
24/5/2021,Nakhon Phanom,0,138,717008,357388,359620,4972,4963,9,,,19/1/2022 7:23
24/5/2021,Nakhon Ratchasima,11,900,2633898,1294636,1339262,95155,94599,556,48,19,19/1/2022 7:23
24/5/2021,Nakhon Si Thammarat,11,830,1550685,765026,785659,7956,7956,0,,,19/1/2022 7:23
24/5/2021,Nakhon Sawan,1,463,1038321,506625,531696,21893,21893,0,45,26,19/1/2022 7:23
24/5/2021,Nonthaburi,172,7590,1282168,596750,685418,3634,3613,21,27,14,19/1/2022 7:23
24/5/2021,Narathiwat,6,776,807640,399607,408033,1063,1063,0,53,29,19/1/2022 7:23
24/5/2021,Nan,0,119,476276,238368,237908,6955,6876,79,,,19/1/2022 7:23
24/5/2021,Bueng Kan,0,27,422395,211815,210580,2107,2107,0,,,19/1/2022 7:23
24/5/2021,Buri Ram,3,199,1580600,784622,795978,19949,19899,50,,,19/1/2022 7:23
24/5/2021,Pathum Thani,38,3826,1181742,559988,621754,2265,2237,28,27,14,19/1/2022 7:23
24/5/2021,Prachuap Khiri Khan,10,1597,550568,272298,278270,51821,51734,87,,,19/1/2022 7:23
24/5/2021,Prachin Buri,1,380,494216,244010,250206,5966,5966,0,56,32,19/1/2022 7:23
24/5/2021,Pattani,5,396,727981,359468,368513,1288,1288,0,,,19/1/2022 7:23
24/5/2021,Phra Nakhon Si Ayutthaya,18,1122,819893,393933,425960,61595,61233,362,22,38,19/1/2022 7:23
24/5/2021,Phayao,0,96,466006,226859,239147,11143,11122,21,34,13,19/1/2022 7:23
24/5/2021,Phang-nga,0,69,268719,134080,134639,8721,8100,621,,,19/1/2022 7:23
24/5/2021,Phatthalung,0,416,523135,254907,268228,1911,1911,0,,,19/1/2022 7:23
24/5/2021,Phichit,1,148,531511,259350,272161,7231,7231,0,,,19/1/2022 7:23
24/5/2021,Phitsanulok,0,323,847403,414611,432792,30519,30433,86,,,19/1/2022 7:23
24/5/2021,Phuket,6,850,414526,195824,218702,5291,4766,525,59,32,19/1/2022 7:23
24/5/2021,Maha Sarakham,11,350,951267,466548,484719,4341,4341,0,,,19/1/2022 7:23
24/5/2021,Mukdahan,0,41,351099,175412,175687,6784,6784,0,,,19/1/2022 7:23
24/5/2021,Yala,18,426,540317,268883,271434,2178,2178,0,60,32,19/1/2022 7:23
24/5/2021,Yasothon,3,131,534080,266625,267455,952,952,0,,,19/1/2022 7:23
24/5/2021,Ranong,30,738,194750,98304,96446,1678,1678,0,,,19/1/2022 7:23
24/5/2021,Rayong,11,1502,746202,366668,379534,22710,22497,213,45,27,19/1/2022 7:23
24/5/2021,Ratchaburi,22,740,869157,422653,446504,7378,7378,0,,,19/1/2022 7:23
24/5/2021,Roi Et,2,259,1297760,643167,654593,6265,6265,0,,,19/1/2022 7:23
24/5/2021,Lop Buri,1,268,739849,368410,371439,10549,10510,39,,,19/1/2022 7:23
24/5/2021,Lampang,0,264,727262,354467,372795,9481,9078,403,30,19,19/1/2022 7:23
24/5/2021,Lamphun,0,300,401851,193249,208602,8607,8482,125,,,19/1/2022 7:23
24/5/2021,Si Sa Ket,20,362,1457888,725954,731934,3439,3439,0,,,19/1/2022 7:23
24/5/2021,Sakon Nakhon,2,121,1147056,570138,576918,3867,3867,0,,,19/1/2022 7:23
24/5/2021,Songkhla,36,1427,1429188,696564,732624,2754,2723,31,60,32,19/1/2022 7:23
24/5/2021,Satun,0,45,324400,161412,162988,5525,5489,36,34,21,19/1/2022 7:23
24/5/2021,Samut Prakarn,186,6299,1354816,645683,709133,3744,3666,78,,,19/1/2022 7:23
24/5/2021,Samut Songkhram,9,217,191777,91661,100116,13850,13794,56,27,14,19/1/2022 7:23
24/5/2021,Samut Sakhon,43,19338,586821,282842,303979,1725,1725,0,51,36,19/1/2022 7:23
24/5/2021,Saraburi,12,379,643778,316334,327444,17834,17781,53,50,70,19/1/2022 7:23
24/5/2021,Sa kaeo,43,705,561072,279991,281081,3712,3712,0,30,13,19/1/2022 7:23
24/5/2021,Sing Buri,6,114,205391,97605,107786,3742,3742,0,,,19/1/2022 7:23
24/5/2021,Suphan Buri,2,419,837411,404175,433236,12597,12597,0,,,19/1/2022 7:23
24/5/2021,Surat Thani,15,1606,1068431,526206,542225,3429,3408,21,75,37,19/1/2022 7:23
24/5/2021,Surin,0,168,1377702,685565,692137,8806,8806,0,,,19/1/2022 7:23
24/5/2021,Sukhothai,1,114,586803,284381,302422,4869,4747,122,,,19/1/2022 7:23
24/5/2021,Nong Khai,0,77,517275,256665,260610,13264,13246,18,23,9,19/1/2022 7:23
24/5/2021,Nong Bua Lam Phu,3,43,509382,254164,255218,2186,2186,0,,,19/1/2022 7:23
24/5/2021,Amnat Charoen,0,54,376342,187394,188948,1140,1140,0,,,19/1/2022 7:23
24/5/2021,Udon Thani,2,462,1567699,776819,790880,11676,11669,7,,,19/1/2022 7:23
24/5/2021,Uttaradit,0,88,447682,218270,229412,8216,8216,0,,,19/1/2022 7:23
24/5/2021,Uthai Thani,0,33,325555,159138,166417,2668,2668,0,,,19/1/2022 7:23
24/5/2021,Ubon Ratchathani,1,359,1867034,932378,934656,17785,17785,0,36,14,19/1/2022 7:23
24/5/2021,Ang Thong,0,299,275934,132137,143797,2679,2679,0,,,19/1/2022 7:23
24/5/2021,Chiang Rai,4,648,1296741,630516,666225,33777,33431,346,59,14,19/1/2022 7:23
24/5/2021,Chiang Mai,8,8032,1785286,862939,922347,97868,95795,2073,45,24,19/1/2022 7:23
24/5/2021,Phetchaburi,669,3089,482261,232800,249461,48502,48311,191,,,19/1/2022 7:23
24/5/2021,Phetchabun,0,151,980259,483622,496637,30774,30774,0,,,19/1/2022 7:23
24/5/2021,Loei,0,96,638528,320030,318498,6303,6296,7,48,18,19/1/2022 7:23
24/5/2021,Phrae,0,84,436092,210253,225839,7717,7717,0,49,13,19/1/2022 7:23
24/5/2021,Mae Hong Son,0,54,285641,144762,140879,13138,12870,268,20,8,19/1/2022 7:23
24/5/2021,,0,153,,,,,,,,,19/1/2022 7:23
25/5/2021,Krabi,3,313,478425,237576,240849,2222,2082,140,,,19/1/2022 7:23
25/5/2021,Bangkok,1752,51396,5565337,2611984,2953353,353401,323907,29494,43,25,19/1/2022 7:23
25/5/2021,Kanchanaburi,4,324,892304,447427,444877,38060,37817,243,32,13,19/1/2022 7:23
25/5/2021,Kalasin,0,105,977098,483228,493870,2258,2258,0,,,19/1/2022 7:23
25/5/2021,Kamphaeng Phet,0,140,713612,352508,361104,8775,8775,0,,,19/1/2022 7:23
25/5/2021,Khon Kaen,3,511,1793078,881616,911462,46729,46690,39,55,30,19/1/2022 7:23
25/5/2021,Chanthaburi,8,999,535709,261994,273715,22331,22275,56,,,19/1/2022 7:23
25/5/2021,Chachoengsao,25,945,721880,353941,367939,5688,5688,0,45,36,19/1/2022 7:23
25/5/2021,Chon Buri,43,5884,1572844,766647,806197,29860,29153,707,42,24,19/1/2022 7:23
25/5/2021,Chai Nat,0,90,321640,154663,166977,5843,5843,0,,,19/1/2022 7:23
25/5/2021,Chaiyaphum,13,305,1124135,555470,568665,7737,7725,12,,,19/1/2022 7:23
25/5/2021,Chumphon,0,123,509660,251522,258138,1501,1501,0,,,19/1/2022 7:23
25/5/2021,Trang,1,343,640335,313195,327140,1786,1786,0,,,19/1/2022 7:23
25/5/2021,Trat,0,158,228577,113056,115521,25099,24970,129,,,19/1/2022 7:23
25/5/2021,Tak,3,555,673504,340558,332946,19138,19115,23,,,19/1/2022 7:23
25/5/2021,Nakhon Nayok,2,241,259663,128076,131587,7533,7533,0,,,19/1/2022 7:23
25/5/2021,Nakhon Pathom,19,1337,922477,443242,479235,13279,13263,16,34,20,19/1/2022 7:23
25/5/2021,Nakhon Phanom,0,138,717008,357388,359620,4972,4963,9,,,19/1/2022 7:23
25/5/2021,Nakhon Ratchasima,12,912,2633898,1294636,1339262,95155,94599,556,45,30,19/1/2022 7:23
25/5/2021,Nakhon Si Thammarat,10,840,1550685,765026,785659,7956,7956,0,,,19/1/2022 7:23
25/5/2021,Nakhon Sawan,1,464,1038321,506625,531696,21893,21893,0,51,31,19/1/2022 7:23
25/5/2021,Nonthaburi,590,8180,1282168,596750,685418,3634,3613,21,29,18,19/1/2022 7:23
25/5/2021,Narathiwat,55,831,807640,399607,408033,1063,1063,0,65,25,19/1/2022 7:23
25/5/2021,Nan,1,120,476276,238368,237908,6955,6876,79,,,19/1/2022 7:23
25/5/2021,Bueng Kan,0,27,422395,211815,210580,2107,2107,0,,,19/1/2022 7:23
25/5/2021,Buri Ram,1,200,1580600,784622,795978,19949,19899,50,,,19/1/2022 7:23
25/5/2021,Pathum Thani,66,3892,1181742,559988,621754,2265,2237,28,29,16,19/1/2022 7:23
25/5/2021,Prachuap Khiri Khan,23,1620,550568,272298,278270,51821,51734,87,,,19/1/2022 7:23
25/5/2021,Prachin Buri,14,394,494216,244010,250206,5966,5966,0,67,28,19/1/2022 7:23
25/5/2021,Pattani,13,409,727981,359468,368513,1288,1288,0,,,19/1/2022 7:23
25/5/2021,Phra Nakhon Si Ayutthaya,29,1151,819893,393933,425960,61595,61233,362,33,37,19/1/2022 7:23
25/5/2021,Phayao,0,96,466006,226859,239147,11143,11122,21,29,16,19/1/2022 7:23
25/5/2021,Phang-nga,0,69,268719,134080,134639,8721,8100,621,,,19/1/2022 7:23
25/5/2021,Phatthalung,0,416,523135,254907,268228,1911,1911,0,,,19/1/2022 7:23
25/5/2021,Phichit,1,149,531511,259350,272161,7231,7231,0,,,19/1/2022 7:23
25/5/2021,Phitsanulok,0,323,847403,414611,432792,30519,30433,86,,,19/1/2022 7:23
25/5/2021,Phuket,4,854,414526,195824,218702,5291,4766,525,57,24,19/1/2022 7:23
25/5/2021,Maha Sarakham,2,352,951267,466548,484719,4341,4341,0,,,19/1/2022 7:23
25/5/2021,Mukdahan,0,41,351099,175412,175687,6784,6784,0,,,19/1/2022 7:23
25/5/2021,Yala,15,441,540317,268883,271434,2178,2178,0,61,25,19/1/2022 7:23
25/5/2021,Yasothon,3,134,534080,266625,267455,952,952,0,,,19/1/2022 7:23
25/5/2021,Ranong,12,750,194750,98304,96446,1678,1678,0,,,19/1/2022 7:23
25/5/2021,Rayong,3,1505,746202,366668,379534,22710,22497,213,42,28,19/1/2022 7:23
25/5/2021,Ratchaburi,25,765,869157,422653,446504,7378,7378,0,,,19/1/2022 7:23
25/5/2021,Roi Et,1,260,1297760,643167,654593,6265,6265,0,,,19/1/2022 7:23
25/5/2021,Lop Buri,1,269,739849,368410,371439,10549,10510,39,,,19/1/2022 7:23
25/5/2021,Lampang,1,265,727262,354467,372795,9481,9078,403,28,27,19/1/2022 7:23
25/5/2021,Lamphun,0,300,401851,193249,208602,8607,8482,125,,,19/1/2022 7:23
25/5/2021,Si Sa Ket,2,364,1457888,725954,731934,3439,3439,0,,,19/1/2022 7:23
25/5/2021,Sakon Nakhon,0,121,1147056,570138,576918,3867,3867,0,,,19/1/2022 7:23
25/5/2021,Songkhla,6,1433,1429188,696564,732624,2754,2723,31,58,28,19/1/2022 7:23
25/5/2021,Satun,0,45,324400,161412,162988,5525,5489,36,46,18,19/1/2022 7:23
25/5/2021,Samut Prakarn,127,6426,1354816,645683,709133,3744,3666,78,,,19/1/2022 7:23
25/5/2021,Samut Songkhram,11,228,191777,91661,100116,13850,13794,56,30,15,19/1/2022 7:23
25/5/2021,Samut Sakhon,49,19387,586821,282842,303979,1725,1725,0,55,39,19/1/2022 7:23
25/5/2021,Saraburi,3,382,643778,316334,327444,17834,17781,53,68,57,19/1/2022 7:23
25/5/2021,Sa kaeo,2,707,561072,279991,281081,3712,3712,0,20,15,19/1/2022 7:23
25/5/2021,Sing Buri,0,114,205391,97605,107786,3742,3742,0,,,19/1/2022 7:23
25/5/2021,Suphan Buri,2,421,837411,404175,433236,12597,12597,0,,,19/1/2022 7:23
25/5/2021,Surat Thani,25,1631,1068431,526206,542225,3429,3408,21,120,29,19/1/2022 7:23
25/5/2021,Surin,0,168,1377702,685565,692137,8806,8806,0,,,19/1/2022 7:23
25/5/2021,Sukhothai,0,114,586803,284381,302422,4869,4747,122,,,19/1/2022 7:23
25/5/2021,Nong Khai,0,77,517275,256665,260610,13264,13246,18,20,7,19/1/2022 7:23
25/5/2021,Nong Bua Lam Phu,0,43,509382,254164,255218,2186,2186,0,,,19/1/2022 7:23
25/5/2021,Amnat Charoen,0,54,376342,187394,188948,1140,1140,0,,,19/1/2022 7:23
25/5/2021,Udon Thani,5,467,1567699,776819,790880,11676,11669,7,,,19/1/2022 7:23
25/5/2021,Uttaradit,0,88,447682,218270,229412,8216,8216,0,,,19/1/2022 7:23
25/5/2021,Uthai Thani,0,33,325555,159138,166417,2668,2668,0,,,19/1/2022 7:23
25/5/2021,Ubon Ratchathani,1,360,1867034,932378,934656,17785,17785,0,34,15,19/1/2022 7:23
25/5/2021,Ang Thong,0,299,275934,132137,143797,2679,2679,0,,,19/1/2022 7:23
25/5/2021,Chiang Rai,4,652,1296741,630516,666225,33777,33431,346,43,17,19/1/2022 7:23
25/5/2021,Chiang Mai,0,8032,1785286,862939,922347,97868,95795,2073,57,29,19/1/2022 7:23
25/5/2021,Phetchaburi,227,3316,482261,232800,249461,48502,48311,191,,,19/1/2022 7:23
25/5/2021,Phetchabun,3,154,980259,483622,496637,30774,30774,0,,,19/1/2022 7:23
25/5/2021,Loei,0,96,638528,320030,318498,6303,6296,7,20,24,19/1/2022 7:23
25/5/2021,Phrae,0,84,436092,210253,225839,7717,7717,0,38,18,19/1/2022 7:23
25/5/2021,Mae Hong Son,0,54,285641,144762,140879,13138,12870,268,31,21,19/1/2022 7:23
25/5/2021,,0,153,,,,,,,,,19/1/2022 7:23
26/5/2021,Krabi,2,315,478425,237576,240849,2222,2082,140,,,19/1/2022 7:23
26/5/2021,Bangkok,1418,52814,5565337,2611984,2953353,353401,323907,29494,56,30,19/1/2022 7:23
26/5/2021,Kanchanaburi,2,326,892304,447427,444877,38060,37817,243,35,15,19/1/2022 7:23
26/5/2021,Kalasin,2,107,977098,483228,493870,2258,2258,0,,,19/1/2022 7:23
26/5/2021,Kamphaeng Phet,0,140,713612,352508,361104,8775,8775,0,,,19/1/2022 7:23
26/5/2021,Khon Kaen,2,513,1793078,881616,911462,46729,46690,39,59,39,19/1/2022 7:23
26/5/2021,Chanthaburi,11,1010,535709,261994,273715,22331,22275,56,,,19/1/2022 7:23
26/5/2021,Chachoengsao,38,983,721880,353941,367939,5688,5688,0,49,35,19/1/2022 7:23
26/5/2021,Chon Buri,43,5927,1572844,766647,806197,29860,29153,707,41,31,19/1/2022 7:23
26/5/2021,Chai Nat,0,90,321640,154663,166977,5843,5843,0,,,19/1/2022 7:23
26/5/2021,Chaiyaphum,2,307,1124135,555470,568665,7737,7725,12,,,19/1/2022 7:23
26/5/2021,Chumphon,1,124,509660,251522,258138,1501,1501,0,,,19/1/2022 7:23
26/5/2021,Trang,3,346,640335,313195,327140,1786,1786,0,,,19/1/2022 7:23
26/5/2021,Trat,0,158,228577,113056,115521,25099,24970,129,,,19/1/2022 7:23
26/5/2021,Tak,30,585,673504,340558,332946,19138,19115,23,,,19/1/2022 7:23
26/5/2021,Nakhon Nayok,5,246,259663,128076,131587,7533,7533,0,,,19/1/2022 7:23
26/5/2021,Nakhon Pathom,13,1350,922477,443242,479235,13279,13263,16,43,21,19/1/2022 7:23
26/5/2021,Nakhon Phanom,2,140,717008,357388,359620,4972,4963,9,,,19/1/2022 7:23
26/5/2021,Nakhon Ratchasima,20,932,2633898,1294636,1339262,95155,94599,556,67,29,19/1/2022 7:23
26/5/2021,Nakhon Si Thammarat,5,845,1550685,765026,785659,7956,7956,0,,,19/1/2022 7:23
26/5/2021,Nakhon Sawan,2,466,1038321,506625,531696,21893,21893,0,61,27,19/1/2022 7:23
26/5/2021,Nonthaburi,122,8302,1282168,596750,685418,3634,3613,21,35,22,19/1/2022 7:23
26/5/2021,Narathiwat,17,848,807640,399607,408033,1063,1063,0,56,21,19/1/2022 7:23
26/5/2021,Nan,1,121,476276,238368,237908,6955,6876,79,,,19/1/2022 7:23
26/5/2021,Bueng Kan,0,27,422395,211815,210580,2107,2107,0,,,19/1/2022 7:23
26/5/2021,Buri Ram,1,201,1580600,784622,795978,19949,19899,50,,,19/1/2022 7:23
26/5/2021,Pathum Thani,61,3953,1181742,559988,621754,2265,2237,28,48,19,19/1/2022 7:23
26/5/2021,Prachuap Khiri Khan,15,1635,550568,272298,278270,51821,51734,87,,,19/1/2022 7:23
26/5/2021,Prachin Buri,2,396,494216,244010,250206,5966,5966,0,61,21,19/1/2022 7:23
26/5/2021,Pattani,7,416,727981,359468,368513,1288,1288,0,,,19/1/2022 7:23
26/5/2021,Phra Nakhon Si Ayutthaya,16,1167,819893,393933,425960,61595,61233,362,41,45,19/1/2022 7:23
26/5/2021,Phayao,2,98,466006,226859,239147,11143,11122,21,39,26,19/1/2022 7:23
26/5/2021,Phang-nga,0,69,268719,134080,134639,8721,8100,621,,,19/1/2022 7:23
26/5/2021,Phatthalung,12,428,523135,254907,268228,1911,1911,0,,,19/1/2022 7:23
26/5/2021,Phichit,0,149,531511,259350,272161,7231,7231,0,,,19/1/2022 7:23
26/5/2021,Phitsanulok,0,323,847403,414611,432792,30519,30433,86,,,19/1/2022 7:23
26/5/2021,Phuket,5,859,414526,195824,218702,5291,4766,525,54,32,19/1/2022 7:23
26/5/2021,Maha Sarakham,2,354,951267,466548,484719,4341,4341,0,,,19/1/2022 7:23
26/5/2021,Mukdahan,0,41,351099,175412,175687,6784,6784,0,,,19/1/2022 7:23
26/5/2021,Yala,8,449,540317,268883,271434,2178,2178,0,57,19,19/1/2022 7:23
26/5/2021,Yasothon,4,138,534080,266625,267455,952,952,0,,,19/1/2022 7:23
26/5/2021,Ranong,5,755,194750,98304,96446,1678,1678,0,,,19/1/2022 7:23
26/5/2021,Rayong,18,1523,746202,366668,379534,22710,22497,213,44,25,19/1/2022 7:23
26/5/2021,Ratchaburi,6,771,869157,422653,446504,7378,7378,0,,,19/1/2022 7:23
26/5/2021,Roi Et,0,260,1297760,643167,654593,6265,6265,0,,,19/1/2022 7:23
26/5/2021,Lop Buri,1,270,739849,368410,371439,10549,10510,39,,,19/1/2022 7:23
26/5/2021,Lampang,1,266,727262,354467,372795,9481,9078,403,46,28,19/1/2022 7:23
26/5/2021,Lamphun,2,302,401851,193249,208602,8607,8482,125,,,19/1/2022 7:23
26/5/2021,Si Sa Ket,6,370,1457888,725954,731934,3439,3439,0,,,19/1/2022 7:23
26/5/2021,Sakon Nakhon,1,122,1147056,570138,576918,3867,3867,0,,,19/1/2022 7:23
26/5/2021,Songkhla,58,1491,1429188,696564,732624,2754,2723,31,53,28,19/1/2022 7:23
26/5/2021,Satun,1,46,324400,161412,162988,5525,5489,36,27,9,19/1/2022 7:23
26/5/2021,Samut Prakarn,100,6526,1354816,645683,709133,3744,3666,78,,,19/1/2022 7:23
26/5/2021,Samut Songkhram,4,232,191777,91661,100116,13850,13794,56,34,15,19/1/2022 7:23
26/5/2021,Samut Sakhon,21,19408,586821,282842,303979,1725,1725,0,75,35,19/1/2022 7:23
26/5/2021,Saraburi,16,398,643778,316334,327444,17834,17781,53,65,52,19/1/2022 7:23
26/5/2021,Sa kaeo,15,722,561072,279991,281081,3712,3712,0,24,12,19/1/2022 7:23
26/5/2021,Sing Buri,2,116,205391,97605,107786,3742,3742,0,,,19/1/2022 7:23
26/5/2021,Suphan Buri,9,430,837411,404175,433236,12597,12597,0,,,19/1/2022 7:23
26/5/2021,Surat Thani,24,1655,1068431,526206,542225,3429,3408,21,71,33,19/1/2022 7:23
26/5/2021,Surin,0,168,1377702,685565,692137,8806,8806,0,,,19/1/2022 7:23
26/5/2021,Sukhothai,1,115,586803,284381,302422,4869,4747,122,,,19/1/2022 7:23
26/5/2021,Nong Khai,0,77,517275,256665,260610,13264,13246,18,18,7,19/1/2022 7:23
26/5/2021,Nong Bua Lam Phu,2,45,509382,254164,255218,2186,2186,0,,,19/1/2022 7:23
26/5/2021,Amnat Charoen,0,54,376342,187394,188948,1140,1140,0,,,19/1/2022 7:23
26/5/2021,Udon Thani,3,470,1567699,776819,790880,11676,11669,7,,,19/1/2022 7:23
26/5/2021,Uttaradit,0,88,447682,218270,229412,8216,8216,0,,,19/1/2022 7:23
26/5/2021,Uthai Thani,1,34,325555,159138,166417,2668,2668,0,,,19/1/2022 7:23
26/5/2021,Ubon Ratchathani,2,362,1867034,932378,934656,17785,17785,0,38,15,19/1/2022 7:23
26/5/2021,Ang Thong,0,299,275934,132137,143797,2679,2679,0,,,19/1/2022 7:23
26/5/2021,Chiang Rai,5,657,1296741,630516,666225,33777,33431,346,48,20,19/1/2022 7:23
26/5/2021,Chiang Mai,12,8044,1785286,862939,922347,97868,95795,2073,67,34,19/1/2022 7:23
26/5/2021,Phetchaburi,259,3575,482261,232800,249461,48502,48311,191,,,19/1/2022 7:23
26/5/2021,Phetchabun,0,154,980259,483622,496637,30774,30774,0,,,19/1/2022 7:23
26/5/2021,Loei,1,97,638528,320030,318498,6303,6296,7,47,28,19/1/2022 7:23
26/5/2021,Phrae,3,87,436092,210253,225839,7717,7717,0,53,27,19/1/2022 7:23
26/5/2021,Mae Hong Son,0,54,285641,144762,140879,13138,12870,268,72,24,19/1/2022 7:23
26/5/2021,,0,153,,,,,,,,,19/1/2022 7:23
27/5/2021,Krabi,1,316,478425,237576,240849,2222,2082,140,,,19/1/2022 7:23
27/5/2021,Bangkok,2058,54872,5565337,2611984,2953353,353401,323907,29494,66,23,19/1/2022 7:23
27/5/2021,Kanchanaburi,2,328,892304,447427,444877,38060,37817,243,40,10,19/1/2022 7:23
27/5/2021,Kalasin,1,108,977098,483228,493870,2258,2258,0,,,19/1/2022 7:23
27/5/2021,Kamphaeng Phet,0,140,713612,352508,361104,8775,8775,0,,,19/1/2022 7:23
27/5/2021,Khon Kaen,3,516,1793078,881616,911462,46729,46690,39,71,34,19/1/2022 7:23
27/5/2021,Chanthaburi,5,1015,535709,261994,273715,22331,22275,56,,,19/1/2022 7:23
27/5/2021,Chachoengsao,49,1032,721880,353941,367939,5688,5688,0,57,28,19/1/2022 7:23
27/5/2021,Chon Buri,52,5979,1572844,766647,806197,29860,29153,707,53,29,19/1/2022 7:23
27/5/2021,Chai Nat,0,90,321640,154663,166977,5843,5843,0,,,19/1/2022 7:23
27/5/2021,Chaiyaphum,5,312,1124135,555470,568665,7737,7725,12,,,19/1/2022 7:23
27/5/2021,Chumphon,1,125,509660,251522,258138,1501,1501,0,,,19/1/2022 7:23
27/5/2021,Trang,0,346,640335,313195,327140,1786,1786,0,,,19/1/2022 7:23
27/5/2021,Trat,0,158,228577,113056,115521,25099,24970,129,,,19/1/2022 7:23
27/5/2021,Tak,0,585,673504,340558,332946,19138,19115,23,,,19/1/2022 7:23
27/5/2021,Nakhon Nayok,3,249,259663,128076,131587,7533,7533,0,,,19/1/2022 7:23
27/5/2021,Nakhon Pathom,35,1385,922477,443242,479235,13279,13263,16,45,19,19/1/2022 7:23
27/5/2021,Nakhon Phanom,0,140,717008,357388,359620,4972,4963,9,,,19/1/2022 7:23
27/5/2021,Nakhon Ratchasima,12,944,2633898,1294636,1339262,95155,94599,556,66,26,19/1/2022 7:23
27/5/2021,Nakhon Si Thammarat,5,850,1550685,765026,785659,7956,7956,0,,,19/1/2022 7:23
27/5/2021,Nakhon Sawan,1,467,1038321,506625,531696,21893,21893,0,51,29,19/1/2022 7:23
27/5/2021,Nonthaburi,129,8431,1282168,596750,685418,3634,3613,21,44,17,19/1/2022 7:23
27/5/2021,Narathiwat,14,862,807640,399607,408033,1063,1063,0,42,22,19/1/2022 7:23
27/5/2021,Nan,0,121,476276,238368,237908,6955,6876,79,,,19/1/2022 7:23
27/5/2021,Bueng Kan,0,27,422395,211815,210580,2107,2107,0,,,19/1/2022 7:23
27/5/2021,Buri Ram,1,202,1580600,784622,795978,19949,19899,50,,,19/1/2022 7:23
27/5/2021,Pathum Thani,98,4051,1181742,559988,621754,2265,2237,28,54,26,19/1/2022 7:23
27/5/2021,Prachuap Khiri Khan,10,1645,550568,272298,278270,51821,51734,87,,,19/1/2022 7:23
27/5/2021,Prachin Buri,1,397,494216,244010,250206,5966,5966,0,53,21,19/1/2022 7:23
27/5/2021,Pattani,4,420,727981,359468,368513,1288,1288,0,,,19/1/2022 7:23
27/5/2021,Phra Nakhon Si Ayutthaya,24,1191,819893,393933,425960,61595,61233,362,54,33,19/1/2022 7:23
27/5/2021,Phayao,0,98,466006,226859,239147,11143,11122,21,53,19,19/1/2022 7:23
27/5/2021,Phang-nga,0,69,268719,134080,134639,8721,8100,621,,,19/1/2022 7:23
27/5/2021,Phatthalung,1,429,523135,254907,268228,1911,1911,0,,,19/1/2022 7:23
27/5/2021,Phichit,0,149,531511,259350,272161,7231,7231,0,,,19/1/2022 7:23
27/5/2021,Phitsanulok,0,323,847403,414611,432792,30519,30433,86,,,19/1/2022 7:23
27/5/2021,Phuket,6,865,414526,195824,218702,5291,4766,525,61,22,19/1/2022 7:23
27/5/2021,Maha Sarakham,3,357,951267,466548,484719,4341,4341,0,,,19/1/2022 7:23
27/5/2021,Mukdahan,1,42,351099,175412,175687,6784,6784,0,,,19/1/2022 7:23
27/5/2021,Yala,3,452,540317,268883,271434,2178,2178,0,47,21,19/1/2022 7:23
27/5/2021,Yasothon,0,138,534080,266625,267455,952,952,0,,,19/1/2022 7:23
27/5/2021,Ranong,8,763,194750,98304,96446,1678,1678,0,,,19/1/2022 7:23
27/5/2021,Rayong,8,1531,746202,366668,379534,22710,22497,213,47,28,19/1/2022 7:23
27/5/2021,Ratchaburi,8,779,869157,422653,446504,7378,7378,0,,,19/1/2022 7:23
27/5/2021,Roi Et,3,263,1297760,643167,654593,6265,6265,0,,,19/1/2022 7:23
27/5/2021,Lop Buri,1,271,739849,368410,371439,10549,10510,39,,,19/1/2022 7:23
27/5/2021,Lampang,3,269,727262,354467,372795,9481,9078,403,48,29,19/1/2022 7:23
27/5/2021,Lamphun,2,304,401851,193249,208602,8607,8482,125,,,19/1/2022 7:23
27/5/2021,Si Sa Ket,12,382,1457888,725954,731934,3439,3439,0,,,19/1/2022 7:23
27/5/2021,Sakon Nakhon,1,123,1147056,570138,576918,3867,3867,0,,,19/1/2022 7:23
27/5/2021,Songkhla,31,1522,1429188,696564,732624,2754,2723,31,51,30,19/1/2022 7:23
27/5/2021,Satun,0,46,324400,161412,162988,5525,5489,36,20,12,19/1/2022 7:23
27/5/2021,Samut Prakarn,280,6806,1354816,645683,709133,3744,3666,78,,,19/1/2022 7:23
27/5/2021,Samut Songkhram,5,237,191777,91661,100116,13850,13794,56,34,12,19/1/2022 7:23
27/5/2021,Samut Sakhon,59,19467,586821,282842,303979,1725,1725,0,66,22,19/1/2022 7:23
27/5/2021,Saraburi,3,401,643778,316334,327444,17834,17781,53,66,72,19/1/2022 7:23
27/5/2021,Sa kaeo,22,744,561072,279991,281081,3712,3712,0,24,12,19/1/2022 7:23
27/5/2021,Sing Buri,1,117,205391,97605,107786,3742,3742,0,,,19/1/2022 7:23
27/5/2021,Suphan Buri,4,434,837411,404175,433236,12597,12597,0,,,19/1/2022 7:23
27/5/2021,Surat Thani,10,1665,1068431,526206,542225,3429,3408,21,70,33,19/1/2022 7:23
27/5/2021,Surin,3,171,1377702,685565,692137,8806,8806,0,,,19/1/2022 7:23
27/5/2021,Sukhothai,0,115,586803,284381,302422,4869,4747,122,,,19/1/2022 7:23
27/5/2021,Nong Khai,0,77,517275,256665,260610,13264,13246,18,18,9,19/1/2022 7:23
27/5/2021,Nong Bua Lam Phu,6,51,509382,254164,255218,2186,2186,0,,,19/1/2022 7:23
27/5/2021,Amnat Charoen,0,54,376342,187394,188948,1140,1140,0,,,19/1/2022 7:23
27/5/2021,Udon Thani,10,480,1567699,776819,790880,11676,11669,7,,,19/1/2022 7:23
27/5/2021,Uttaradit,0,88,447682,218270,229412,8216,8216,0,,,19/1/2022 7:23
27/5/2021,Uthai Thani,0,34,325555,159138,166417,2668,2668,0,,,19/1/2022 7:23
27/5/2021,Ubon Ratchathani,2,364,1867034,932378,934656,17785,17785,0,32,18,19/1/2022 7:23
27/5/2021,Ang Thong,0,299,275934,132137,143797,2679,2679,0,,,19/1/2022 7:23
27/5/2021,Chiang Rai,45,702,1296741,630516,666225,33777,33431,346,57,13,19/1/2022 7:23
27/5/2021,Chiang Mai,32,8076,1785286,862939,922347,97868,95795,2073,74,31,19/1/2022 7:23
27/5/2021,Phetchaburi,233,3808,482261,232800,249461,48502,48311,191,,,19/1/2022 7:23
27/5/2021,Phetchabun,1,155,980259,483622,496637,30774,30774,0,,,19/1/2022 7:23
27/5/2021,Loei,2,99,638528,320030,318498,6303,6296,7,55,23,19/1/2022 7:23
27/5/2021,Phrae,0,87,436092,210253,225839,7717,7717,0,62,18,19/1/2022 7:23
27/5/2021,Mae Hong Son,0,54,285641,144762,140879,13138,12870,268,79,27,19/1/2022 7:23
27/5/2021,,0,153,,,,,,,,,19/1/2022 7:23
28/5/2021,Krabi,6,322,478425,237576,240849,2222,2082,140,,,19/1/2022 7:23
28/5/2021,Bangkok,2170,57042,5565337,2611984,2953353,353401,323907,29494,49,20,19/1/2022 7:23
28/5/2021,Kanchanaburi,2,330,892304,447427,444877,38060,37817,243,29,15,19/1/2022 7:23
28/5/2021,Kalasin,0,108,977098,483228,493870,2258,2258,0,,,19/1/2022 7:23
28/5/2021,Kamphaeng Phet,0,140,713612,352508,361104,8775,8775,0,,,19/1/2022 7:23
28/5/2021,Khon Kaen,3,519,1793078,881616,911462,46729,46690,39,67,28,19/1/2022 7:23
28/5/2021,Chanthaburi,17,1032,535709,261994,273715,22331,22275,56,,,19/1/2022 7:23
28/5/2021,Chachoengsao,88,1120,721880,353941,367939,5688,5688,0,34,28,19/1/2022 7:23
28/5/2021,Chon Buri,42,6021,1572844,766647,806197,29860,29153,707,55,23,19/1/2022 7:23
28/5/2021,Chai Nat,2,92,321640,154663,166977,5843,5843,0,,,19/1/2022 7:23
28/5/2021,Chaiyaphum,0,312,1124135,555470,568665,7737,7725,12,,,19/1/2022 7:23
28/5/2021,Chumphon,0,125,509660,251522,258138,1501,1501,0,,,19/1/2022 7:23
28/5/2021,Trang,10,356,640335,313195,327140,1786,1786,0,,,19/1/2022 7:23
28/5/2021,Trat,0,158,228577,113056,115521,25099,24970,129,,,19/1/2022 7:23
28/5/2021,Tak,6,591,673504,340558,332946,19138,19115,23,,,19/1/2022 7:23
28/5/2021,Nakhon Nayok,1,250,259663,128076,131587,7533,7533,0,,,19/1/2022 7:23
28/5/2021,Nakhon Pathom,36,1421,922477,443242,479235,13279,13263,16,37,14,19/1/2022 7:23
28/5/2021,Nakhon Phanom,0,140,717008,357388,359620,4972,4963,9,,,19/1/2022 7:23
28/5/2021,Nakhon Ratchasima,11,955,2633898,1294636,1339262,95155,94599,556,58,21,19/1/2022 7:23
28/5/2021,Nakhon Si Thammarat,12,862,1550685,765026,785659,7956,7956,0,,,19/1/2022 7:23
28/5/2021,Nakhon Sawan,1,468,1038321,506625,531696,21893,21893,0,57,28,19/1/2022 7:23
28/5/2021,Nonthaburi,102,8533,1282168,596750,685418,3634,3613,21,34,14,19/1/2022 7:23
28/5/2021,Narathiwat,25,887,807640,399607,408033,1063,1063,0,44,20,19/1/2022 7:23
28/5/2021,Nan,0,121,476276,238368,237908,6955,6876,79,,,19/1/2022 7:23
28/5/2021,Bueng Kan,0,27,422395,211815,210580,2107,2107,0,,,19/1/2022 7:23
28/5/2021,Buri Ram,4,206,1580600,784622,795978,19949,19899,50,,,19/1/2022 7:23
28/5/2021,Pathum Thani,39,4090,1181742,559988,621754,2265,2237,28,63,15,19/1/2022 7:23
28/5/2021,Prachuap Khiri Khan,24,1669,550568,272298,278270,51821,51734,87,,,19/1/2022 7:23
28/5/2021,Prachin Buri,0,397,494216,244010,250206,5966,5966,0,52,21,19/1/2022 7:23
28/5/2021,Pattani,8,428,727981,359468,368513,1288,1288,0,,,19/1/2022 7:23
28/5/2021,Phra Nakhon Si Ayutthaya,32,1223,819893,393933,425960,61595,61233,362,44,32,19/1/2022 7:23
28/5/2021,Phayao,0,98,466006,226859,239147,11143,11122,21,43,19,19/1/2022 7:23
28/5/2021,Phang-nga,0,69,268719,134080,134639,8721,8100,621,,,19/1/2022 7:23
28/5/2021,Phatthalung,1,430,523135,254907,268228,1911,1911,0,,,19/1/2022 7:23
28/5/2021,Phichit,0,149,531511,259350,272161,7231,7231,0,,,19/1/2022 7:23
28/5/2021,Phitsanulok,0,323,847403,414611,432792,30519,30433,86,,,19/1/2022 7:23
28/5/2021,Phuket,2,867,414526,195824,218702,5291,4766,525,53,25,19/1/2022 7:23
28/5/2021,Maha Sarakham,0,357,951267,466548,484719,4341,4341,0,,,19/1/2022 7:23
28/5/2021,Mukdahan,0,42,351099,175412,175687,6784,6784,0,,,19/1/2022 7:23
28/5/2021,Yala,4,456,540317,268883,271434,2178,2178,0,47,22,19/1/2022 7:23
28/5/2021,Yasothon,0,138,534080,266625,267455,952,952,0,,,19/1/2022 7:23
28/5/2021,Ranong,9,772,194750,98304,96446,1678,1678,0,,,19/1/2022 7:23
28/5/2021,Rayong,1,1532,746202,366668,379534,22710,22497,213,40,29,19/1/2022 7:23
28/5/2021,Ratchaburi,6,785,869157,422653,446504,7378,7378,0,,,19/1/2022 7:23
28/5/2021,Roi Et,0,263,1297760,643167,654593,6265,6265,0,,,19/1/2022 7:23
28/5/2021,Lop Buri,2,273,739849,368410,371439,10549,10510,39,,,19/1/2022 7:23
28/5/2021,Lampang,1,270,727262,354467,372795,9481,9078,403,54,102,19/1/2022 7:23
28/5/2021,Lamphun,0,304,401851,193249,208602,8607,8482,125,,,19/1/2022 7:23
28/5/2021,Si Sa Ket,6,388,1457888,725954,731934,3439,3439,0,,,19/1/2022 7:23
28/5/2021,Sakon Nakhon,0,123,1147056,570138,576918,3867,3867,0,,,19/1/2022 7:23
28/5/2021,Songkhla,50,1572,1429188,696564,732624,2754,2723,31,55,29,19/1/2022 7:23
28/5/2021,Satun,0,46,324400,161412,162988,5525,5489,36,20,20,19/1/2022 7:23
28/5/2021,Samut Prakarn,227,7033,1354816,645683,709133,3744,3666,78,,,19/1/2022 7:23
28/5/2021,Samut Songkhram,4,241,191777,91661,100116,13850,13794,56,24,13,19/1/2022 7:23
28/5/2021,Samut Sakhon,55,19522,586821,282842,303979,1725,1725,0,48,24,19/1/2022 7:23
28/5/2021,Saraburi,21,422,643778,316334,327444,17834,17781,53,67,46,19/1/2022 7:23
28/5/2021,Sa kaeo,11,755,561072,279991,281081,3712,3712,0,18,10,19/1/2022 7:23
28/5/2021,Sing Buri,0,117,205391,97605,107786,3742,3742,0,,,19/1/2022 7:23
28/5/2021,Suphan Buri,6,440,837411,404175,433236,12597,12597,0,,,19/1/2022 7:23
28/5/2021,Surat Thani,17,1682,1068431,526206,542225,3429,3408,21,70,34,19/1/2022 7:23
28/5/2021,Surin,1,172,1377702,685565,692137,8806,8806,0,,,19/1/2022 7:23
28/5/2021,Sukhothai,3,118,586803,284381,302422,4869,4747,122,,,19/1/2022 7:23
28/5/2021,Nong Khai,0,77,517275,256665,260610,13264,13246,18,22,9,19/1/2022 7:23
28/5/2021,Nong Bua Lam Phu,1,52,509382,254164,255218,2186,2186,0,,,19/1/2022 7:23
28/5/2021,Amnat Charoen,0,54,376342,187394,188948,1140,1140,0,,,19/1/2022 7:23
28/5/2021,Udon Thani,6,486,1567699,776819,790880,11676,11669,7,,,19/1/2022 7:23
28/5/2021,Uttaradit,0,88,447682,218270,229412,8216,8216,0,,,19/1/2022 7:23
28/5/2021,Uthai Thani,0,34,325555,159138,166417,2668,2668,0,,,19/1/2022 7:23
28/5/2021,Ubon Ratchathani,1,365,1867034,932378,934656,17785,17785,0,40,20,19/1/2022 7:23
28/5/2021,Ang Thong,2,301,275934,132137,143797,2679,2679,0,,,19/1/2022 7:23
28/5/2021,Chiang Rai,3,705,1296741,630516,666225,33777,33431,346,38,17,19/1/2022 7:23
28/5/2021,Chiang Mai,19,8095,1785286,862939,922347,97868,95795,2073,73,27,19/1/2022 7:23
28/5/2021,Phetchaburi,658,4466,482261,232800,249461,48502,48311,191,,,19/1/2022 7:23
28/5/2021,Phetchabun,1,156,980259,483622,496637,30774,30774,0,,,19/1/2022 7:23
28/5/2021,Loei,0,99,638528,320030,318498,6303,6296,7,35,17,19/1/2022 7:23
28/5/2021,Phrae,0,87,436092,210253,225839,7717,7717,0,52,17,19/1/2022 7:23
28/5/2021,Mae Hong Son,0,54,285641,144762,140879,13138,12870,268,83,10,19/1/2022 7:23
28/5/2021,,0,153,,,,,,,,,19/1/2022 7:23
29/5/2021,Krabi,4,326,478425,237576,240849,2222,2082,140,,,19/1/2022 7:23
29/5/2021,Bangkok,1184,58226,5565337,2611984,2953353,353401,323907,29494,45,17,19/1/2022 7:23
29/5/2021,Kanchanaburi,2,332,892304,447427,444877,38060,37817,243,41,10,19/1/2022 7:23
29/5/2021,Kalasin,1,109,977098,483228,493870,2258,2258,0,,,19/1/2022 7:23
29/5/2021,Kamphaeng Phet,3,143,713612,352508,361104,8775,8775,0,,,19/1/2022 7:23
29/5/2021,Khon Kaen,15,534,1793078,881616,911462,46729,46690,39,61,31,19/1/2022 7:23
29/5/2021,Chanthaburi,9,1041,535709,261994,273715,22331,22275,56,,,19/1/2022 7:23
29/5/2021,Chachoengsao,141,1261,721880,353941,367939,5688,5688,0,29,30,19/1/2022 7:23
29/5/2021,Chon Buri,84,6105,1572844,766647,806197,29860,29153,707,38,20,19/1/2022 7:23
29/5/2021,Chai Nat,0,92,321640,154663,166977,5843,5843,0,,,19/1/2022 7:23
29/5/2021,Chaiyaphum,1,313,1124135,555470,568665,7737,7725,12,,,19/1/2022 7:23
29/5/2021,Chumphon,0,125,509660,251522,258138,1501,1501,0,,,19/1/2022 7:23
29/5/2021,Trang,37,393,640335,313195,327140,1786,1786,0,,,19/1/2022 7:23
29/5/2021,Trat,0,158,228577,113056,115521,25099,24970,129,,,19/1/2022 7:23
29/5/2021,Tak,13,604,673504,340558,332946,19138,19115,23,,,19/1/2022 7:23
29/5/2021,Nakhon Nayok,3,253,259663,128076,131587,7533,7533,0,,,19/1/2022 7:23
29/5/2021,Nakhon Pathom,26,1447,922477,443242,479235,13279,13263,16,37,14,19/1/2022 7:23
29/5/2021,Nakhon Phanom,0,140,717008,357388,359620,4972,4963,9,,,19/1/2022 7:23
29/5/2021,Nakhon Ratchasima,12,967,2633898,1294636,1339262,95155,94599,556,46,18,19/1/2022 7:23
29/5/2021,Nakhon Si Thammarat,5,867,1550685,765026,785659,7956,7956,0,,,19/1/2022 7:23
29/5/2021,Nakhon Sawan,4,472,1038321,506625,531696,21893,21893,0,55,20,19/1/2022 7:23
29/5/2021,Nonthaburi,2636,11169,1282168,596750,685418,3634,3613,21,25,11,19/1/2022 7:23
29/5/2021,Narathiwat,22,909,807640,399607,408033,1063,1063,0,40,18,19/1/2022 7:23
29/5/2021,Nan,0,121,476276,238368,237908,6955,6876,79,,,19/1/2022 7:23
29/5/2021,Bueng Kan,2,29,422395,211815,210580,2107,2107,0,,,19/1/2022 7:23
29/5/2021,Buri Ram,2,208,1580600,784622,795978,19949,19899,50,,,19/1/2022 7:23
29/5/2021,Pathum Thani,65,4155,1181742,559988,621754,2265,2237,28,47,19,19/1/2022 7:23
29/5/2021,Prachuap Khiri Khan,13,1682,550568,272298,278270,51821,51734,87,,,19/1/2022 7:23
29/5/2021,Prachin Buri,2,399,494216,244010,250206,5966,5966,0,51,21,19/1/2022 7:23
29/5/2021,Pattani,1,429,727981,359468,368513,1288,1288,0,,,19/1/2022 7:23
29/5/2021,Phra Nakhon Si Ayutthaya,8,1231,819893,393933,425960,61595,61233,362,27,33,19/1/2022 7:23
29/5/2021,Phayao,0,98,466006,226859,239147,11143,11122,21,44,19,19/1/2022 7:23
29/5/2021,Phang-nga,0,69,268719,134080,134639,8721,8100,621,,,19/1/2022 7:23
29/5/2021,Phatthalung,1,431,523135,254907,268228,1911,1911,0,,,19/1/2022 7:23
29/5/2021,Phichit,3,152,531511,259350,272161,7231,7231,0,,,19/1/2022 7:23
29/5/2021,Phitsanulok,0,323,847403,414611,432792,30519,30433,86,,,19/1/2022 7:23
29/5/2021,Phuket,3,870,414526,195824,218702,5291,4766,525,65,29,19/1/2022 7:23
29/5/2021,Maha Sarakham,12,369,951267,466548,484719,4341,4341,0,,,19/1/2022 7:23
29/5/2021,Mukdahan,0,42,351099,175412,175687,6784,6784,0,,,19/1/2022 7:23
29/5/2021,Yala,2,458,540317,268883,271434,2178,2178,0,53,20,19/1/2022 7:23
29/5/2021,Yasothon,0,138,534080,266625,267455,952,952,0,,,19/1/2022 7:23
29/5/2021,Ranong,5,777,194750,98304,96446,1678,1678,0,,,19/1/2022 7:23
29/5/2021,Rayong,1,1533,746202,366668,379534,22710,22497,213,48,26,19/1/2022 7:23
29/5/2021,Ratchaburi,8,793,869157,422653,446504,7378,7378,0,,,19/1/2022 7:23
29/5/2021,Roi Et,2,265,1297760,643167,654593,6265,6265,0,,,19/1/2022 7:23
29/5/2021,Lop Buri,0,273,739849,368410,371439,10549,10510,39,,,19/1/2022 7:23
29/5/2021,Lampang,0,270,727262,354467,372795,9481,9078,403,42,19,19/1/2022 7:23
29/5/2021,Lamphun,0,304,401851,193249,208602,8607,8482,125,,,19/1/2022 7:23
29/5/2021,Si Sa Ket,10,398,1457888,725954,731934,3439,3439,0,,,19/1/2022 7:23
29/5/2021,Sakon Nakhon,1,124,1147056,570138,576918,3867,3867,0,,,19/1/2022 7:23
29/5/2021,Songkhla,31,1603,1429188,696564,732624,2754,2723,31,58,33,19/1/2022 7:23
29/5/2021,Satun,0,46,324400,161412,162988,5525,5489,36,38,30,19/1/2022 7:23
29/5/2021,Samut Prakarn,215,7248,1354816,645683,709133,3744,3666,78,,,19/1/2022 7:23
29/5/2021,Samut Songkhram,16,257,191777,91661,100116,13850,13794,56,23,10,19/1/2022 7:23
29/5/2021,Samut Sakhon,43,19565,586821,282842,303979,1725,1725,0,47,25,19/1/2022 7:23
29/5/2021,Saraburi,9,431,643778,316334,327444,17834,17781,53,50,34,19/1/2022 7:23
29/5/2021,Sa kaeo,47,802,561072,279991,281081,3712,3712,0,11,12,19/1/2022 7:23
29/5/2021,Sing Buri,0,117,205391,97605,107786,3742,3742,0,,,19/1/2022 7:23
29/5/2021,Suphan Buri,2,442,837411,404175,433236,12597,12597,0,,,19/1/2022 7:23
29/5/2021,Surat Thani,14,1696,1068431,526206,542225,3429,3408,21,61,34,19/1/2022 7:23
29/5/2021,Surin,0,172,1377702,685565,692137,8806,8806,0,,,19/1/2022 7:23
29/5/2021,Sukhothai,0,118,586803,284381,302422,4869,4747,122,,,19/1/2022 7:23
29/5/2021,Nong Khai,0,77,517275,256665,260610,13264,13246,18,22,9,19/1/2022 7:23
29/5/2021,Nong Bua Lam Phu,0,52,509382,254164,255218,2186,2186,0,,,19/1/2022 7:23
29/5/2021,Amnat Charoen,0,54,376342,187394,188948,1140,1140,0,,,19/1/2022 7:23
29/5/2021,Udon Thani,5,491,1567699,776819,790880,11676,11669,7,,,19/1/2022 7:23
29/5/2021,Uttaradit,0,88,447682,218270,229412,8216,8216,0,,,19/1/2022 7:23
29/5/2021,Uthai Thani,0,34,325555,159138,166417,2668,2668,0,,,19/1/2022 7:23
29/5/2021,Ubon Ratchathani,0,365,1867034,932378,934656,17785,17785,0,45,21,19/1/2022 7:23
29/5/2021,Ang Thong,0,301,275934,132137,143797,2679,2679,0,,,19/1/2022 7:23
29/5/2021,Chiang Rai,4,709,1296741,630516,666225,33777,33431,346,49,16,19/1/2022 7:23
29/5/2021,Chiang Mai,6,8101,1785286,862939,922347,97868,95795,2073,62,20,19/1/2022 7:23
29/5/2021,Phetchaburi,64,4530,482261,232800,249461,48502,48311,191,,,19/1/2022 7:23
29/5/2021,Phetchabun,4,160,980259,483622,496637,30774,30774,0,,,19/1/2022 7:23
29/5/2021,Loei,0,99,638528,320030,318498,6303,6296,7,35,20,19/1/2022 7:23
29/5/2021,Phrae,0,87,436092,210253,225839,7717,7717,0,46,18,19/1/2022 7:23
29/5/2021,Mae Hong Son,0,54,285641,144762,140879,13138,12870,268,43,7,19/1/2022 7:23
29/5/2021,,0,153,,,,,,,,,19/1/2022 7:23
30/5/2021,Krabi,3,329,478425,237576,240849,2222,2082,140,,,19/1/2022 7:23
30/5/2021,Bangkok,1657,59883,5565337,2611984,2953353,353401,323907,29494,36,23,19/1/2022 7:23
30/5/2021,Kanchanaburi,4,336,892304,447427,444877,38060,37817,243,28,11,19/1/2022 7:23
30/5/2021,Kalasin,2,111,977098,483228,493870,2258,2258,0,,,19/1/2022 7:23
30/5/2021,Kamphaeng Phet,2,145,713612,352508,361104,8775,8775,0,,,19/1/2022 7:23
30/5/2021,Khon Kaen,1,535,1793078,881616,911462,46729,46690,39,58,35,19/1/2022 7:23
30/5/2021,Chanthaburi,14,1055,535709,261994,273715,22331,22275,56,,,19/1/2022 7:23
30/5/2021,Chachoengsao,118,1379,721880,353941,367939,5688,5688,0,37,34,19/1/2022 7:23
30/5/2021,Chon Buri,90,6195,1572844,766647,806197,29860,29153,707,32,26,19/1/2022 7:23
30/5/2021,Chai Nat,0,92,321640,154663,166977,5843,5843,0,,,19/1/2022 7:23
30/5/2021,Chaiyaphum,0,313,1124135,555470,568665,7737,7725,12,,,19/1/2022 7:23
30/5/2021,Chumphon,3,128,509660,251522,258138,1501,1501,0,,,19/1/2022 7:23
30/5/2021,Trang,44,437,640335,313195,327140,1786,1786,0,,,19/1/2022 7:23
30/5/2021,Trat,1,159,228577,113056,115521,25099,24970,129,,,19/1/2022 7:23
30/5/2021,Tak,5,609,673504,340558,332946,19138,19115,23,,,19/1/2022 7:23
30/5/2021,Nakhon Nayok,3,256,259663,128076,131587,7533,7533,0,,,19/1/2022 7:23
30/5/2021,Nakhon Pathom,23,1470,922477,443242,479235,13279,13263,16,18,17,19/1/2022 7:23
30/5/2021,Nakhon Phanom,0,140,717008,357388,359620,4972,4963,9,,,19/1/2022 7:23
30/5/2021,Nakhon Ratchasima,4,971,2633898,1294636,1339262,95155,94599,556,45,24,19/1/2022 7:23
30/5/2021,Nakhon Si Thammarat,13,880,1550685,765026,785659,7956,7956,0,,,19/1/2022 7:23
30/5/2021,Nakhon Sawan,1,473,1038321,506625,531696,21893,21893,0,37,20,19/1/2022 7:23
30/5/2021,Nonthaburi,1043,12212,1282168,596750,685418,3634,3613,21,18,14,19/1/2022 7:23
30/5/2021,Narathiwat,65,974,807640,399607,408033,1063,1063,0,46,23,19/1/2022 7:23
30/5/2021,Nan,0,121,476276,238368,237908,6955,6876,79,,,19/1/2022 7:23
30/5/2021,Bueng Kan,3,32,422395,211815,210580,2107,2107,0,,,19/1/2022 7:23
30/5/2021,Buri Ram,1,209,1580600,784622,795978,19949,19899,50,,,19/1/2022 7:23
30/5/2021,Pathum Thani,73,4228,1181742,559988,621754,2265,2237,28,44,13,19/1/2022 7:23
30/5/2021,Prachuap Khiri Khan,17,1699,550568,272298,278270,51821,51734,87,,,19/1/2022 7:23
30/5/2021,Prachin Buri,2,401,494216,244010,250206,5966,5966,0,50,26,19/1/2022 7:23
30/5/2021,Pattani,5,434,727981,359468,368513,1288,1288,0,,,19/1/2022 7:23
30/5/2021,Phra Nakhon Si Ayutthaya,23,1254,819893,393933,425960,61595,61233,362,29,38,19/1/2022 7:23
30/5/2021,Phayao,0,98,466006,226859,239147,11143,11122,21,45,14,19/1/2022 7:23
30/5/2021,Phang-nga,0,69,268719,134080,134639,8721,8100,621,,,19/1/2022 7:23
30/5/2021,Phatthalung,0,431,523135,254907,268228,1911,1911,0,,,19/1/2022 7:23
30/5/2021,Phichit,0,152,531511,259350,272161,7231,7231,0,,,19/1/2022 7:23
30/5/2021,Phitsanulok,1,324,847403,414611,432792,30519,30433,86,,,19/1/2022 7:23
30/5/2021,Phuket,3,873,414526,195824,218702,5291,4766,525,58,31,19/1/2022 7:23
30/5/2021,Maha Sarakham,0,369,951267,466548,484719,4341,4341,0,,,19/1/2022 7:23
30/5/2021,Mukdahan,0,42,351099,175412,175687,6784,6784,0,,,19/1/2022 7:23
30/5/2021,Yala,17,475,540317,268883,271434,2178,2178,0,43,23,19/1/2022 7:23
30/5/2021,Yasothon,1,139,534080,266625,267455,952,952,0,,,19/1/2022 7:23
30/5/2021,Ranong,14,791,194750,98304,96446,1678,1678,0,,,19/1/2022 7:23
30/5/2021,Rayong,6,1539,746202,366668,379534,22710,22497,213,38,27,19/1/2022 7:23
30/5/2021,Ratchaburi,12,805,869157,422653,446504,7378,7378,0,,,19/1/2022 7:23
30/5/2021,Roi Et,1,266,1297760,643167,654593,6265,6265,0,,,19/1/2022 7:23
30/5/2021,Lop Buri,2,275,739849,368410,371439,10549,10510,39,,,19/1/2022 7:23
30/5/2021,Lampang,0,270,727262,354467,372795,9481,9078,403,33,17,19/1/2022 7:23
30/5/2021,Lamphun,0,304,401851,193249,208602,8607,8482,125,,,19/1/2022 7:23
30/5/2021,Si Sa Ket,3,401,1457888,725954,731934,3439,3439,0,,,19/1/2022 7:23
30/5/2021,Sakon Nakhon,3,127,1147056,570138,576918,3867,3867,0,,,19/1/2022 7:23
30/5/2021,Songkhla,81,1684,1429188,696564,732624,2754,2723,31,69,35,19/1/2022 7:23
30/5/2021,Satun,0,46,324400,161412,162988,5525,5489,36,65,22,19/1/2022 7:23
30/5/2021,Samut Prakarn,264,7512,1354816,645683,709133,3744,3666,78,,,19/1/2022 7:23
30/5/2021,Samut Songkhram,4,261,191777,91661,100116,13850,13794,56,21,12,19/1/2022 7:23
30/5/2021,Samut Sakhon,58,19623,586821,282842,303979,1725,1725,0,53,28,19/1/2022 7:23
30/5/2021,Saraburi,15,446,643778,316334,327444,17834,17781,53,45,45,19/1/2022 7:23
30/5/2021,Sa kaeo,24,826,561072,279991,281081,3712,3712,0,15,14,19/1/2022 7:23
30/5/2021,Sing Buri,3,120,205391,97605,107786,3742,3742,0,,,19/1/2022 7:23
30/5/2021,Suphan Buri,1,443,837411,404175,433236,12597,12597,0,,,19/1/2022 7:23
30/5/2021,Surat Thani,13,1709,1068431,526206,542225,3429,3408,21,74,40,19/1/2022 7:23
30/5/2021,Surin,1,173,1377702,685565,692137,8806,8806,0,,,19/1/2022 7:23
30/5/2021,Sukhothai,0,118,586803,284381,302422,4869,4747,122,,,19/1/2022 7:23
30/5/2021,Nong Khai,1,78,517275,256665,260610,13264,13246,18,22,11,19/1/2022 7:23
30/5/2021,Nong Bua Lam Phu,6,58,509382,254164,255218,2186,2186,0,,,19/1/2022 7:23
30/5/2021,Amnat Charoen,0,54,376342,187394,188948,1140,1140,0,,,19/1/2022 7:23
30/5/2021,Udon Thani,5,496,1567699,776819,790880,11676,11669,7,,,19/1/2022 7:23
30/5/2021,Uttaradit,0,88,447682,218270,229412,8216,8216,0,,,19/1/2022 7:23
30/5/2021,Uthai Thani,1,35,325555,159138,166417,2668,2668,0,,,19/1/2022 7:23
30/5/2021,Ubon Ratchathani,0,365,1867034,932378,934656,17785,17785,0,46,22,19/1/2022 7:23
30/5/2021,Ang Thong,3,304,275934,132137,143797,2679,2679,0,,,19/1/2022 7:23
30/5/2021,Chiang Rai,6,715,1296741,630516,666225,33777,33431,346,42,12,19/1/2022 7:23
30/5/2021,Chiang Mai,0,8101,1785286,862939,922347,97868,95795,2073,51,21,19/1/2022 7:23
30/5/2021,Phetchaburi,754,5284,482261,232800,249461,48502,48311,191,,,19/1/2022 7:23
30/5/2021,Phetchabun,5,165,980259,483622,496637,30774,30774,0,,,19/1/2022 7:23
30/5/2021,Loei,0,99,638528,320030,318498,6303,6296,7,34,23,19/1/2022 7:23
30/5/2021,Phrae,0,87,436092,210253,225839,7717,7717,0,41,15,19/1/2022 7:23
30/5/2021,Mae Hong Son,0,54,285641,144762,140879,13138,12870,268,31,7,19/1/2022 7:23
30/5/2021,,0,153,,,,,,,,,19/1/2022 7:23
31/5/2021,Krabi,2,331,478425,237576,240849,2222,2082,140,,,19/1/2022 7:23
31/5/2021,Bangkok,2026,61909,5565337,2611984,2953353,353401,323907,29494,47,24,19/1/2022 7:23
31/5/2021,Kanchanaburi,0,336,892304,447427,444877,38060,37817,243,31,11,19/1/2022 7:23
31/5/2021,Kalasin,1,112,977098,483228,493870,2258,2258,0,,,19/1/2022 7:23
31/5/2021,Kamphaeng Phet,3,148,713612,352508,361104,8775,8775,0,,,19/1/2022 7:23
31/5/2021,Khon Kaen,0,535,1793078,881616,911462,46729,46690,39,61,37,19/1/2022 7:23
31/5/2021,Chanthaburi,7,1062,535709,261994,273715,22331,22275,56,,,19/1/2022 7:23
31/5/2021,Chachoengsao,820,2199,721880,353941,367939,5688,5688,0,39,36,19/1/2022 7:23
31/5/2021,Chon Buri,62,6257,1572844,766647,806197,29860,29153,707,47,31,19/1/2022 7:23
31/5/2021,Chai Nat,0,92,321640,154663,166977,5843,5843,0,,,19/1/2022 7:23
31/5/2021,Chaiyaphum,0,313,1124135,555470,568665,7737,7725,12,,,19/1/2022 7:23
31/5/2021,Chumphon,0,128,509660,251522,258138,1501,1501,0,,,19/1/2022 7:23
31/5/2021,Trang,76,513,640335,313195,327140,1786,1786,0,,,19/1/2022 7:23
31/5/2021,Trat,0,159,228577,113056,115521,25099,24970,129,,,19/1/2022 7:23
31/5/2021,Tak,2,611,673504,340558,332946,19138,19115,23,,,19/1/2022 7:23
31/5/2021,Nakhon Nayok,13,269,259663,128076,131587,7533,7533,0,,,19/1/2022 7:23
31/5/2021,Nakhon Pathom,40,1510,922477,443242,479235,13279,13263,16,34,19,19/1/2022 7:23
31/5/2021,Nakhon Phanom,0,140,717008,357388,359620,4972,4963,9,,,19/1/2022 7:23
31/5/2021,Nakhon Ratchasima,3,974,2633898,1294636,1339262,95155,94599,556,47,26,19/1/2022 7:23
31/5/2021,Nakhon Si Thammarat,9,889,1550685,765026,785659,7956,7956,0,,,19/1/2022 7:23
31/5/2021,Nakhon Sawan,7,480,1038321,506625,531696,21893,21893,0,36,25,19/1/2022 7:23
31/5/2021,Nonthaburi,366,12578,1282168,596750,685418,3634,3613,21,27,14,19/1/2022 7:23
31/5/2021,Narathiwat,21,995,807640,399607,408033,1063,1063,0,55,21,19/1/2022 7:23
31/5/2021,Nan,0,121,476276,238368,237908,6955,6876,79,,,19/1/2022 7:23
31/5/2021,Bueng Kan,0,32,422395,211815,210580,2107,2107,0,,,19/1/2022 7:23
31/5/2021,Buri Ram,0,209,1580600,784622,795978,19949,19899,50,,,19/1/2022 7:23
31/5/2021,Pathum Thani,213,4441,1181742,559988,621754,2265,2237,28,35,15,19/1/2022 7:23
31/5/2021,Prachuap Khiri Khan,3,1702,550568,272298,278270,51821,51734,87,,,19/1/2022 7:23
31/5/2021,Prachin Buri,2,403,494216,244010,250206,5966,5966,0,61,29,19/1/2022 7:23
31/5/2021,Pattani,6,440,727981,359468,368513,1288,1288,0,,,19/1/2022 7:23
31/5/2021,Phra Nakhon Si Ayutthaya,27,1281,819893,393933,425960,61595,61233,362,45,41,19/1/2022 7:23
31/5/2021,Phayao,0,98,466006,226859,239147,11143,11122,21,28,22,19/1/2022 7:23
31/5/2021,Phang-nga,0,69,268719,134080,134639,8721,8100,621,,,19/1/2022 7:23
31/5/2021,Phatthalung,0,431,523135,254907,268228,1911,1911,0,,,19/1/2022 7:23
31/5/2021,Phichit,0,152,531511,259350,272161,7231,7231,0,,,19/1/2022 7:23
31/5/2021,Phitsanulok,11,335,847403,414611,432792,30519,30433,86,,,19/1/2022 7:23
31/5/2021,Phuket,8,881,414526,195824,218702,5291,4766,525,61,29,19/1/2022 7:23
31/5/2021,Maha Sarakham,1,370,951267,466548,484719,4341,4341,0,,,19/1/2022 7:23
31/5/2021,Mukdahan,0,42,351099,175412,175687,6784,6784,0,,,19/1/2022 7:23
31/5/2021,Yala,15,490,540317,268883,271434,2178,2178,0,52,24,19/1/2022 7:23
31/5/2021,Yasothon,2,141,534080,266625,267455,952,952,0,,,19/1/2022 7:23
31/5/2021,Ranong,19,810,194750,98304,96446,1678,1678,0,,,19/1/2022 7:23
31/5/2021,Rayong,3,1542,746202,366668,379534,22710,22497,213,41,32,19/1/2022 7:23
31/5/2021,Ratchaburi,26,831,869157,422653,446504,7378,7378,0,,,19/1/2022 7:23
31/5/2021,Roi Et,0,266,1297760,643167,654593,6265,6265,0,,,19/1/2022 7:23
31/5/2021,Lop Buri,14,289,739849,368410,371439,10549,10510,39,,,19/1/2022 7:23
31/5/2021,Lampang,0,270,727262,354467,372795,9481,9078,403,23,25,19/1/2022 7:23
31/5/2021,Lamphun,0,304,401851,193249,208602,8607,8482,125,,,19/1/2022 7:23
31/5/2021,Si Sa Ket,6,407,1457888,725954,731934,3439,3439,0,,,19/1/2022 7:23
31/5/2021,Sakon Nakhon,0,127,1147056,570138,576918,3867,3867,0,,,19/1/2022 7:23
31/5/2021,Songkhla,113,1797,1429188,696564,732624,2754,2723,31,72,40,19/1/2022 7:23
31/5/2021,Satun,0,46,324400,161412,162988,5525,5489,36,43,25,19/1/2022 7:23
31/5/2021,Samut Prakarn,358,7870,1354816,645683,709133,3744,3666,78,,,19/1/2022 7:23
31/5/2021,Samut Songkhram,3,264,191777,91661,100116,13850,13794,56,26,15,19/1/2022 7:23
31/5/2021,Samut Sakhon,58,19681,586821,282842,303979,1725,1725,0,56,32,19/1/2022 7:23
31/5/2021,Saraburi,327,773,643778,316334,327444,17834,17781,53,52,48,19/1/2022 7:23
31/5/2021,Sa kaeo,55,881,561072,279991,281081,3712,3712,0,19,16,19/1/2022 7:23
31/5/2021,Sing Buri,3,123,205391,97605,107786,3742,3742,0,,,19/1/2022 7:23
31/5/2021,Suphan Buri,1,444,837411,404175,433236,12597,12597,0,,,19/1/2022 7:23
31/5/2021,Surat Thani,10,1719,1068431,526206,542225,3429,3408,21,79,30,19/1/2022 7:23
31/5/2021,Surin,0,173,1377702,685565,692137,8806,8806,0,,,19/1/2022 7:23
31/5/2021,Sukhothai,1,119,586803,284381,302422,4869,4747,122,,,19/1/2022 7:23
31/5/2021,Nong Khai,0,78,517275,256665,260610,13264,13246,18,27,9,19/1/2022 7:23
31/5/2021,Nong Bua Lam Phu,0,58,509382,254164,255218,2186,2186,0,,,19/1/2022 7:23
31/5/2021,Amnat Charoen,0,54,376342,187394,188948,1140,1140,0,,,19/1/2022 7:23
31/5/2021,Udon Thani,2,498,1567699,776819,790880,11676,11669,7,,,19/1/2022 7:23
31/5/2021,Uttaradit,1,89,447682,218270,229412,8216,8216,0,,,19/1/2022 7:23
31/5/2021,Uthai Thani,5,40,325555,159138,166417,2668,2668,0,,,19/1/2022 7:23
31/5/2021,Ubon Ratchathani,1,366,1867034,932378,934656,17785,17785,0,48,26,19/1/2022 7:23
31/5/2021,Ang Thong,0,304,275934,132137,143797,2679,2679,0,,,19/1/2022 7:23
31/5/2021,Chiang Rai,2,717,1296741,630516,666225,33777,33431,346,33,21,19/1/2022 7:23
31/5/2021,Chiang Mai,174,8275,1785286,862939,922347,97868,95795,2073,51,28,19/1/2022 7:23
31/5/2021,Phetchaburi,555,5839,482261,232800,249461,48502,48311,191,,,19/1/2022 7:23
31/5/2021,Phetchabun,2,167,980259,483622,496637,30774,30774,0,,,19/1/2022 7:23
31/5/2021,Loei,0,99,638528,320030,318498,6303,6296,7,45,24,19/1/2022 7:23
31/5/2021,Phrae,0,87,436092,210253,225839,7717,7717,0,39,20,19/1/2022 7:23
31/5/2021,Mae Hong Son,0,54,285641,144762,140879,13138,12870,268,27,20,19/1/2022 7:23
31/5/2021,,0,153,,,,,,,,,19/1/2022 7:23
1/6/2021,Krabi,0,331,478523,237695,240828,2661,2547,114,,,19/1/2022 7:23
1/6/2021,Bangkok,882,62791,5557605,2607913,2949692,256622,230749,25873,58,28,19/1/2022 7:23
1/6/2021,Kanchanaburi,0,336,892655,447517,445138,61297,61077,220,28,8,19/1/2022 7:23
1/6/2021,Kalasin,1,113,976880,483049,493831,2792,2792,0,,,19/1/2022 7:23
1/6/2021,Kamphaeng Phet,2,150,713388,352344,361044,7265,7265,0,,,19/1/2022 7:23
1/6/2021,Khon Kaen,1,536,1792631,881416,911215,39567,39567,0,65,42,19/1/2022 7:23
1/6/2021,Chanthaburi,6,1068,535759,262053,273706,20687,20602,85,,,19/1/2022 7:23
1/6/2021,Chachoengsao,11,2210,722120,354040,368080,4415,4415,0,51,38,19/1/2022 7:23
1/6/2021,Chon Buri,56,6313,1576670,769103,807567,41441,40719,722,48,33,19/1/2022 7:23
1/6/2021,Chai Nat,1,93,321397,154547,166850,5221,5221,0,,,19/1/2022 7:23
1/6/2021,Chaiyaphum,1,314,1123720,555261,568459,6515,6506,9,,,19/1/2022 7:23
1/6/2021,Chumphon,0,128,509518,251488,258030,2539,2539,0,,,19/1/2022 7:23
1/6/2021,Trang,164,677,640151,313123,327028,3134,3134,0,,,19/1/2022 7:23
1/6/2021,Trat,0,159,228460,112953,115507,19181,19065,116,,,19/1/2022 7:23
1/6/2021,Tak,1,612,674065,340821,333244,16539,16539,0,,,19/1/2022 7:23
1/6/2021,Nakhon Nayok,6,275,259655,128067,131588,4620,4620,0,,,19/1/2022 7:23
1/6/2021,Nakhon Pathom,40,1550,922334,443151,479183,8757,8744,13,46,20,19/1/2022 7:23
1/6/2021,Nakhon Phanom,0,140,717157,357396,359761,5327,5318,9,,,19/1/2022 7:23
1/6/2021,Nakhon Ratchasima,2,976,2633864,1294474,1339390,120449,119801,648,55,28,19/1/2022 7:23
1/6/2021,Nakhon Si Thammarat,2,891,1549931,764739,785192,9919,9919,0,,,19/1/2022 7:23
1/6/2021,Nakhon Sawan,10,490,1037728,506276,531452,18315,18315,0,49,25,19/1/2022 7:23
1/6/2021,Nonthaburi,112,12690,1283748,597411,686337,2979,2961,18,34,17,19/1/2022 7:23
1/6/2021,Narathiwat,36,1031,807983,399778,408205,613,613,0,51,21,19/1/2022 7:23
1/6/2021,Nan,0,121,476110,238240,237870,12538,12477,61,,,19/1/2022 7:23
1/6/2021,Bueng Kan,0,32,422320,211778,210542,3482,3477,5,,,19/1/2022 7:23
1/6/2021,Buri Ram,2,211,1580295,784354,795941,23788,23726,62,,,19/1/2022 7:23
1/6/2021,Pathum Thani,61,4502,1184377,561210,623167,1664,1645,19,38,15,19/1/2022 7:23
1/6/2021,Prachuap Khiri Khan,13,1715,551074,272744,278330,36899,36826,73,,,19/1/2022 7:23
1/6/2021,Prachin Buri,0,403,494401,244052,250349,3921,3921,0,63,30,19/1/2022 7:23
1/6/2021,Pattani,4,444,728135,359504,368631,837,837,0,,,19/1/2022 7:23
1/6/2021,Phra Nakhon Si Ayutthaya,32,1313,820129,394020,426109,61845,61474,371,37,40,19/1/2022 7:23
1/6/2021,Phayao,0,98,465644,226629,239015,8699,8699,0,46,36,19/1/2022 7:23
1/6/2021,Phang-nga,2,71,268563,134041,134522,5909,5544,365,,,19/1/2022 7:23
1/6/2021,Phatthalung,1,432,523027,254844,268183,2836,2836,0,,,19/1/2022 7:23
1/6/2021,Phichit,0,152,531180,259128,272052,6377,6377,0,,,19/1/2022 7:23
1/6/2021,Phitsanulok,4,339,847068,414386,432682,28588,28523,65,,,19/1/2022 7:23
1/6/2021,Phuket,4,885,415684,196375,219309,28777,28224,553,56,25,19/1/2022 7:23
1/6/2021,Maha Sarakham,0,370,950820,466360,484460,3552,3552,0,,,19/1/2022 7:23
1/6/2021,Mukdahan,0,42,351117,175421,175696,6539,6539,0,,,19/1/2022 7:23
1/6/2021,Yala,4,494,540726,269152,271574,923,923,0,56,25,19/1/2022 7:23
1/6/2021,Yasothon,0,141,533972,266534,267438,1630,1630,0,,,19/1/2022 7:23
1/6/2021,Ranong,25,835,194715,98283,96432,2092,2092,0,,,19/1/2022 7:23
1/6/2021,Rayong,2,1544,747267,367184,380083,23374,23094,280,55,34,19/1/2022 7:23
1/6/2021,Ratchaburi,3,834,869140,422590,446550,13639,13639,0,,,19/1/2022 7:23
1/6/2021,Roi Et,0,266,1297189,642792,654397,3901,3901,0,,,19/1/2022 7:23
1/6/2021,Lop Buri,4,293,739289,367896,371393,8701,8660,41,,,19/1/2022 7:23
1/6/2021,Lampang,0,270,726902,354357,372545,6899,6564,335,45,38,19/1/2022 7:23
1/6/2021,Lamphun,0,304,401818,193230,208588,7266,7171,95,,,19/1/2022 7:23
1/6/2021,Si Sa Ket,2,409,1457790,725911,731879,4874,4874,0,,,19/1/2022 7:23
1/6/2021,Sakon Nakhon,0,127,1146926,570016,576910,5542,5542,0,,,19/1/2022 7:23
1/6/2021,Songkhla,81,1878,1429245,696525,732720,2071,2048,23,78,36,19/1/2022 7:23
1/6/2021,Satun,2,48,324391,161409,162982,3087,3058,29,55,22,19/1/2022 7:23
1/6/2021,Samut Prakarn,259,8129,1355249,645868,709381,2956,2895,61,,,19/1/2022 7:23
1/6/2021,Samut Songkhram,17,281,191737,91607,100130,17315,17259,56,31,15,19/1/2022 7:23
1/6/2021,Samut Sakhon,82,19763,587191,283020,304171,1347,1347,0,64,30,19/1/2022 7:23
1/6/2021,Saraburi,83,856,643677,316181,327496,14753,14707,46,61,54,19/1/2022 7:23
1/6/2021,Sa kaeo,4,885,561052,279978,281074,2761,2761,0,34,15,19/1/2022 7:23
1/6/2021,Sing Buri,1,124,205344,97567,107777,3421,3421,0,,,19/1/2022 7:23
1/6/2021,Suphan Buri,5,449,837218,404081,433137,20061,20061,0,,,19/1/2022 7:23
1/6/2021,Surat Thani,17,1736,1069905,526507,543398,4456,4439,17,67,35,19/1/2022 7:23
1/6/2021,Surin,2,175,1377402,685400,692002,10395,10377,18,,,19/1/2022 7:23
1/6/2021,Sukhothai,0,119,586606,284242,302364,7337,7029,308,,,19/1/2022 7:23
1/6/2021,Nong Khai,0,78,517219,256618,260601,12678,12669,9,23,11,19/1/2022 7:23
1/6/2021,Nong Bua Lam Phu,0,58,509323,254117,255206,3248,3248,0,,,19/1/2022 7:23
1/6/2021,Amnat Charoen,0,54,376371,187343,189028,2235,2235,0,,,19/1/2022 7:23
1/6/2021,Udon Thani,1,499,1567321,776506,790815,16592,16582,10,,,19/1/2022 7:23
1/6/2021,Uttaradit,6,95,447366,218091,229275,7129,7129,0,,,19/1/2022 7:23
1/6/2021,Uthai Thani,0,40,325515,159149,166366,2979,2979,0,,,19/1/2022 7:23
1/6/2021,Ubon Ratchathani,1,367,1867065,932291,934774,19665,19665,0,58,34,19/1/2022 7:23
1/6/2021,Ang Thong,1,305,275836,132062,143774,2258,2258,0,,,19/1/2022 7:23
1/6/2021,Chiang Rai,1,718,1297104,630696,666408,26342,26054,288,53,33,19/1/2022 7:23
1/6/2021,Chiang Mai,4,8279,1786156,863211,922945,80431,79438,993,57,39,19/1/2022 7:23
1/6/2021,Phetchaburi,166,6005,482299,232776,249523,41434,41240,194,,,19/1/2022 7:23
1/6/2021,Phetchabun,0,167,979800,483288,496512,23760,23760,0,,,19/1/2022 7:23
1/6/2021,Loei,0,99,638445,319953,318492,5204,5185,19,46,25,19/1/2022 7:23
1/6/2021,Phrae,0,87,435883,210160,225723,6005,6005,0,44,24,19/1/2022 7:23
1/6/2021,Mae Hong Son,0,54,285642,144738,140904,8603,8391,212,68,29,19/1/2022 7:23
1/6/2021,,0,153,,,,,,,,,19/1/2022 7:23
2/6/2021,Krabi,3,334,478523,237695,240828,2661,2547,114,,,19/1/2022 7:23
2/6/2021,Bangkok,744,63535,5557605,2607913,2949692,256622,230749,25873,60,23,19/1/2022 7:23
2/6/2021,Kanchanaburi,1,337,892655,447517,445138,61297,61077,220,23,15,19/1/2022 7:23
2/6/2021,Kalasin,2,115,976880,483049,493831,2792,2792,0,,,19/1/2022 7:23
2/6/2021,Kamphaeng Phet,1,151,713388,352344,361044,7265,7265,0,,,19/1/2022 7:23
2/6/2021,Khon Kaen,0,536,1792631,881416,911215,39567,39567,0,72,43,19/1/2022 7:23
2/6/2021,Chanthaburi,16,1084,535759,262053,273706,20687,20602,85,,,19/1/2022 7:23
2/6/2021,Chachoengsao,25,2235,722120,354040,368080,4415,4415,0,57,39,19/1/2022 7:23
2/6/2021,Chon Buri,30,6343,1576670,769103,807567,41441,40719,722,52,30,19/1/2022 7:23
2/6/2021,Chai Nat,3,96,321397,154547,166850,5221,5221,0,,,19/1/2022 7:23
2/6/2021,Chaiyaphum,1,315,1123720,555261,568459,6515,6506,9,,,19/1/2022 7:23
2/6/2021,Chumphon,0,128,509518,251488,258030,2539,2539,0,,,19/1/2022 7:23
2/6/2021,Trang,176,853,640151,313123,327028,3134,3134,0,,,19/1/2022 7:23
2/6/2021,Trat,0,159,228460,112953,115507,19181,19065,116,,,19/1/2022 7:23
2/6/2021,Tak,6,618,674065,340821,333244,16539,16539,0,,,19/1/2022 7:23
2/6/2021,Nakhon Nayok,4,279,259655,128067,131588,4620,4620,0,,,19/1/2022 7:23
2/6/2021,Nakhon Pathom,23,1573,922334,443151,479183,8757,8744,13,46,20,19/1/2022 7:23
2/6/2021,Nakhon Phanom,1,141,717157,357396,359761,5327,5318,9,,,19/1/2022 7:23
2/6/2021,Nakhon Ratchasima,3,979,2633864,1294474,1339390,120449,119801,648,56,28,19/1/2022 7:23
2/6/2021,Nakhon Si Thammarat,8,899,1549931,764739,785192,9919,9919,0,,,19/1/2022 7:23
2/6/2021,Nakhon Sawan,14,504,1037728,506276,531452,18315,18315,0,49,26,19/1/2022 7:23
2/6/2021,Nonthaburi,1036,13726,1283748,597411,686337,2979,2961,18,36,17,19/1/2022 7:23
2/6/2021,Narathiwat,36,1067,807983,399778,408205,613,613,0,43,22,19/1/2022 7:23
2/6/2021,Nan,0,121,476110,238240,237870,12538,12477,61,,,19/1/2022 7:23
2/6/2021,Bueng Kan,1,33,422320,211778,210542,3482,3477,5,,,19/1/2022 7:23
2/6/2021,Buri Ram,0,211,1580295,784354,795941,23788,23726,62,,,19/1/2022 7:23
2/6/2021,Pathum Thani,39,4541,1184377,561210,623167,1664,1645,19,43,17,19/1/2022 7:23
2/6/2021,Prachuap Khiri Khan,4,1719,551074,272744,278330,36899,36826,73,,,19/1/2022 7:23
2/6/2021,Prachin Buri,1,404,494401,244052,250349,3921,3921,0,65,29,19/1/2022 7:23
2/6/2021,Pattani,8,452,728135,359504,368631,837,837,0,,,19/1/2022 7:23
2/6/2021,Phra Nakhon Si Ayutthaya,33,1346,820129,394020,426109,61845,61474,371,44,39,19/1/2022 7:23
2/6/2021,Phayao,0,98,465644,226629,239015,8699,8699,0,64,43,19/1/2022 7:23
2/6/2021,Phang-nga,0,71,268563,134041,134522,5909,5544,365,,,19/1/2022 7:23
2/6/2021,Phatthalung,3,435,523027,254844,268183,2836,2836,0,,,19/1/2022 7:23
2/6/2021,Phichit,0,152,531180,259128,272052,6377,6377,0,,,19/1/2022 7:23
2/6/2021,Phitsanulok,11,350,847068,414386,432682,28588,28523,65,,,19/1/2022 7:23
2/6/2021,Phuket,2,887,415684,196375,219309,28777,28224,553,50,27,19/1/2022 7:23
2/6/2021,Maha Sarakham,0,370,950820,466360,484460,3552,3552,0,,,19/1/2022 7:23
2/6/2021,Mukdahan,0,42,351117,175421,175696,6539,6539,0,,,19/1/2022 7:23
2/6/2021,Yala,5,499,540726,269152,271574,923,923,0,53,22,19/1/2022 7:23
2/6/2021,Yasothon,1,142,533972,266534,267438,1630,1630,0,,,19/1/2022 7:23
2/6/2021,Ranong,16,851,194715,98283,96432,2092,2092,0,,,19/1/2022 7:23
2/6/2021,Rayong,11,1555,747267,367184,380083,23374,23094,280,59,38,19/1/2022 7:23
2/6/2021,Ratchaburi,2,836,869140,422590,446550,13639,13639,0,,,19/1/2022 7:23
2/6/2021,Roi Et,1,267,1297189,642792,654397,3901,3901,0,,,19/1/2022 7:23
2/6/2021,Lop Buri,10,303,739289,367896,371393,8701,8660,41,,,19/1/2022 7:23
2/6/2021,Lampang,0,270,726902,354357,372545,6899,6564,335,65,44,19/1/2022 7:23
2/6/2021,Lamphun,0,304,401818,193230,208588,7266,7171,95,,,19/1/2022 7:23
2/6/2021,Si Sa Ket,10,419,1457790,725911,731879,4874,4874,0,,,19/1/2022 7:23
2/6/2021,Sakon Nakhon,1,128,1146926,570016,576910,5542,5542,0,,,19/1/2022 7:23
2/6/2021,Songkhla,69,1947,1429245,696525,732720,2071,2048,23,78,37,19/1/2022 7:23
2/6/2021,Satun,0,48,324391,161409,162982,3087,3058,29,48,22,19/1/2022 7:23
2/6/2021,Samut Prakarn,466,8595,1355249,645868,709381,2956,2895,61,,,19/1/2022 7:23
2/6/2021,Samut Songkhram,19,300,191737,91607,100130,17315,17259,56,34,17,19/1/2022 7:23
2/6/2021,Samut Sakhon,78,19841,587191,283020,304171,1347,1347,0,56,30,19/1/2022 7:23
2/6/2021,Saraburi,27,883,643677,316181,327496,14753,14707,46,66,46,19/1/2022 7:23
2/6/2021,Sa kaeo,2,887,561052,279978,281074,2761,2761,0,27,17,19/1/2022 7:23
2/6/2021,Sing Buri,0,124,205344,97567,107777,3421,3421,0,,,19/1/2022 7:23
2/6/2021,Suphan Buri,4,453,837218,404081,433137,20061,20061,0,,,19/1/2022 7:23
2/6/2021,Surat Thani,3,1739,1069905,526507,543398,4456,4439,17,69,37,19/1/2022 7:23
2/6/2021,Surin,5,180,1377402,685400,692002,10395,10377,18,,,19/1/2022 7:23
2/6/2021,Sukhothai,1,120,586606,284242,302364,7337,7029,308,,,19/1/2022 7:23
2/6/2021,Nong Khai,0,78,517219,256618,260601,12678,12669,9,27,13,19/1/2022 7:23
2/6/2021,Nong Bua Lam Phu,0,58,509323,254117,255206,3248,3248,0,,,19/1/2022 7:23
2/6/2021,Amnat Charoen,0,54,376371,187343,189028,2235,2235,0,,,19/1/2022 7:23
2/6/2021,Udon Thani,3,502,1567321,776506,790815,16592,16582,10,,,19/1/2022 7:23
2/6/2021,Uttaradit,0,95,447366,218091,229275,7129,7129,0,,,19/1/2022 7:23
2/6/2021,Uthai Thani,1,41,325515,159149,166366,2979,2979,0,,,19/1/2022 7:23
2/6/2021,Ubon Ratchathani,4,371,1867065,932291,934774,19665,19665,0,64,42,19/1/2022 7:23
2/6/2021,Ang Thong,0,305,275836,132062,143774,2258,2258,0,,,19/1/2022 7:23
2/6/2021,Chiang Rai,3,721,1297104,630696,666408,26342,26054,288,76,34,19/1/2022 7:23
2/6/2021,Chiang Mai,10,8289,1786156,863211,922945,80431,79438,993,76,45,19/1/2022 7:23
2/6/2021,Phetchaburi,449,6454,482299,232776,249523,41434,41240,194,,,19/1/2022 7:23
2/6/2021,Phetchabun,2,169,979800,483288,496512,23760,23760,0,,,19/1/2022 7:23
2/6/2021,Loei,1,100,638445,319953,318492,5204,5185,19,52,27,19/1/2022 7:23
2/6/2021,Phrae,1,88,435883,210160,225723,6005,6005,0,56,42,19/1/2022 7:23
2/6/2021,Mae Hong Son,0,54,285642,144738,140904,8603,8391,212,87,32,19/1/2022 7:23
2/6/2021,,0,153,,,,,,,,,19/1/2022 7:23
3/6/2021,Krabi,0,334,478523,237695,240828,2661,2547,114,,,19/1/2022 7:23
3/6/2021,Bangkok,1144,64679,5557605,2607913,2949692,256622,230749,25873,53,27,19/1/2022 7:23
3/6/2021,Kanchanaburi,4,341,892655,447517,445138,61297,61077,220,39,17,19/1/2022 7:23
3/6/2021,Kalasin,5,120,976880,483049,493831,2792,2792,0,,,19/1/2022 7:23
3/6/2021,Kamphaeng Phet,2,153,713388,352344,361044,7265,7265,0,,,19/1/2022 7:23
3/6/2021,Khon Kaen,2,538,1792631,881416,911215,39567,39567,0,75,46,19/1/2022 7:23
3/6/2021,Chanthaburi,13,1097,535759,262053,273706,20687,20602,85,,,19/1/2022 7:23
3/6/2021,Chachoengsao,165,2400,722120,354040,368080,4415,4415,0,60,38,19/1/2022 7:23
3/6/2021,Chon Buri,48,6391,1576670,769103,807567,41441,40719,722,53,31,19/1/2022 7:23
3/6/2021,Chai Nat,1,97,321397,154547,166850,5221,5221,0,,,19/1/2022 7:23
3/6/2021,Chaiyaphum,4,319,1123720,555261,568459,6515,6506,9,,,19/1/2022 7:23
3/6/2021,Chumphon,0,128,509518,251488,258030,2539,2539,0,,,19/1/2022 7:23
3/6/2021,Trang,92,945,640151,313123,327028,3134,3134,0,,,19/1/2022 7:23
3/6/2021,Trat,0,159,228460,112953,115507,19181,19065,116,,,19/1/2022 7:23
3/6/2021,Tak,21,639,674065,340821,333244,16539,16539,0,,,19/1/2022 7:23
3/6/2021,Nakhon Nayok,10,289,259655,128067,131588,4620,4620,0,,,19/1/2022 7:23
3/6/2021,Nakhon Pathom,31,1604,922334,443151,479183,8757,8744,13,39,20,19/1/2022 7:23
3/6/2021,Nakhon Phanom,0,141,717157,357396,359761,5327,5318,9,,,19/1/2022 7:23
3/6/2021,Nakhon Ratchasima,2,981,2633864,1294474,1339390,120449,119801,648,63,29,19/1/2022 7:23
3/6/2021,Nakhon Si Thammarat,2,901,1549931,764739,785192,9919,9919,0,,,19/1/2022 7:23
3/6/2021,Nakhon Sawan,4,508,1037728,506276,531452,18315,18315,0,50,35,19/1/2022 7:23
3/6/2021,Nonthaburi,1125,14851,1283748,597411,686337,2979,2961,18,35,16,19/1/2022 7:23
3/6/2021,Narathiwat,19,1086,807983,399778,408205,613,613,0,48,21,19/1/2022 7:23
3/6/2021,Nan,0,121,476110,238240,237870,12538,12477,61,,,19/1/2022 7:23
3/6/2021,Bueng Kan,0,33,422320,211778,210542,3482,3477,5,,,19/1/2022 7:23
3/6/2021,Buri Ram,0,211,1580295,784354,795941,23788,23726,62,,,19/1/2022 7:23
3/6/2021,Pathum Thani,62,4603,1184377,561210,623167,1664,1645,19,48,16,19/1/2022 7:23
3/6/2021,Prachuap Khiri Khan,9,1728,551074,272744,278330,36899,36826,73,,,19/1/2022 7:23
3/6/2021,Prachin Buri,1,405,494401,244052,250349,3921,3921,0,67,30,19/1/2022 7:23
3/6/2021,Pattani,4,456,728135,359504,368631,837,837,0,,,19/1/2022 7:23
3/6/2021,Phra Nakhon Si Ayutthaya,30,1376,820129,394020,426109,61845,61474,371,44,41,19/1/2022 7:23
3/6/2021,Phayao,0,98,465644,226629,239015,8699,8699,0,76,29,19/1/2022 7:23
3/6/2021,Phang-nga,0,71,268563,134041,134522,5909,5544,365,,,19/1/2022 7:23
3/6/2021,Phatthalung,0,435,523027,254844,268183,2836,2836,0,,,19/1/2022 7:23
3/6/2021,Phichit,0,152,531180,259128,272052,6377,6377,0,,,19/1/2022 7:23
3/6/2021,Phitsanulok,2,352,847068,414386,432682,28588,28523,65,,,19/1/2022 7:23
3/6/2021,Phuket,6,893,415684,196375,219309,28777,28224,553,58,28,19/1/2022 7:23
3/6/2021,Maha Sarakham,2,372,950820,466360,484460,3552,3552,0,,,19/1/2022 7:23
3/6/2021,Mukdahan,0,42,351117,175421,175696,6539,6539,0,,,19/1/2022 7:23
3/6/2021,Yala,5,504,540726,269152,271574,923,923,0,51,19,19/1/2022 7:23
3/6/2021,Yasothon,1,143,533972,266534,267438,1630,1630,0,,,19/1/2022 7:23
3/6/2021,Ranong,22,873,194715,98283,96432,2092,2092,0,,,19/1/2022 7:23
3/6/2021,Rayong,2,1557,747267,367184,380083,23374,23094,280,56,32,19/1/2022 7:23
3/6/2021,Ratchaburi,0,836,869140,422590,446550,13639,13639,0,,,19/1/2022 7:23
3/6/2021,Roi Et,0,267,1297189,642792,654397,3901,3901,0,,,19/1/2022 7:23
3/6/2021,Lop Buri,18,321,739289,367896,371393,8701,8660,41,,,19/1/2022 7:23
3/6/2021,Lampang,0,270,726902,354357,372545,6899,6564,335,71,44,19/1/2022 7:23
3/6/2021,Lamphun,0,304,401818,193230,208588,7266,7171,95,,,19/1/2022 7:23
3/6/2021,Si Sa Ket,2,421,1457790,725911,731879,4874,4874,0,,,19/1/2022 7:23
3/6/2021,Sakon Nakhon,1,129,1146926,570016,576910,5542,5542,0,,,19/1/2022 7:23
3/6/2021,Songkhla,78,2025,1429245,696525,732720,2071,2048,23,75,37,19/1/2022 7:23
3/6/2021,Satun,0,48,324391,161409,162982,3087,3058,29,53,18,19/1/2022 7:23
3/6/2021,Samut Prakarn,232,8827,1355249,645868,709381,2956,2895,61,,,19/1/2022 7:23
3/6/2021,Samut Songkhram,16,316,191737,91607,100130,17315,17259,56,37,16,19/1/2022 7:23
3/6/2021,Samut Sakhon,76,19917,587191,283020,304171,1347,1347,0,58,29,19/1/2022 7:23
3/6/2021,Saraburi,31,914,643677,316181,327496,14753,14707,46,58,44,19/1/2022 7:23
3/6/2021,Sa kaeo,44,931,561052,279978,281074,2761,2761,0,30,18,19/1/2022 7:23
3/6/2021,Sing Buri,1,125,205344,97567,107777,3421,3421,0,,,19/1/2022 7:23
3/6/2021,Suphan Buri,4,457,837218,404081,433137,20061,20061,0,,,19/1/2022 7:23
3/6/2021,Surat Thani,17,1756,1069905,526507,543398,4456,4439,17,74,31,19/1/2022 7:23
3/6/2021,Surin,1,181,1377402,685400,692002,10395,10377,18,,,19/1/2022 7:23
3/6/2021,Sukhothai,0,120,586606,284242,302364,7337,7029,308,,,19/1/2022 7:23
3/6/2021,Nong Khai,1,79,517219,256618,260601,12678,12669,9,33,14,19/1/2022 7:23
3/6/2021,Nong Bua Lam Phu,5,63,509323,254117,255206,3248,3248,0,,,19/1/2022 7:23
3/6/2021,Amnat Charoen,0,54,376371,187343,189028,2235,2235,0,,,19/1/2022 7:23
3/6/2021,Udon Thani,3,505,1567321,776506,790815,16592,16582,10,,,19/1/2022 7:23
3/6/2021,Uttaradit,0,95,447366,218091,229275,7129,7129,0,,,19/1/2022 7:23
3/6/2021,Uthai Thani,0,41,325515,159149,166366,2979,2979,0,,,19/1/2022 7:23
3/6/2021,Ubon Ratchathani,1,372,1867065,932291,934774,19665,19665,0,71,36,19/1/2022 7:23
3/6/2021,Ang Thong,9,314,275836,132062,143774,2258,2258,0,,,19/1/2022 7:23
3/6/2021,Chiang Rai,4,725,1297104,630696,666408,26342,26054,288,84,12,19/1/2022 7:23
3/6/2021,Chiang Mai,120,8409,1786156,863211,922945,80431,79438,993,85,40,19/1/2022 7:23
3/6/2021,Phetchaburi,380,6834,482299,232776,249523,41434,41240,194,,,19/1/2022 7:23
3/6/2021,Phetchabun,2,171,979800,483288,496512,23760,23760,0,,,19/1/2022 7:23
3/6/2021,Loei,0,100,638445,319953,318492,5204,5185,19,49,31,19/1/2022 7:23
3/6/2021,Phrae,0,88,435883,210160,225723,6005,6005,0,69,37,19/1/2022 7:23
3/6/2021,Mae Hong Son,0,54,285642,144738,140904,8603,8391,212,93,28,19/1/2022 7:23
3/6/2021,,0,153,,,,,,,,,19/1/2022 7:23
4/6/2021,Krabi,0,334,478523,237695,240828,2661,2547,114,,,19/1/2022 7:23
4/6/2021,Bangkok,941,65620,5557605,2607913,2949692,256622,230749,25873,55,26,19/1/2022 7:23
4/6/2021,Kanchanaburi,12,353,892655,447517,445138,61297,61077,220,46,16,19/1/2022 7:23
4/6/2021,Kalasin,1,121,976880,483049,493831,2792,2792,0,,,19/1/2022 7:23
4/6/2021,Kamphaeng Phet,2,155,713388,352344,361044,7265,7265,0,,,19/1/2022 7:23
4/6/2021,Khon Kaen,0,538,1792631,881416,911215,39567,39567,0,78,50,19/1/2022 7:23
4/6/2021,Chanthaburi,22,1119,535759,262053,273706,20687,20602,85,,,19/1/2022 7:23
4/6/2021,Chachoengsao,82,2482,722120,354040,368080,4415,4415,0,59,33,19/1/2022 7:23
4/6/2021,Chon Buri,101,6492,1576670,769103,807567,41441,40719,722,60,29,19/1/2022 7:23
4/6/2021,Chai Nat,1,98,321397,154547,166850,5221,5221,0,,,19/1/2022 7:23
4/6/2021,Chaiyaphum,2,321,1123720,555261,568459,6515,6506,9,,,19/1/2022 7:23
4/6/2021,Chumphon,0,128,509518,251488,258030,2539,2539,0,,,19/1/2022 7:23
4/6/2021,Trang,34,979,640151,313123,327028,3134,3134,0,,,19/1/2022 7:23
4/6/2021,Trat,0,159,228460,112953,115507,19181,19065,116,,,19/1/2022 7:23
4/6/2021,Tak,7,646,674065,340821,333244,16539,16539,0,,,19/1/2022 7:23
4/6/2021,Nakhon Nayok,2,291,259655,128067,131588,4620,4620,0,,,19/1/2022 7:23
4/6/2021,Nakhon Pathom,36,1640,922334,443151,479183,8757,8744,13,50,20,19/1/2022 7:23
4/6/2021,Nakhon Phanom,0,141,717157,357396,359761,5327,5318,9,,,19/1/2022 7:23
4/6/2021,Nakhon Ratchasima,5,986,2633864,1294474,1339390,120449,119801,648,65,36,19/1/2022 7:23
4/6/2021,Nakhon Si Thammarat,0,901,1549931,764739,785192,9919,9919,0,,,19/1/2022 7:23
4/6/2021,Nakhon Sawan,7,515,1037728,506276,531452,18315,18315,0,68,32,19/1/2022 7:23
4/6/2021,Nonthaburi,153,15004,1283748,597411,686337,2979,2961,18,32,17,19/1/2022 7:23
4/6/2021,Narathiwat,3,1089,807983,399778,408205,613,613,0,43,18,19/1/2022 7:23
4/6/2021,Nan,0,121,476110,238240,237870,12538,12477,61,,,19/1/2022 7:23
4/6/2021,Bueng Kan,2,35,422320,211778,210542,3482,3477,5,,,19/1/2022 7:23
4/6/2021,Buri Ram,3,214,1580295,784354,795941,23788,23726,62,,,19/1/2022 7:23
4/6/2021,Pathum Thani,463,5066,1184377,561210,623167,1664,1645,19,47,16,19/1/2022 7:23
4/6/2021,Prachuap Khiri Khan,9,1737,551074,272744,278330,36899,36826,73,,,19/1/2022 7:23
4/6/2021,Prachin Buri,1,406,494401,244052,250349,3921,3921,0,67,32,19/1/2022 7:23
4/6/2021,Pattani,21,477,728135,359504,368631,837,837,0,,,19/1/2022 7:23
4/6/2021,Phra Nakhon Si Ayutthaya,30,1406,820129,394020,426109,61845,61474,371,45,39,19/1/2022 7:23
4/6/2021,Phayao,0,98,465644,226629,239015,8699,8699,0,57,20,19/1/2022 7:23
4/6/2021,Phang-nga,0,71,268563,134041,134522,5909,5544,365,,,19/1/2022 7:23
4/6/2021,Phatthalung,0,435,523027,254844,268183,2836,2836,0,,,19/1/2022 7:23
4/6/2021,Phichit,0,152,531180,259128,272052,6377,6377,0,,,19/1/2022 7:23
4/6/2021,Phitsanulok,4,356,847068,414386,432682,28588,28523,65,,,19/1/2022 7:23
4/6/2021,Phuket,1,894,415684,196375,219309,28777,28224,553,61,24,19/1/2022 7:23
4/6/2021,Maha Sarakham,5,377,950820,466360,484460,3552,3552,0,,,19/1/2022 7:23
4/6/2021,Mukdahan,1,43,351117,175421,175696,6539,6539,0,,,19/1/2022 7:23
4/6/2021,Yala,8,512,540726,269152,271574,923,923,0,45,17,19/1/2022 7:23
4/6/2021,Yasothon,0,143,533972,266534,267438,1630,1630,0,,,19/1/2022 7:23
4/6/2021,Ranong,11,884,194715,98283,96432,2092,2092,0,,,19/1/2022 7:23
4/6/2021,Rayong,30,1587,747267,367184,380083,23374,23094,280,51,35,19/1/2022 7:23
4/6/2021,Ratchaburi,15,851,869140,422590,446550,13639,13639,0,,,19/1/2022 7:23
4/6/2021,Roi Et,0,267,1297189,642792,654397,3901,3901,0,,,19/1/2022 7:23
4/6/2021,Lop Buri,7,328,739289,367896,371393,8701,8660,41,,,19/1/2022 7:23
4/6/2021,Lampang,0,270,726902,354357,372545,6899,6564,335,70,29,19/1/2022 7:23
4/6/2021,Lamphun,1,305,401818,193230,208588,7266,7171,95,,,19/1/2022 7:23
4/6/2021,Si Sa Ket,1,422,1457790,725911,731879,4874,4874,0,,,19/1/2022 7:23
4/6/2021,Sakon Nakhon,1,130,1146926,570016,576910,5542,5542,0,,,19/1/2022 7:23
4/6/2021,Songkhla,54,2079,1429245,696525,732720,2071,2048,23,72,30,19/1/2022 7:23
4/6/2021,Satun,0,48,324391,161409,162982,3087,3058,29,46,16,19/1/2022 7:23
4/6/2021,Samut Prakarn,202,9029,1355249,645868,709381,2956,2895,61,,,19/1/2022 7:23
4/6/2021,Samut Songkhram,6,322,191737,91607,100130,17315,17259,56,35,14,19/1/2022 7:23
4/6/2021,Samut Sakhon,73,19990,587191,283020,304171,1347,1347,0,55,34,19/1/2022 7:23
4/6/2021,Saraburi,9,923,643677,316181,327496,14753,14707,46,55,45,19/1/2022 7:23
4/6/2021,Sa kaeo,33,964,561052,279978,281074,2761,2761,0,28,19,19/1/2022 7:23
4/6/2021,Sing Buri,1,126,205344,97567,107777,3421,3421,0,,,19/1/2022 7:23
4/6/2021,Suphan Buri,7,464,837218,404081,433137,20061,20061,0,,,19/1/2022 7:23
4/6/2021,Surat Thani,5,1761,1069905,526507,543398,4456,4439,17,71,36,19/1/2022 7:23
4/6/2021,Surin,0,181,1377402,685400,692002,10395,10377,18,,,19/1/2022 7:23
4/6/2021,Sukhothai,0,120,586606,284242,302364,7337,7029,308,,,19/1/2022 7:23
4/6/2021,Nong Khai,1,80,517219,256618,260601,12678,12669,9,36,11,19/1/2022 7:23
4/6/2021,Nong Bua Lam Phu,0,63,509323,254117,255206,3248,3248,0,,,19/1/2022 7:23
4/6/2021,Amnat Charoen,0,54,376371,187343,189028,2235,2235,0,,,19/1/2022 7:23
4/6/2021,Udon Thani,0,505,1567321,776506,790815,16592,16582,10,,,19/1/2022 7:23
4/6/2021,Uttaradit,2,97,447366,218091,229275,7129,7129,0,,,19/1/2022 7:23
4/6/2021,Uthai Thani,2,43,325515,159149,166366,2979,2979,0,,,19/1/2022 7:23
4/6/2021,Ubon Ratchathani,1,373,1867065,932291,934774,19665,19665,0,62,23,19/1/2022 7:23
4/6/2021,Ang Thong,7,321,275836,132062,143774,2258,2258,0,,,19/1/2022 7:23
4/6/2021,Chiang Rai,0,725,1297104,630696,666408,26342,26054,288,41,10,19/1/2022 7:23
4/6/2021,Chiang Mai,1,8410,1786156,863211,922945,80431,79438,993,85,23,19/1/2022 7:23
4/6/2021,Phetchaburi,198,7032,482299,232776,249523,41434,41240,194,,,19/1/2022 7:23
4/6/2021,Phetchabun,0,171,979800,483288,496512,23760,23760,0,,,19/1/2022 7:23
4/6/2021,Loei,4,104,638445,319953,318492,5204,5185,19,57,27,19/1/2022 7:23
4/6/2021,Phrae,0,88,435883,210160,225723,6005,6005,0,73,18,19/1/2022 7:23
4/6/2021,Mae Hong Son,0,54,285642,144738,140904,8603,8391,212,84,8,19/1/2022 7:23
4/6/2021,,0,153,,,,,,,,,19/1/2022 7:23
5/6/2021,Krabi,1,335,478523,237695,240828,2661,2547,114,,,19/1/2022 7:23
5/6/2021,Bangkok,1084,66704,5557605,2607913,2949692,256622,230749,25873,56,23,19/1/2022 7:23
5/6/2021,Kanchanaburi,1,354,892655,447517,445138,61297,61077,220,43,12,19/1/2022 7:23
5/6/2021,Kalasin,1,122,976880,483049,493831,2792,2792,0,,,19/1/2022 7:23
5/6/2021,Kamphaeng Phet,1,156,713388,352344,361044,7265,7265,0,,,19/1/2022 7:23
5/6/2021,Khon Kaen,0,538,1792631,881416,911215,39567,39567,0,87,44,19/1/2022 7:23
5/6/2021,Chanthaburi,26,1145,535759,262053,273706,20687,20602,85,,,19/1/2022 7:23
5/6/2021,Chachoengsao,89,2571,722120,354040,368080,4415,4415,0,22,30,19/1/2022 7:23
5/6/2021,Chon Buri,42,6534,1576670,769103,807567,41441,40719,722,52,20,19/1/2022 7:23
5/6/2021,Chai Nat,0,98,321397,154547,166850,5221,5221,0,,,19/1/2022 7:23
5/6/2021,Chaiyaphum,0,321,1123720,555261,568459,6515,6506,9,,,19/1/2022 7:23
5/6/2021,Chumphon,0,128,509518,251488,258030,2539,2539,0,,,19/1/2022 7:23
5/6/2021,Trang,52,1031,640151,313123,327028,3134,3134,0,,,19/1/2022 7:23
5/6/2021,Trat,0,159,228460,112953,115507,19181,19065,116,,,19/1/2022 7:23
5/6/2021,Tak,11,657,674065,340821,333244,16539,16539,0,,,19/1/2022 7:23
5/6/2021,Nakhon Nayok,4,295,259655,128067,131588,4620,4620,0,,,19/1/2022 7:23
5/6/2021,Nakhon Pathom,30,1670,922334,443151,479183,8757,8744,13,40,15,19/1/2022 7:23
5/6/2021,Nakhon Phanom,1,142,717157,357396,359761,5327,5318,9,,,19/1/2022 7:23
5/6/2021,Nakhon Ratchasima,5,991,2633864,1294474,1339390,120449,119801,648,68,25,19/1/2022 7:23
5/6/2021,Nakhon Si Thammarat,5,906,1549931,764739,785192,9919,9919,0,,,19/1/2022 7:23
5/6/2021,Nakhon Sawan,10,525,1037728,506276,531452,18315,18315,0,63,23,19/1/2022 7:23
5/6/2021,Nonthaburi,179,15183,1283748,597411,686337,2979,2961,18,29,14,19/1/2022 7:23
5/6/2021,Narathiwat,26,1115,807983,399778,408205,613,613,0,41,20,19/1/2022 7:23
5/6/2021,Nan,1,122,476110,238240,237870,12538,12477,61,,,19/1/2022 7:23
5/6/2021,Bueng Kan,0,35,422320,211778,210542,3482,3477,5,,,19/1/2022 7:23
5/6/2021,Buri Ram,2,216,1580295,784354,795941,23788,23726,62,,,19/1/2022 7:23
5/6/2021,Pathum Thani,411,5477,1184377,561210,623167,1664,1645,19,35,12,19/1/2022 7:23
5/6/2021,Prachuap Khiri Khan,35,1772,551074,272744,278330,36899,36826,73,,,19/1/2022 7:23
5/6/2021,Prachin Buri,5,411,494401,244052,250349,3921,3921,0,62,26,19/1/2022 7:23
5/6/2021,Pattani,9,486,728135,359504,368631,837,837,0,,,19/1/2022 7:23
5/6/2021,Phra Nakhon Si Ayutthaya,49,1455,820129,394020,426109,61845,61474,371,42,35,19/1/2022 7:23
5/6/2021,Phayao,0,98,465644,226629,239015,8699,8699,0,45,21,19/1/2022 7:23
5/6/2021,Phang-nga,0,71,268563,134041,134522,5909,5544,365,,,19/1/2022 7:23
5/6/2021,Phatthalung,3,438,523027,254844,268183,2836,2836,0,,,19/1/2022 7:23
5/6/2021,Phichit,0,152,531180,259128,272052,6377,6377,0,,,19/1/2022 7:23
5/6/2021,Phitsanulok,3,359,847068,414386,432682,28588,28523,65,,,19/1/2022 7:23
5/6/2021,Phuket,1,895,415684,196375,219309,28777,28224,553,55,28,19/1/2022 7:23
5/6/2021,Maha Sarakham,3,380,950820,466360,484460,3552,3552,0,,,19/1/2022 7:23
5/6/2021,Mukdahan,0,43,351117,175421,175696,6539,6539,0,,,19/1/2022 7:23
5/6/2021,Yala,4,516,540726,269152,271574,923,923,0,45,18,19/1/2022 7:23
5/6/2021,Yasothon,0,143,533972,266534,267438,1630,1630,0,,,19/1/2022 7:23
5/6/2021,Ranong,3,887,194715,98283,96432,2092,2092,0,,,19/1/2022 7:23
5/6/2021,Rayong,15,1602,747267,367184,380083,23374,23094,280,49,29,19/1/2022 7:23
5/6/2021,Ratchaburi,13,864,869140,422590,446550,13639,13639,0,,,19/1/2022 7:23
5/6/2021,Roi Et,1,268,1297189,642792,654397,3901,3901,0,,,19/1/2022 7:23
5/6/2021,Lop Buri,6,334,739289,367896,371393,8701,8660,41,,,19/1/2022 7:23
5/6/2021,Lampang,0,270,726902,354357,372545,6899,6564,335,52,30,19/1/2022 7:23
5/6/2021,Lamphun,0,305,401818,193230,208588,7266,7171,95,,,19/1/2022 7:23
5/6/2021,Si Sa Ket,3,425,1457790,725911,731879,4874,4874,0,,,19/1/2022 7:23
5/6/2021,Sakon Nakhon,1,131,1146926,570016,576910,5542,5542,0,,,19/1/2022 7:23
5/6/2021,Songkhla,38,2117,1429245,696525,732720,2071,2048,23,65,33,19/1/2022 7:23
5/6/2021,Satun,0,48,324391,161409,162982,3087,3058,29,34,16,19/1/2022 7:23
5/6/2021,Samut Prakarn,143,9172,1355249,645868,709381,2956,2895,61,,,19/1/2022 7:23
5/6/2021,Samut Songkhram,6,328,191737,91607,100130,17315,17259,56,31,12,19/1/2022 7:23
5/6/2021,Samut Sakhon,293,20283,587191,283020,304171,1347,1347,0,64,32,19/1/2022 7:23
5/6/2021,Saraburi,22,945,643677,316181,327496,14753,14707,46,62,46,19/1/2022 7:23
5/6/2021,Sa kaeo,28,992,561052,279978,281074,2761,2761,0,28,15,19/1/2022 7:23
5/6/2021,Sing Buri,0,126,205344,97567,107777,3421,3421,0,,,19/1/2022 7:23
5/6/2021,Suphan Buri,0,464,837218,404081,433137,20061,20061,0,,,19/1/2022 7:23
5/6/2021,Surat Thani,9,1770,1069905,526507,543398,4456,4439,17,75,35,19/1/2022 7:23
5/6/2021,Surin,5,186,1377402,685400,692002,10395,10377,18,,,19/1/2022 7:23
5/6/2021,Sukhothai,0,120,586606,284242,302364,7337,7029,308,,,19/1/2022 7:23
5/6/2021,Nong Khai,1,81,517219,256618,260601,12678,12669,9,28,12,19/1/2022 7:23
5/6/2021,Nong Bua Lam Phu,0,63,509323,254117,255206,3248,3248,0,,,19/1/2022 7:23
5/6/2021,Amnat Charoen,1,55,376371,187343,189028,2235,2235,0,,,19/1/2022 7:23
5/6/2021,Udon Thani,0,505,1567321,776506,790815,16592,16582,10,,,19/1/2022 7:23
5/6/2021,Uttaradit,0,97,447366,218091,229275,7129,7129,0,,,19/1/2022 7:23
5/6/2021,Uthai Thani,0,43,325515,159149,166366,2979,2979,0,,,19/1/2022 7:23
5/6/2021,Ubon Ratchathani,0,373,1867065,932291,934774,19665,19665,0,45,20,19/1/2022 7:23
5/6/2021,Ang Thong,1,322,275836,132062,143774,2258,2258,0,,,19/1/2022 7:23
5/6/2021,Chiang Rai,0,725,1297104,630696,666408,26342,26054,288,34,14,19/1/2022 7:23
5/6/2021,Chiang Mai,3,8413,1786156,863211,922945,80431,79438,993,57,29,19/1/2022 7:23
5/6/2021,Phetchaburi,130,7162,482299,232776,249523,41434,41240,194,,,19/1/2022 7:23
5/6/2021,Phetchabun,0,171,979800,483288,496512,23760,23760,0,,,19/1/2022 7:23
5/6/2021,Loei,1,105,638445,319953,318492,5204,5185,19,55,22,19/1/2022 7:23
5/6/2021,Phrae,0,88,435883,210160,225723,6005,6005,0,48,18,19/1/2022 7:23
5/6/2021,Mae Hong Son,0,54,285642,144738,140904,8603,8391,212,37,12,19/1/2022 7:23
5/6/2021,,0,153,,,,,,,,,19/1/2022 7:23
6/6/2021,Krabi,0,335,478523,237695,240828,2661,2547,114,,,19/1/2022 7:23
6/6/2021,Bangkok,1101,67805,5557605,2607913,2949692,256622,230749,25873,49,21,19/1/2022 7:23
6/6/2021,Kanchanaburi,3,357,892655,447517,445138,61297,61077,220,32,12,19/1/2022 7:23
6/6/2021,Kalasin,1,123,976880,483049,493831,2792,2792,0,,,19/1/2022 7:23
6/6/2021,Kamphaeng Phet,1,157,713388,352344,361044,7265,7265,0,,,19/1/2022 7:23
6/6/2021,Khon Kaen,0,538,1792631,881416,911215,39567,39567,0,74,29,19/1/2022 7:23
6/6/2021,Chanthaburi,21,1166,535759,262053,273706,20687,20602,85,,,19/1/2022 7:23
6/6/2021,Chachoengsao,210,2781,722120,354040,368080,4415,4415,0,32,30,19/1/2022 7:23
6/6/2021,Chon Buri,28,6562,1576670,769103,807567,41441,40719,722,39,26,19/1/2022 7:23
6/6/2021,Chai Nat,0,98,321397,154547,166850,5221,5221,0,,,19/1/2022 7:23
6/6/2021,Chaiyaphum,3,324,1123720,555261,568459,6515,6506,9,,,19/1/2022 7:23
6/6/2021,Chumphon,1,129,509518,251488,258030,2539,2539,0,,,19/1/2022 7:23
6/6/2021,Trang,58,1089,640151,313123,327028,3134,3134,0,,,19/1/2022 7:23
6/6/2021,Trat,0,159,228460,112953,115507,19181,19065,116,,,19/1/2022 7:23
6/6/2021,Tak,0,657,674065,340821,333244,16539,16539,0,,,19/1/2022 7:23
6/6/2021,Nakhon Nayok,11,306,259655,128067,131588,4620,4620,0,,,19/1/2022 7:23
6/6/2021,Nakhon Pathom,19,1689,922334,443151,479183,8757,8744,13,35,14,19/1/2022 7:23
6/6/2021,Nakhon Phanom,0,142,717157,357396,359761,5327,5318,9,,,19/1/2022 7:23
6/6/2021,Nakhon Ratchasima,0,991,2633864,1294474,1339390,120449,119801,648,50,23,19/1/2022 7:23
6/6/2021,Nakhon Si Thammarat,3,909,1549931,764739,785192,9919,9919,0,,,19/1/2022 7:23
6/6/2021,Nakhon Sawan,19,544,1037728,506276,531452,18315,18315,0,43,23,19/1/2022 7:23
6/6/2021,Nonthaburi,167,15350,1283748,597411,686337,2979,2961,18,23,13,19/1/2022 7:23
6/6/2021,Narathiwat,22,1137,807983,399778,408205,613,613,0,43,24,19/1/2022 7:23
6/6/2021,Nan,0,122,476110,238240,237870,12538,12477,61,,,19/1/2022 7:23
6/6/2021,Bueng Kan,0,35,422320,211778,210542,3482,3477,5,,,19/1/2022 7:23
6/6/2021,Buri Ram,2,218,1580295,784354,795941,23788,23726,62,,,19/1/2022 7:23
6/6/2021,Pathum Thani,51,5528,1184377,561210,623167,1664,1645,19,28,13,19/1/2022 7:23
6/6/2021,Prachuap Khiri Khan,18,1790,551074,272744,278330,36899,36826,73,,,19/1/2022 7:23
6/6/2021,Prachin Buri,4,415,494401,244052,250349,3921,3921,0,57,23,19/1/2022 7:23
6/6/2021,Pattani,3,489,728135,359504,368631,837,837,0,,,19/1/2022 7:23
6/6/2021,Phra Nakhon Si Ayutthaya,44,1499,820129,394020,426109,61845,61474,371,33,35,19/1/2022 7:23
6/6/2021,Phayao,0,98,465644,226629,239015,8699,8699,0,49,23,19/1/2022 7:23
6/6/2021,Phang-nga,0,71,268563,134041,134522,5909,5544,365,,,19/1/2022 7:23
6/6/2021,Phatthalung,6,444,523027,254844,268183,2836,2836,0,,,19/1/2022 7:23
6/6/2021,Phichit,0,152,531180,259128,272052,6377,6377,0,,,19/1/2022 7:23
6/6/2021,Phitsanulok,0,359,847068,414386,432682,28588,28523,65,,,19/1/2022 7:23
6/6/2021,Phuket,1,896,415684,196375,219309,28777,28224,553,58,34,19/1/2022 7:23
6/6/2021,Maha Sarakham,4,384,950820,466360,484460,3552,3552,0,,,19/1/2022 7:23
6/6/2021,Mukdahan,1,44,351117,175421,175696,6539,6539,0,,,19/1/2022 7:23
6/6/2021,Yala,1,517,540726,269152,271574,923,923,0,42,24,19/1/2022 7:23
6/6/2021,Yasothon,0,143,533972,266534,267438,1630,1630,0,,,19/1/2022 7:23
6/6/2021,Ranong,10,897,194715,98283,96432,2092,2092,0,,,19/1/2022 7:23
6/6/2021,Rayong,8,1610,747267,367184,380083,23374,23094,280,38,29,19/1/2022 7:23
6/6/2021,Ratchaburi,12,876,869140,422590,446550,13639,13639,0,,,19/1/2022 7:23
6/6/2021,Roi Et,2,270,1297189,642792,654397,3901,3901,0,,,19/1/2022 7:23
6/6/2021,Lop Buri,11,345,739289,367896,371393,8701,8660,41,,,19/1/2022 7:23
6/6/2021,Lampang,0,270,726902,354357,372545,6899,6564,335,55,27,19/1/2022 7:23
6/6/2021,Lamphun,1,306,401818,193230,208588,7266,7171,95,,,19/1/2022 7:23
6/6/2021,Si Sa Ket,1,426,1457790,725911,731879,4874,4874,0,,,19/1/2022 7:23
6/6/2021,Sakon Nakhon,0,131,1146926,570016,576910,5542,5542,0,,,19/1/2022 7:23
6/6/2021,Songkhla,91,2208,1429245,696525,732720,2071,2048,23,63,34,19/1/2022 7:23
6/6/2021,Satun,0,48,324391,161409,162982,3087,3058,29,26,22,19/1/2022 7:23
6/6/2021,Samut Prakarn,124,9296,1355249,645868,709381,2956,2895,61,,,19/1/2022 7:23
6/6/2021,Samut Songkhram,7,335,191737,91607,100130,17315,17259,56,29,11,19/1/2022 7:23
6/6/2021,Samut Sakhon,288,20571,587191,283020,304171,1347,1347,0,58,29,19/1/2022 7:23
6/6/2021,Saraburi,15,960,643677,316181,327496,14753,14707,46,49,44,19/1/2022 7:23
6/6/2021,Sa kaeo,60,1052,561052,279978,281074,2761,2761,0,19,11,19/1/2022 7:23
6/6/2021,Sing Buri,8,134,205344,97567,107777,3421,3421,0,,,19/1/2022 7:23
6/6/2021,Suphan Buri,8,472,837218,404081,433137,20061,20061,0,,,19/1/2022 7:23
6/6/2021,Surat Thani,6,1776,1069905,526507,543398,4456,4439,17,73,33,19/1/2022 7:23
6/6/2021,Surin,2,188,1377402,685400,692002,10395,10377,18,,,19/1/2022 7:23
6/6/2021,Sukhothai,2,122,586606,284242,302364,7337,7029,308,,,19/1/2022 7:23
6/6/2021,Nong Khai,4,85,517219,256618,260601,12678,12669,9,30,10,19/1/2022 7:23
6/6/2021,Nong Bua Lam Phu,2,65,509323,254117,255206,3248,3248,0,,,19/1/2022 7:23
6/6/2021,Amnat Charoen,0,55,376371,187343,189028,2235,2235,0,,,19/1/2022 7:23
6/6/2021,Udon Thani,0,505,1567321,776506,790815,16592,16582,10,,,19/1/2022 7:23
6/6/2021,Uttaradit,0,97,447366,218091,229275,7129,7129,0,,,19/1/2022 7:23
6/6/2021,Uthai Thani,1,44,325515,159149,166366,2979,2979,0,,,19/1/2022 7:23
6/6/2021,Ubon Ratchathani,2,375,1867065,932291,934774,19665,19665,0,44,13,19/1/2022 7:23
6/6/2021,Ang Thong,3,325,275836,132062,143774,2258,2258,0,,,19/1/2022 7:23
6/6/2021,Chiang Rai,1,726,1297104,630696,666408,26342,26054,288,47,15,19/1/2022 7:23
6/6/2021,Chiang Mai,0,8413,1786156,863211,922945,80431,79438,993,64,27,19/1/2022 7:23
6/6/2021,Phetchaburi,196,7358,482299,232776,249523,41434,41240,194,,,19/1/2022 7:23
6/6/2021,Phetchabun,1,172,979800,483288,496512,23760,23760,0,,,19/1/2022 7:23
6/6/2021,Loei,2,107,638445,319953,318492,5204,5185,19,46,19,19/1/2022 7:23
6/6/2021,Phrae,0,88,435883,210160,225723,6005,6005,0,47,18,19/1/2022 7:23
6/6/2021,Mae Hong Son,0,54,285642,144738,140904,8603,8391,212,51,17,19/1/2022 7:23
6/6/2021,,0,153,,,,,,,,,19/1/2022 7:23
7/6/2021,Krabi,2,337,478523,237695,240828,2661,2547,114,,,19/1/2022 7:23
7/6/2021,Bangkok,950,68755,5557605,2607913,2949692,256622,230749,25873,45,21,19/1/2022 7:23
7/6/2021,Kanchanaburi,0,357,892655,447517,445138,61297,61077,220,33,13,19/1/2022 7:23
7/6/2021,Kalasin,8,131,976880,483049,493831,2792,2792,0,,,19/1/2022 7:23
7/6/2021,Kamphaeng Phet,1,158,713388,352344,361044,7265,7265,0,,,19/1/2022 7:23
7/6/2021,Khon Kaen,3,541,1792631,881416,911215,39567,39567,0,61,32,19/1/2022 7:23
7/6/2021,Chanthaburi,6,1172,535759,262053,273706,20687,20602,85,,,19/1/2022 7:23
7/6/2021,Chachoengsao,98,2879,722120,354040,368080,4415,4415,0,44,35,19/1/2022 7:23
7/6/2021,Chon Buri,53,6615,1576670,769103,807567,41441,40719,722,38,29,19/1/2022 7:23
7/6/2021,Chai Nat,0,98,321397,154547,166850,5221,5221,0,,,19/1/2022 7:23
7/6/2021,Chaiyaphum,0,324,1123720,555261,568459,6515,6506,9,,,19/1/2022 7:23
7/6/2021,Chumphon,0,129,509518,251488,258030,2539,2539,0,,,19/1/2022 7:23
7/6/2021,Trang,106,1195,640151,313123,327028,3134,3134,0,,,19/1/2022 7:23
7/6/2021,Trat,0,159,228460,112953,115507,19181,19065,116,,,19/1/2022 7:23
7/6/2021,Tak,2,659,674065,340821,333244,16539,16539,0,,,19/1/2022 7:23
7/6/2021,Nakhon Nayok,9,315,259655,128067,131588,4620,4620,0,,,19/1/2022 7:23
7/6/2021,Nakhon Pathom,41,1730,922334,443151,479183,8757,8744,13,32,15,19/1/2022 7:23
7/6/2021,Nakhon Phanom,2,144,717157,357396,359761,5327,5318,9,,,19/1/2022 7:23
7/6/2021,Nakhon Ratchasima,1,992,2633864,1294474,1339390,120449,119801,648,50,23,19/1/2022 7:23
7/6/2021,Nakhon Si Thammarat,16,925,1549931,764739,785192,9919,9919,0,,,19/1/2022 7:23
7/6/2021,Nakhon Sawan,6,550,1037728,506276,531452,18315,18315,0,43,19,19/1/2022 7:23
7/6/2021,Nonthaburi,111,15461,1283748,597411,686337,2979,2961,18,21,16,19/1/2022 7:23
7/6/2021,Narathiwat,15,1152,807983,399778,408205,613,613,0,57,27,19/1/2022 7:23
7/6/2021,Nan,0,122,476110,238240,237870,12538,12477,61,,,19/1/2022 7:23
7/6/2021,Bueng Kan,1,36,422320,211778,210542,3482,3477,5,,,19/1/2022 7:23
7/6/2021,Buri Ram,2,220,1580295,784354,795941,23788,23726,62,,,19/1/2022 7:23
7/6/2021,Pathum Thani,57,5585,1184377,561210,623167,1664,1645,19,27,13,19/1/2022 7:23
7/6/2021,Prachuap Khiri Khan,45,1835,551074,272744,278330,36899,36826,73,,,19/1/2022 7:23
7/6/2021,Prachin Buri,3,418,494401,244052,250349,3921,3921,0,55,24,19/1/2022 7:23
7/6/2021,Pattani,9,498,728135,359504,368631,837,837,0,,,19/1/2022 7:23
7/6/2021,Phra Nakhon Si Ayutthaya,34,1533,820129,394020,426109,61845,61474,371,28,33,19/1/2022 7:23
7/6/2021,Phayao,0,98,465644,226629,239015,8699,8699,0,54,20,19/1/2022 7:23
7/6/2021,Phang-nga,0,71,268563,134041,134522,5909,5544,365,,,19/1/2022 7:23
7/6/2021,Phatthalung,0,444,523027,254844,268183,2836,2836,0,,,19/1/2022 7:23
7/6/2021,Phichit,0,152,531180,259128,272052,6377,6377,0,,,19/1/2022 7:23
7/6/2021,Phitsanulok,0,359,847068,414386,432682,28588,28523,65,,,19/1/2022 7:23
7/6/2021,Phuket,1,897,415684,196375,219309,28777,28224,553,60,33,19/1/2022 7:23
7/6/2021,Maha Sarakham,1,385,950820,466360,484460,3552,3552,0,,,19/1/2022 7:23
7/6/2021,Mukdahan,0,44,351117,175421,175696,6539,6539,0,,,19/1/2022 7:23
7/6/2021,Yala,13,530,540726,269152,271574,923,923,0,54,27,19/1/2022 7:23
7/6/2021,Yasothon,0,143,533972,266534,267438,1630,1630,0,,,19/1/2022 7:23
7/6/2021,Ranong,7,904,194715,98283,96432,2092,2092,0,,,19/1/2022 7:23
7/6/2021,Rayong,16,1626,747267,367184,380083,23374,23094,280,35,32,19/1/2022 7:23
7/6/2021,Ratchaburi,22,898,869140,422590,446550,13639,13639,0,,,19/1/2022 7:23
7/6/2021,Roi Et,1,271,1297189,642792,654397,3901,3901,0,,,19/1/2022 7:23
7/6/2021,Lop Buri,2,347,739289,367896,371393,8701,8660,41,,,19/1/2022 7:23
7/6/2021,Lampang,0,270,726902,354357,372545,6899,6564,335,48,20,19/1/2022 7:23
7/6/2021,Lamphun,0,306,401818,193230,208588,7266,7171,95,,,19/1/2022 7:23
7/6/2021,Si Sa Ket,2,428,1457790,725911,731879,4874,4874,0,,,19/1/2022 7:23
7/6/2021,Sakon Nakhon,0,131,1146926,570016,576910,5542,5542,0,,,19/1/2022 7:23
7/6/2021,Songkhla,21,2229,1429245,696525,732720,2071,2048,23,58,38,19/1/2022 7:23
7/6/2021,Satun,0,48,324391,161409,162982,3087,3058,29,36,20,19/1/2022 7:23
7/6/2021,Samut Prakarn,321,9617,1355249,645868,709381,2956,2895,61,,,19/1/2022 7:23
7/6/2021,Samut Songkhram,3,338,191737,91607,100130,17315,17259,56,20,9,19/1/2022 7:23
7/6/2021,Samut Sakhon,92,20663,587191,283020,304171,1347,1347,0,44,32,19/1/2022 7:23
7/6/2021,Saraburi,16,976,643677,316181,327496,14753,14707,46,38,33,19/1/2022 7:23
7/6/2021,Sa kaeo,27,1079,561052,279978,281074,2761,2761,0,15,11,19/1/2022 7:23
7/6/2021,Sing Buri,3,137,205344,97567,107777,3421,3421,0,,,19/1/2022 7:23
7/6/2021,Suphan Buri,4,476,837218,404081,433137,20061,20061,0,,,19/1/2022 7:23
7/6/2021,Surat Thani,7,1783,1069905,526507,543398,4456,4439,17,70,37,19/1/2022 7:23
7/6/2021,Surin,1,189,1377402,685400,692002,10395,10377,18,,,19/1/2022 7:23
7/6/2021,Sukhothai,1,123,586606,284242,302364,7337,7029,308,,,19/1/2022 7:23
7/6/2021,Nong Khai,1,86,517219,256618,260601,12678,12669,9,24,9,19/1/2022 7:23
7/6/2021,Nong Bua Lam Phu,2,67,509323,254117,255206,3248,3248,0,,,19/1/2022 7:23
7/6/2021,Amnat Charoen,0,55,376371,187343,189028,2235,2235,0,,,19/1/2022 7:23
7/6/2021,Udon Thani,4,509,1567321,776506,790815,16592,16582,10,,,19/1/2022 7:23
7/6/2021,Uttaradit,0,97,447366,218091,229275,7129,7129,0,,,19/1/2022 7:23
7/6/2021,Uthai Thani,0,44,325515,159149,166366,2979,2979,0,,,19/1/2022 7:23
7/6/2021,Ubon Ratchathani,0,375,1867065,932291,934774,19665,19665,0,28,15,19/1/2022 7:23
7/6/2021,Ang Thong,1,326,275836,132062,143774,2258,2258,0,,,19/1/2022 7:23
7/6/2021,Chiang Rai,1,727,1297104,630696,666408,26342,26054,288,50,13,19/1/2022 7:23
7/6/2021,Chiang Mai,1,8414,1786156,863211,922945,80431,79438,993,63,28,19/1/2022 7:23
7/6/2021,Phetchaburi,265,7623,482299,232776,249523,41434,41240,194,,,19/1/2022 7:23
7/6/2021,Phetchabun,2,174,979800,483288,496512,23760,23760,0,,,19/1/2022 7:23
7/6/2021,Loei,0,107,638445,319953,318492,5204,5185,19,41,18,19/1/2022 7:23
7/6/2021,Phrae,0,88,435883,210160,225723,6005,6005,0,45,20,19/1/2022 7:23
7/6/2021,Mae Hong Son,0,54,285642,144738,140904,8603,8391,212,64,18,19/1/2022 7:23
7/6/2021,,0,153,,,,,,,,,19/1/2022 7:23
8/6/2021,Krabi,0,337,478523,237695,240828,2661,2547,114,,,19/1/2022 7:23
8/6/2021,Bangkok,1105,69860,5557605,2607913,2949692,256622,230749,25873,46,16,19/1/2022 7:23
8/6/2021,Kanchanaburi,2,359,892655,447517,445138,61297,61077,220,33,13,19/1/2022 7:23
8/6/2021,Kalasin,1,132,976880,483049,493831,2792,2792,0,,,19/1/2022 7:23
8/6/2021,Kamphaeng Phet,1,159,713388,352344,361044,7265,7265,0,,,19/1/2022 7:23
8/6/2021,Khon Kaen,2,543,1792631,881416,911215,39567,39567,0,62,29,19/1/2022 7:23
8/6/2021,Chanthaburi,10,1182,535759,262053,273706,20687,20602,85,,,19/1/2022 7:23
8/6/2021,Chachoengsao,154,3033,722120,354040,368080,4415,4415,0,40,34,19/1/2022 7:23
8/6/2021,Chon Buri,70,6685,1576670,769103,807567,41441,40719,722,35,24,19/1/2022 7:23
8/6/2021,Chai Nat,0,98,321397,154547,166850,5221,5221,0,,,19/1/2022 7:23
8/6/2021,Chaiyaphum,0,324,1123720,555261,568459,6515,6506,9,,,19/1/2022 7:23
8/6/2021,Chumphon,4,133,509518,251488,258030,2539,2539,0,,,19/1/2022 7:23
8/6/2021,Trang,55,1250,640151,313123,327028,3134,3134,0,,,19/1/2022 7:23
8/6/2021,Trat,1,160,228460,112953,115507,19181,19065,116,,,19/1/2022 7:23
8/6/2021,Tak,2,661,674065,340821,333244,16539,16539,0,,,19/1/2022 7:23
8/6/2021,Nakhon Nayok,5,320,259655,128067,131588,4620,4620,0,,,19/1/2022 7:23
8/6/2021,Nakhon Pathom,58,1788,922334,443151,479183,8757,8744,13,33,11,19/1/2022 7:23
8/6/2021,Nakhon Phanom,0,144,717157,357396,359761,5327,5318,9,,,19/1/2022 7:23
8/6/2021,Nakhon Ratchasima,2,994,2633864,1294474,1339390,120449,119801,648,50,16,19/1/2022 7:23
8/6/2021,Nakhon Si Thammarat,7,932,1549931,764739,785192,9919,9919,0,,,19/1/2022 7:23
8/6/2021,Nakhon Sawan,4,554,1037728,506276,531452,18315,18315,0,35,21,19/1/2022 7:23
8/6/2021,Nonthaburi,493,15954,1283748,597411,686337,2979,2961,18,20,14,19/1/2022 7:23
8/6/2021,Narathiwat,5,1157,807983,399778,408205,613,613,0,63,25,19/1/2022 7:23
8/6/2021,Nan,1,123,476110,238240,237870,12538,12477,61,,,19/1/2022 7:23
8/6/2021,Bueng Kan,0,36,422320,211778,210542,3482,3477,5,,,19/1/2022 7:23
8/6/2021,Buri Ram,1,221,1580295,784354,795941,23788,23726,62,,,19/1/2022 7:23
8/6/2021,Pathum Thani,80,5665,1184377,561210,623167,1664,1645,19,32,12,19/1/2022 7:23
8/6/2021,Prachuap Khiri Khan,27,1862,551074,272744,278330,36899,36826,73,,,19/1/2022 7:23
8/6/2021,Prachin Buri,3,421,494401,244052,250349,3921,3921,0,53,25,19/1/2022 7:23
8/6/2021,Pattani,5,503,728135,359504,368631,837,837,0,,,19/1/2022 7:23
8/6/2021,Phra Nakhon Si Ayutthaya,35,1568,820129,394020,426109,61845,61474,371,30,34,19/1/2022 7:23
8/6/2021,Phayao,0,98,465644,226629,239015,8699,8699,0,47,15,19/1/2022 7:23
8/6/2021,Phang-nga,0,71,268563,134041,134522,5909,5544,365,,,19/1/2022 7:23
8/6/2021,Phatthalung,7,451,523027,254844,268183,2836,2836,0,,,19/1/2022 7:23
8/6/2021,Phichit,0,152,531180,259128,272052,6377,6377,0,,,19/1/2022 7:23
8/6/2021,Phitsanulok,0,359,847068,414386,432682,28588,28523,65,,,19/1/2022 7:23
8/6/2021,Phuket,2,899,415684,196375,219309,28777,28224,553,58,25,19/1/2022 7:23
8/6/2021,Maha Sarakham,2,387,950820,466360,484460,3552,3552,0,,,19/1/2022 7:23
8/6/2021,Mukdahan,0,44,351117,175421,175696,6539,6539,0,,,19/1/2022 7:23
8/6/2021,Yala,9,539,540726,269152,271574,923,923,0,60,33,19/1/2022 7:23
8/6/2021,Yasothon,0,143,533972,266534,267438,1630,1630,0,,,19/1/2022 7:23
8/6/2021,Ranong,19,923,194715,98283,96432,2092,2092,0,,,19/1/2022 7:23
8/6/2021,Rayong,9,1635,747267,367184,380083,23374,23094,280,49,31,19/1/2022 7:23
8/6/2021,Ratchaburi,13,911,869140,422590,446550,13639,13639,0,,,19/1/2022 7:23
8/6/2021,Roi Et,0,271,1297189,642792,654397,3901,3901,0,,,19/1/2022 7:23
8/6/2021,Lop Buri,13,360,739289,367896,371393,8701,8660,41,,,19/1/2022 7:23
8/6/2021,Lampang,0,270,726902,354357,372545,6899,6564,335,40,18,19/1/2022 7:23
8/6/2021,Lamphun,0,306,401818,193230,208588,7266,7171,95,,,19/1/2022 7:23
8/6/2021,Si Sa Ket,3,431,1457790,725911,731879,4874,4874,0,,,19/1/2022 7:23
8/6/2021,Sakon Nakhon,0,131,1146926,570016,576910,5542,5542,0,,,19/1/2022 7:23
8/6/2021,Songkhla,14,2243,1429245,696525,732720,2071,2048,23,72,35,19/1/2022 7:23
8/6/2021,Satun,0,48,324391,161409,162982,3087,3058,29,46,22,19/1/2022 7:23
8/6/2021,Samut Prakarn,273,9890,1355249,645868,709381,2956,2895,61,,,19/1/2022 7:23
8/6/2021,Samut Songkhram,8,346,191737,91607,100130,17315,17259,56,16,10,19/1/2022 7:23
8/6/2021,Samut Sakhon,75,20738,587191,283020,304171,1347,1347,0,54,34,19/1/2022 7:23
8/6/2021,Saraburi,9,985,643677,316181,327496,14753,14707,46,35,51,19/1/2022 7:23
8/6/2021,Sa kaeo,1,1080,561052,279978,281074,2761,2761,0,15,11,19/1/2022 7:23
8/6/2021,Sing Buri,0,137,205344,97567,107777,3421,3421,0,,,19/1/2022 7:23
8/6/2021,Suphan Buri,4,480,837218,404081,433137,20061,20061,0,,,19/1/2022 7:23
8/6/2021,Surat Thani,9,1792,1069905,526507,543398,4456,4439,17,74,33,19/1/2022 7:23
8/6/2021,Surin,0,189,1377402,685400,692002,10395,10377,18,,,19/1/2022 7:23
8/6/2021,Sukhothai,1,124,586606,284242,302364,7337,7029,308,,,19/1/2022 7:23
8/6/2021,Nong Khai,4,90,517219,256618,260601,12678,12669,9,22,11,19/1/2022 7:23
8/6/2021,Nong Bua Lam Phu,1,68,509323,254117,255206,3248,3248,0,,,19/1/2022 7:23
8/6/2021,Amnat Charoen,0,55,376371,187343,189028,2235,2235,0,,,19/1/2022 7:23
8/6/2021,Udon Thani,0,509,1567321,776506,790815,16592,16582,10,,,19/1/2022 7:23
8/6/2021,Uttaradit,0,97,447366,218091,229275,7129,7129,0,,,19/1/2022 7:23
8/6/2021,Uthai Thani,0,44,325515,159149,166366,2979,2979,0,,,19/1/2022 7:23
8/6/2021,Ubon Ratchathani,0,375,1867065,932291,934774,19665,19665,0,30,15,19/1/2022 7:23
8/6/2021,Ang Thong,0,326,275836,132062,143774,2258,2258,0,,,19/1/2022 7:23
8/6/2021,Chiang Rai,0,727,1297104,630696,666408,26342,26054,288,44,7,19/1/2022 7:23
8/6/2021,Chiang Mai,2,8416,1786156,863211,922945,80431,79438,993,62,19,19/1/2022 7:23
8/6/2021,Phetchaburi,49,7672,482299,232776,249523,41434,41240,194,,,19/1/2022 7:23
8/6/2021,Phetchabun,2,176,979800,483288,496512,23760,23760,0,,,19/1/2022 7:23
8/6/2021,Loei,0,107,638445,319953,318492,5204,5185,19,42,16,19/1/2022 7:23
8/6/2021,Phrae,0,88,435883,210160,225723,6005,6005,0,49,12,19/1/2022 7:23
8/6/2021,Mae Hong Son,0,54,285642,144738,140904,8603,8391,212,65,5,19/1/2022 7:23
8/6/2021,,0,153,,,,,,,,,19/1/2022 7:23
9/6/2021,Krabi,1,338,478523,237695,240828,2661,2547,114,,,19/1/2022 7:23
9/6/2021,Bangkok,1100,70960,5557605,2607913,2949692,256622,230749,25873,35,14,19/1/2022 7:23
9/6/2021,Kanchanaburi,3,362,892655,447517,445138,61297,61077,220,32,9,19/1/2022 7:23
9/6/2021,Kalasin,0,132,976880,483049,493831,2792,2792,0,,,19/1/2022 7:23
9/6/2021,Kamphaeng Phet,1,160,713388,352344,361044,7265,7265,0,,,19/1/2022 7:23
9/6/2021,Khon Kaen,1,544,1792631,881416,911215,39567,39567,0,58,25,19/1/2022 7:23
9/6/2021,Chanthaburi,20,1202,535759,262053,273706,20687,20602,85,,,19/1/2022 7:23
9/6/2021,Chachoengsao,86,3119,722120,354040,368080,4415,4415,0,40,32,19/1/2022 7:23
9/6/2021,Chon Buri,41,6726,1576670,769103,807567,41441,40719,722,32,26,19/1/2022 7:23
9/6/2021,Chai Nat,0,98,321397,154547,166850,5221,5221,0,,,19/1/2022 7:23
9/6/2021,Chaiyaphum,1,325,1123720,555261,568459,6515,6506,9,,,19/1/2022 7:23
9/6/2021,Chumphon,7,140,509518,251488,258030,2539,2539,0,,,19/1/2022 7:23
9/6/2021,Trang,11,1261,640151,313123,327028,3134,3134,0,,,19/1/2022 7:23
9/6/2021,Trat,0,160,228460,112953,115507,19181,19065,116,,,19/1/2022 7:23
9/6/2021,Tak,5,666,674065,340821,333244,16539,16539,0,,,19/1/2022 7:23
9/6/2021,Nakhon Nayok,8,328,259655,128067,131588,4620,4620,0,,,19/1/2022 7:23
9/6/2021,Nakhon Pathom,21,1809,922334,443151,479183,8757,8744,13,28,10,19/1/2022 7:23
9/6/2021,Nakhon Phanom,1,145,717157,357396,359761,5327,5318,9,,,19/1/2022 7:23
9/6/2021,Nakhon Ratchasima,2,996,2633864,1294474,1339390,120449,119801,648,37,22,19/1/2022 7:23
9/6/2021,Nakhon Si Thammarat,17,949,1549931,764739,785192,9919,9919,0,,,19/1/2022 7:23
9/6/2021,Nakhon Sawan,3,557,1037728,506276,531452,18315,18315,0,41,18,19/1/2022 7:23
9/6/2021,Nonthaburi,355,16309,1283748,597411,686337,2979,2961,18,19,13,19/1/2022 7:23
9/6/2021,Narathiwat,16,1173,807983,399778,408205,613,613,0,62,22,19/1/2022 7:23
9/6/2021,Nan,0,123,476110,238240,237870,12538,12477,61,,,19/1/2022 7:23
9/6/2021,Bueng Kan,0,36,422320,211778,210542,3482,3477,5,,,19/1/2022 7:23
9/6/2021,Buri Ram,1,222,1580295,784354,795941,23788,23726,62,,,19/1/2022 7:23
9/6/2021,Pathum Thani,61,5726,1184377,561210,623167,1664,1645,19,38,14,19/1/2022 7:23
9/6/2021,Prachuap Khiri Khan,91,1953,551074,272744,278330,36899,36826,73,,,19/1/2022 7:23
9/6/2021,Prachin Buri,2,423,494401,244052,250349,3921,3921,0,60,22,19/1/2022 7:23
9/6/2021,Pattani,15,518,728135,359504,368631,837,837,0,,,19/1/2022 7:23
9/6/2021,Phra Nakhon Si Ayutthaya,35,1603,820129,394020,426109,61845,61474,371,29,29,19/1/2022 7:23
9/6/2021,Phayao,0,98,465644,226629,239015,8699,8699,0,32,16,19/1/2022 7:23
9/6/2021,Phang-nga,0,71,268563,134041,134522,5909,5544,365,,,19/1/2022 7:23
9/6/2021,Phatthalung,2,453,523027,254844,268183,2836,2836,0,,,19/1/2022 7:23
9/6/2021,Phichit,0,152,531180,259128,272052,6377,6377,0,,,19/1/2022 7:23
9/6/2021,Phitsanulok,0,359,847068,414386,432682,28588,28523,65,,,19/1/2022 7:23
9/6/2021,Phuket,1,900,415684,196375,219309,28777,28224,553,51,26,19/1/2022 7:23
9/6/2021,Maha Sarakham,2,389,950820,466360,484460,3552,3552,0,,,19/1/2022 7:23
9/6/2021,Mukdahan,0,44,351117,175421,175696,6539,6539,0,,,19/1/2022 7:23
9/6/2021,Yala,25,564,540726,269152,271574,923,923,0,60,24,19/1/2022 7:23
9/6/2021,Yasothon,0,143,533972,266534,267438,1630,1630,0,,,19/1/2022 7:23
9/6/2021,Ranong,16,939,194715,98283,96432,2092,2092,0,,,19/1/2022 7:23
9/6/2021,Rayong,14,1649,747267,367184,380083,23374,23094,280,35,33,19/1/2022 7:23
9/6/2021,Ratchaburi,34,945,869140,422590,446550,13639,13639,0,,,19/1/2022 7:23
9/6/2021,Roi Et,1,272,1297189,642792,654397,3901,3901,0,,,19/1/2022 7:23
9/6/2021,Lop Buri,3,363,739289,367896,371393,8701,8660,41,,,19/1/2022 7:23
9/6/2021,Lampang,0,270,726902,354357,372545,6899,6564,335,25,20,19/1/2022 7:23
9/6/2021,Lamphun,0,306,401818,193230,208588,7266,7171,95,,,19/1/2022 7:23
9/6/2021,Si Sa Ket,1,432,1457790,725911,731879,4874,4874,0,,,19/1/2022 7:23
9/6/2021,Sakon Nakhon,2,133,1146926,570016,576910,5542,5542,0,,,19/1/2022 7:23
9/6/2021,Songkhla,36,2279,1429245,696525,732720,2071,2048,23,68,38,19/1/2022 7:23
9/6/2021,Satun,0,48,324391,161409,162982,3087,3058,29,48,17,19/1/2022 7:23
9/6/2021,Samut Prakarn,491,10381,1355249,645868,709381,2956,2895,61,,,19/1/2022 7:23
9/6/2021,Samut Songkhram,8,354,191737,91607,100130,17315,17259,56,18,8,19/1/2022 7:23
9/6/2021,Samut Sakhon,42,20780,587191,283020,304171,1347,1347,0,60,28,19/1/2022 7:23
9/6/2021,Saraburi,20,1005,643677,316181,327496,14753,14707,46,47,41,19/1/2022 7:23
9/6/2021,Sa kaeo,5,1085,561052,279978,281074,2761,2761,0,11,9,19/1/2022 7:23
9/6/2021,Sing Buri,2,139,205344,97567,107777,3421,3421,0,,,19/1/2022 7:23
9/6/2021,Suphan Buri,5,485,837218,404081,433137,20061,20061,0,,,19/1/2022 7:23
9/6/2021,Surat Thani,18,1810,1069905,526507,543398,4456,4439,17,73,26,19/1/2022 7:23
9/6/2021,Surin,2,191,1377402,685400,692002,10395,10377,18,,,19/1/2022 7:23
9/6/2021,Sukhothai,0,124,586606,284242,302364,7337,7029,308,,,19/1/2022 7:23
9/6/2021,Nong Khai,0,90,517219,256618,260601,12678,12669,9,27,11,19/1/2022 7:23
9/6/2021,Nong Bua Lam Phu,6,74,509323,254117,255206,3248,3248,0,,,19/1/2022 7:23
9/6/2021,Amnat Charoen,0,55,376371,187343,189028,2235,2235,0,,,19/1/2022 7:23
9/6/2021,Udon Thani,2,511,1567321,776506,790815,16592,16582,10,,,19/1/2022 7:23
9/6/2021,Uttaradit,0,97,447366,218091,229275,7129,7129,0,,,19/1/2022 7:23
9/6/2021,Uthai Thani,0,44,325515,159149,166366,2979,2979,0,,,19/1/2022 7:23
9/6/2021,Ubon Ratchathani,0,375,1867065,932291,934774,19665,19665,0,31,14,19/1/2022 7:23
9/6/2021,Ang Thong,4,330,275836,132062,143774,2258,2258,0,,,19/1/2022 7:23
9/6/2021,Chiang Rai,1,728,1297104,630696,666408,26342,26054,288,21,10,19/1/2022 7:23
9/6/2021,Chiang Mai,2,8418,1786156,863211,922945,80431,79438,993,45,22,19/1/2022 7:23
9/6/2021,Phetchaburi,28,7700,482299,232776,249523,41434,41240,194,,,19/1/2022 7:23
9/6/2021,Phetchabun,2,178,979800,483288,496512,23760,23760,0,,,19/1/2022 7:23
9/6/2021,Loei,0,107,638445,319953,318492,5204,5185,19,25,17,19/1/2022 7:23
9/6/2021,Phrae,0,88,435883,210160,225723,6005,6005,0,36,14,19/1/2022 7:23
9/6/2021,Mae Hong Son,0,54,285642,144738,140904,8603,8391,212,21,6,19/1/2022 7:23
9/6/2021,,0,153,,,,,,,,,19/1/2022 7:23
10/6/2021,Krabi,1,339,478523,237695,240828,2661,2547,114,,,19/1/2022 7:23
10/6/2021,Bangkok,872,71832,5557605,2607913,2949692,256622,230749,25873,29,25,19/1/2022 7:23
10/6/2021,Kanchanaburi,3,365,892655,447517,445138,61297,61077,220,23,27,19/1/2022 7:23
10/6/2021,Kalasin,0,132,976880,483049,493831,2792,2792,0,,,19/1/2022 7:23
10/6/2021,Kamphaeng Phet,0,160,713388,352344,361044,7265,7265,0,,,19/1/2022 7:23
10/6/2021,Khon Kaen,8,552,1792631,881416,911215,39567,39567,0,52,28,19/1/2022 7:23
10/6/2021,Chanthaburi,22,1224,535759,262053,273706,20687,20602,85,,,19/1/2022 7:23
10/6/2021,Chachoengsao,41,3160,722120,354040,368080,4415,4415,0,38,27,19/1/2022 7:23
10/6/2021,Chon Buri,81,6807,1576670,769103,807567,41441,40719,722,38,27,19/1/2022 7:23
10/6/2021,Chai Nat,1,99,321397,154547,166850,5221,5221,0,,,19/1/2022 7:23
10/6/2021,Chaiyaphum,0,325,1123720,555261,568459,6515,6506,9,,,19/1/2022 7:23
10/6/2021,Chumphon,1,141,509518,251488,258030,2539,2539,0,,,19/1/2022 7:23
10/6/2021,Trang,21,1282,640151,313123,327028,3134,3134,0,,,19/1/2022 7:23
10/6/2021,Trat,7,167,228460,112953,115507,19181,19065,116,,,19/1/2022 7:23
10/6/2021,Tak,7,673,674065,340821,333244,16539,16539,0,,,19/1/2022 7:23
10/6/2021,Nakhon Nayok,6,334,259655,128067,131588,4620,4620,0,,,19/1/2022 7:23
10/6/2021,Nakhon Pathom,32,1841,922334,443151,479183,8757,8744,13,19,16,19/1/2022 7:23
10/6/2021,Nakhon Phanom,0,145,717157,357396,359761,5327,5318,9,,,19/1/2022 7:23
10/6/2021,Nakhon Ratchasima,2,998,2633864,1294474,1339390,120449,119801,648,43,26,19/1/2022 7:23
10/6/2021,Nakhon Si Thammarat,1,950,1549931,764739,785192,9919,9919,0,,,19/1/2022 7:23
10/6/2021,Nakhon Sawan,4,561,1037728,506276,531452,18315,18315,0,31,20,19/1/2022 7:23
10/6/2021,Nonthaburi,133,16442,1283748,597411,686337,2979,2961,18,23,14,19/1/2022 7:23
10/6/2021,Narathiwat,0,1173,807983,399778,408205,613,613,0,45,20,19/1/2022 7:23
10/6/2021,Nan,1,124,476110,238240,237870,12538,12477,61,,,19/1/2022 7:23
10/6/2021,Bueng Kan,2,38,422320,211778,210542,3482,3477,5,,,19/1/2022 7:23
10/6/2021,Buri Ram,12,234,1580295,784354,795941,23788,23726,62,,,19/1/2022 7:23
10/6/2021,Pathum Thani,308,6034,1184377,561210,623167,1664,1645,19,28,13,19/1/2022 7:23
10/6/2021,Prachuap Khiri Khan,94,2047,551074,272744,278330,36899,36826,73,,,19/1/2022 7:23
10/6/2021,Prachin Buri,1,424,494401,244052,250349,3921,3921,0,53,27,19/1/2022 7:23
10/6/2021,Pattani,27,545,728135,359504,368631,837,837,0,,,19/1/2022 7:23
10/6/2021,Phra Nakhon Si Ayutthaya,43,1646,820129,394020,426109,61845,61474,371,23,32,19/1/2022 7:23
10/6/2021,Phayao,1,99,465644,226629,239015,8699,8699,0,31,19,19/1/2022 7:23
10/6/2021,Phang-nga,0,71,268563,134041,134522,5909,5544,365,,,19/1/2022 7:23
10/6/2021,Phatthalung,7,460,523027,254844,268183,2836,2836,0,,,19/1/2022 7:23
10/6/2021,Phichit,1,153,531180,259128,272052,6377,6377,0,,,19/1/2022 7:23
10/6/2021,Phitsanulok,2,361,847068,414386,432682,28588,28523,65,,,19/1/2022 7:23
10/6/2021,Phuket,0,900,415684,196375,219309,28777,28224,553,47,29,19/1/2022 7:23
10/6/2021,Maha Sarakham,1,390,950820,466360,484460,3552,3552,0,,,19/1/2022 7:23
10/6/2021,Mukdahan,0,44,351117,175421,175696,6539,6539,0,,,19/1/2022 7:23
10/6/2021,Yala,42,606,540726,269152,271574,923,923,0,48,21,19/1/2022 7:23
10/6/2021,Yasothon,0,143,533972,266534,267438,1630,1630,0,,,19/1/2022 7:23
10/6/2021,Ranong,14,953,194715,98283,96432,2092,2092,0,,,19/1/2022 7:23
10/6/2021,Rayong,5,1654,747267,367184,380083,23374,23094,280,38,33,19/1/2022 7:23
10/6/2021,Ratchaburi,43,988,869140,422590,446550,13639,13639,0,,,19/1/2022 7:23
10/6/2021,Roi Et,0,272,1297189,642792,654397,3901,3901,0,,,19/1/2022 7:23
10/6/2021,Lop Buri,5,368,739289,367896,371393,8701,8660,41,,,19/1/2022 7:23
10/6/2021,Lampang,0,270,726902,354357,372545,6899,6564,335,28,18,19/1/2022 7:23
10/6/2021,Lamphun,0,306,401818,193230,208588,7266,7171,95,,,19/1/2022 7:23
10/6/2021,Si Sa Ket,1,433,1457790,725911,731879,4874,4874,0,,,19/1/2022 7:23
10/6/2021,Sakon Nakhon,0,133,1146926,570016,576910,5542,5542,0,,,19/1/2022 7:23
10/6/2021,Songkhla,33,2312,1429245,696525,732720,2071,2048,23,72,37,19/1/2022 7:23
10/6/2021,Satun,0,48,324391,161409,162982,3087,3058,29,33,20,19/1/2022 7:23
10/6/2021,Samut Prakarn,220,10601,1355249,645868,709381,2956,2895,61,,,19/1/2022 7:23
10/6/2021,Samut Songkhram,12,366,191737,91607,100130,17315,17259,56,17,11,19/1/2022 7:23
10/6/2021,Samut Sakhon,89,20869,587191,283020,304171,1347,1347,0,48,30,19/1/2022 7:23
10/6/2021,Saraburi,18,1023,643677,316181,327496,14753,14707,46,39,49,19/1/2022 7:23
10/6/2021,Sa kaeo,40,1125,561052,279978,281074,2761,2761,0,24,12,19/1/2022 7:23
10/6/2021,Sing Buri,2,141,205344,97567,107777,3421,3421,0,,,19/1/2022 7:23
10/6/2021,Suphan Buri,3,488,837218,404081,433137,20061,20061,0,,,19/1/2022 7:23
10/6/2021,Surat Thani,7,1817,1069905,526507,543398,4456,4439,17,64,31,19/1/2022 7:23
10/6/2021,Surin,0,191,1377402,685400,692002,10395,10377,18,,,19/1/2022 7:23
10/6/2021,Sukhothai,0,124,586606,284242,302364,7337,7029,308,,,19/1/2022 7:23
10/6/2021,Nong Khai,1,91,517219,256618,260601,12678,12669,9,26,13,19/1/2022 7:23
10/6/2021,Nong Bua Lam Phu,1,75,509323,254117,255206,3248,3248,0,,,19/1/2022 7:23
10/6/2021,Amnat Charoen,0,55,376371,187343,189028,2235,2235,0,,,19/1/2022 7:23
10/6/2021,Udon Thani,2,513,1567321,776506,790815,16592,16582,10,,,19/1/2022 7:23
10/6/2021,Uttaradit,1,98,447366,218091,229275,7129,7129,0,,,19/1/2022 7:23
10/6/2021,Uthai Thani,0,44,325515,159149,166366,2979,2979,0,,,19/1/2022 7:23
10/6/2021,Ubon Ratchathani,0,375,1867065,932291,934774,19665,19665,0,30,13,19/1/2022 7:23
10/6/2021,Ang Thong,2,332,275836,132062,143774,2258,2258,0,,,19/1/2022 7:23
10/6/2021,Chiang Rai,2,730,1297104,630696,666408,26342,26054,288,20,11,19/1/2022 7:23
10/6/2021,Chiang Mai,1,8419,1786156,863211,922945,80431,79438,993,43,22,19/1/2022 7:23
10/6/2021,Phetchaburi,20,7720,482299,232776,249523,41434,41240,194,,,19/1/2022 7:23
10/6/2021,Phetchabun,1,179,979800,483288,496512,23760,23760,0,,,19/1/2022 7:23
10/6/2021,Loei,1,108,638445,319953,318492,5204,5185,19,28,18,19/1/2022 7:23
10/6/2021,Phrae,1,89,435883,210160,225723,6005,6005,0,33,16,19/1/2022 7:23
10/6/2021,Mae Hong Son,0,54,285642,144738,140904,8603,8391,212,24,7,19/1/2022 7:23
10/6/2021,,0,153,,,,,,,,,19/1/2022 7:23
11/6/2021,Krabi,0,339,478523,237695,240828,2661,2547,114,,,19/1/2022 7:23
11/6/2021,Bangkok,967,72799,5557605,2607913,2949692,256622,230749,25873,51,36,19/1/2022 7:23
11/6/2021,Kanchanaburi,7,372,892655,447517,445138,61297,61077,220,58,14,19/1/2022 7:23
11/6/2021,Kalasin,3,135,976880,483049,493831,2792,2792,0,,,19/1/2022 7:23
11/6/2021,Kamphaeng Phet,1,161,713388,352344,361044,7265,7265,0,,,19/1/2022 7:23
11/6/2021,Khon Kaen,3,555,1792631,881416,911215,39567,39567,0,55,29,19/1/2022 7:23
11/6/2021,Chanthaburi,45,1269,535759,262053,273706,20687,20602,85,,,19/1/2022 7:23
11/6/2021,Chachoengsao,68,3228,722120,354040,368080,4415,4415,0,43,35,19/1/2022 7:23
11/6/2021,Chon Buri,62,6869,1576670,769103,807567,41441,40719,722,41,36,19/1/2022 7:23
11/6/2021,Chai Nat,0,99,321397,154547,166850,5221,5221,0,,,19/1/2022 7:23
11/6/2021,Chaiyaphum,2,327,1123720,555261,568459,6515,6506,9,,,19/1/2022 7:23
11/6/2021,Chumphon,3,144,509518,251488,258030,2539,2539,0,,,19/1/2022 7:23
11/6/2021,Trang,22,1304,640151,313123,327028,3134,3134,0,,,19/1/2022 7:23
11/6/2021,Trat,5,172,228460,112953,115507,19181,19065,116,,,19/1/2022 7:23
11/6/2021,Tak,9,682,674065,340821,333244,16539,16539,0,,,19/1/2022 7:23
11/6/2021,Nakhon Nayok,9,343,259655,128067,131588,4620,4620,0,,,19/1/2022 7:23
11/6/2021,Nakhon Pathom,83,1924,922334,443151,479183,8757,8744,13,41,26,19/1/2022 7:23
11/6/2021,Nakhon Phanom,2,147,717157,357396,359761,5327,5318,9,,,19/1/2022 7:23
11/6/2021,Nakhon Ratchasima,13,1011,2633864,1294474,1339390,120449,119801,648,52,28,19/1/2022 7:23
11/6/2021,Nakhon Si Thammarat,13,963,1549931,764739,785192,9919,9919,0,,,19/1/2022 7:23
11/6/2021,Nakhon Sawan,4,565,1037728,506276,531452,18315,18315,0,33,30,19/1/2022 7:23
11/6/2021,Nonthaburi,201,16643,1283748,597411,686337,2979,2961,18,30,19,19/1/2022 7:23
11/6/2021,Narathiwat,8,1181,807983,399778,408205,613,613,0,41,28,19/1/2022 7:23
11/6/2021,Nan,0,124,476110,238240,237870,12538,12477,61,,,19/1/2022 7:23
11/6/2021,Bueng Kan,0,38,422320,211778,210542,3482,3477,5,,,19/1/2022 7:23
11/6/2021,Buri Ram,2,236,1580295,784354,795941,23788,23726,62,,,19/1/2022 7:23
11/6/2021,Pathum Thani,50,6084,1184377,561210,623167,1664,1645,19,32,17,19/1/2022 7:23
11/6/2021,Prachuap Khiri Khan,1,2048,551074,272744,278330,36899,36826,73,,,19/1/2022 7:23
11/6/2021,Prachin Buri,3,427,494401,244052,250349,3921,3921,0,55,38,19/1/2022 7:23
11/6/2021,Pattani,4,549,728135,359504,368631,837,837,0,,,19/1/2022 7:23
11/6/2021,Phra Nakhon Si Ayutthaya,19,1665,820129,394020,426109,61845,61474,371,26,36,19/1/2022 7:23
11/6/2021,Phayao,0,99,465644,226629,239015,8699,8699,0,37,15,19/1/2022 7:23
11/6/2021,Phang-nga,4,75,268563,134041,134522,5909,5544,365,,,19/1/2022 7:23
11/6/2021,Phatthalung,9,469,523027,254844,268183,2836,2836,0,,,19/1/2022 7:23
11/6/2021,Phichit,2,155,531180,259128,272052,6377,6377,0,,,19/1/2022 7:23
11/6/2021,Phitsanulok,1,362,847068,414386,432682,28588,28523,65,,,19/1/2022 7:23
11/6/2021,Phuket,1,901,415684,196375,219309,28777,28224,553,55,26,19/1/2022 7:23
11/6/2021,Maha Sarakham,1,391,950820,466360,484460,3552,3552,0,,,19/1/2022 7:23
11/6/2021,Mukdahan,0,44,351117,175421,175696,6539,6539,0,,,19/1/2022 7:23
11/6/2021,Yala,31,637,540726,269152,271574,923,923,0,44,28,19/1/2022 7:23
11/6/2021,Yasothon,0,143,533972,266534,267438,1630,1630,0,,,19/1/2022 7:23
11/6/2021,Ranong,12,965,194715,98283,96432,2092,2092,0,,,19/1/2022 7:23
11/6/2021,Rayong,16,1670,747267,367184,380083,23374,23094,280,42,36,19/1/2022 7:23
11/6/2021,Ratchaburi,9,997,869140,422590,446550,13639,13639,0,,,19/1/2022 7:23
11/6/2021,Roi Et,0,272,1297189,642792,654397,3901,3901,0,,,19/1/2022 7:23
11/6/2021,Lop Buri,2,370,739289,367896,371393,8701,8660,41,,,19/1/2022 7:23
11/6/2021,Lampang,0,270,726902,354357,372545,6899,6564,335,30,19,19/1/2022 7:23
11/6/2021,Lamphun,0,306,401818,193230,208588,7266,7171,95,,,19/1/2022 7:23
11/6/2021,Si Sa Ket,2,435,1457790,725911,731879,4874,4874,0,,,19/1/2022 7:23
11/6/2021,Sakon Nakhon,2,135,1146926,570016,576910,5542,5542,0,,,19/1/2022 7:23
11/6/2021,Songkhla,210,2522,1429245,696525,732720,2071,2048,23,63,29,19/1/2022 7:23
11/6/2021,Satun,0,48,324391,161409,162982,3087,3058,29,31,16,19/1/2022 7:23
11/6/2021,Samut Prakarn,173,10774,1355249,645868,709381,2956,2895,61,,,19/1/2022 7:23
11/6/2021,Samut Songkhram,7,373,191737,91607,100130,17315,17259,56,24,17,19/1/2022 7:23
11/6/2021,Samut Sakhon,98,20967,587191,283020,304171,1347,1347,0,54,42,19/1/2022 7:23
11/6/2021,Saraburi,15,1038,643677,316181,327496,14753,14707,46,51,53,19/1/2022 7:23
11/6/2021,Sa kaeo,4,1129,561052,279978,281074,2761,2761,0,18,27,19/1/2022 7:23
11/6/2021,Sing Buri,3,144,205344,97567,107777,3421,3421,0,,,19/1/2022 7:23
11/6/2021,Suphan Buri,3,491,837218,404081,433137,20061,20061,0,,,19/1/2022 7:23
11/6/2021,Surat Thani,5,1822,1069905,526507,543398,4456,4439,17,60,34,19/1/2022 7:23
11/6/2021,Surin,2,193,1377402,685400,692002,10395,10377,18,,,19/1/2022 7:23
11/6/2021,Sukhothai,0,124,586606,284242,302364,7337,7029,308,,,19/1/2022 7:23
11/6/2021,Nong Khai,0,91,517219,256618,260601,12678,12669,9,31,11,19/1/2022 7:23
11/6/2021,Nong Bua Lam Phu,3,78,509323,254117,255206,3248,3248,0,,,19/1/2022 7:23
11/6/2021,Amnat Charoen,0,55,376371,187343,189028,2235,2235,0,,,19/1/2022 7:23
11/6/2021,Udon Thani,2,515,1567321,776506,790815,16592,16582,10,,,19/1/2022 7:23
11/6/2021,Uttaradit,0,98,447366,218091,229275,7129,7129,0,,,19/1/2022 7:23
11/6/2021,Uthai Thani,2,46,325515,159149,166366,2979,2979,0,,,19/1/2022 7:23
11/6/2021,Ubon Ratchathani,4,379,1867065,932291,934774,19665,19665,0,27,12,19/1/2022 7:23
11/6/2021,Ang Thong,0,332,275836,132062,143774,2258,2258,0,,,19/1/2022 7:23
11/6/2021,Chiang Rai,1,731,1297104,630696,666408,26342,26054,288,25,14,19/1/2022 7:23
11/6/2021,Chiang Mai,1,8420,1786156,863211,922945,80431,79438,993,49,22,19/1/2022 7:23
11/6/2021,Phetchaburi,56,7776,482299,232776,249523,41434,41240,194,,,19/1/2022 7:23
11/6/2021,Phetchabun,0,179,979800,483288,496512,23760,23760,0,,,19/1/2022 7:23
11/6/2021,Loei,0,108,638445,319953,318492,5204,5185,19,26,19,19/1/2022 7:23
11/6/2021,Phrae,0,89,435883,210160,225723,6005,6005,0,41,18,19/1/2022 7:23
11/6/2021,Mae Hong Son,0,54,285642,144738,140904,8603,8391,212,28,7,19/1/2022 7:23
11/6/2021,,0,153,,,,,,,,,19/1/2022 7:23
12/6/2021,Krabi,1,340,478523,237695,240828,2661,2547,114,,,19/1/2022 7:23
12/6/2021,Bangkok,1669,74468,5557605,2607913,2949692,256622,230749,25873,72,33,19/1/2022 7:23
12/6/2021,Kanchanaburi,2,374,892655,447517,445138,61297,61077,220,37,13,19/1/2022 7:23
12/6/2021,Kalasin,3,138,976880,483049,493831,2792,2792,0,,,19/1/2022 7:23
12/6/2021,Kamphaeng Phet,26,187,713388,352344,361044,7265,7265,0,,,19/1/2022 7:23
12/6/2021,Khon Kaen,3,558,1792631,881416,911215,39567,39567,0,56,26,19/1/2022 7:23
12/6/2021,Chanthaburi,11,1280,535759,262053,273706,20687,20602,85,,,19/1/2022 7:23
12/6/2021,Chachoengsao,52,3280,722120,354040,368080,4415,4415,0,51,37,19/1/2022 7:23
12/6/2021,Chon Buri,76,6945,1576670,769103,807567,41441,40719,722,50,36,19/1/2022 7:23
12/6/2021,Chai Nat,0,99,321397,154547,166850,5221,5221,0,,,19/1/2022 7:23
12/6/2021,Chaiyaphum,1,328,1123720,555261,568459,6515,6506,9,,,19/1/2022 7:23
12/6/2021,Chumphon,5,149,509518,251488,258030,2539,2539,0,,,19/1/2022 7:23
12/6/2021,Trang,21,1325,640151,313123,327028,3134,3134,0,,,19/1/2022 7:23
12/6/2021,Trat,37,209,228460,112953,115507,19181,19065,116,,,19/1/2022 7:23
12/6/2021,Tak,11,693,674065,340821,333244,16539,16539,0,,,19/1/2022 7:23
12/6/2021,Nakhon Nayok,6,349,259655,128067,131588,4620,4620,0,,,19/1/2022 7:23
12/6/2021,Nakhon Pathom,78,2002,922334,443151,479183,8757,8744,13,48,25,19/1/2022 7:23
12/6/2021,Nakhon Phanom,1,148,717157,357396,359761,5327,5318,9,,,19/1/2022 7:23
12/6/2021,Nakhon Ratchasima,5,1016,2633864,1294474,1339390,120449,119801,648,48,26,19/1/2022 7:23
12/6/2021,Nakhon Si Thammarat,14,977,1549931,764739,785192,9919,9919,0,,,19/1/2022 7:23
12/6/2021,Nakhon Sawan,5,570,1037728,506276,531452,18315,18315,0,61,28,19/1/2022 7:23
12/6/2021,Nonthaburi,292,16935,1283748,597411,686337,2979,2961,18,40,23,19/1/2022 7:23
12/6/2021,Narathiwat,24,1205,807983,399778,408205,613,613,0,62,19,19/1/2022 7:23
12/6/2021,Nan,0,124,476110,238240,237870,12538,12477,61,,,19/1/2022 7:23
12/6/2021,Bueng Kan,0,38,422320,211778,210542,3482,3477,5,,,19/1/2022 7:23
12/6/2021,Buri Ram,2,238,1580295,784354,795941,23788,23726,62,,,19/1/2022 7:23
12/6/2021,Pathum Thani,81,6165,1184377,561210,623167,1664,1645,19,44,18,19/1/2022 7:23
12/6/2021,Prachuap Khiri Khan,7,2055,551074,272744,278330,36899,36826,73,,,19/1/2022 7:23
12/6/2021,Prachin Buri,2,429,494401,244052,250349,3921,3921,0,67,27,19/1/2022 7:23
12/6/2021,Pattani,11,560,728135,359504,368631,837,837,0,,,19/1/2022 7:23
12/6/2021,Phra Nakhon Si Ayutthaya,39,1704,820129,394020,426109,61845,61474,371,28,38,19/1/2022 7:23
12/6/2021,Phayao,2,101,465644,226629,239015,8699,8699,0,39,18,19/1/2022 7:23
12/6/2021,Phang-nga,7,82,268563,134041,134522,5909,5544,365,,,19/1/2022 7:23
12/6/2021,Phatthalung,0,469,523027,254844,268183,2836,2836,0,,,19/1/2022 7:23
12/6/2021,Phichit,0,155,531180,259128,272052,6377,6377,0,,,19/1/2022 7:23
12/6/2021,Phitsanulok,0,362,847068,414386,432682,28588,28523,65,,,19/1/2022 7:23
12/6/2021,Phuket,0,901,415684,196375,219309,28777,28224,553,53,24,19/1/2022 7:23
12/6/2021,Maha Sarakham,0,391,950820,466360,484460,3552,3552,0,,,19/1/2022 7:23
12/6/2021,Mukdahan,1,45,351117,175421,175696,6539,6539,0,,,19/1/2022 7:23
12/6/2021,Yala,22,659,540726,269152,271574,923,923,0,58,34,19/1/2022 7:23
12/6/2021,Yasothon,0,143,533972,266534,267438,1630,1630,0,,,19/1/2022 7:23
12/6/2021,Ranong,8,973,194715,98283,96432,2092,2092,0,,,19/1/2022 7:23
12/6/2021,Rayong,10,1680,747267,367184,380083,23374,23094,280,50,40,19/1/2022 7:23
12/6/2021,Ratchaburi,15,1012,869140,422590,446550,13639,13639,0,,,19/1/2022 7:23
12/6/2021,Roi Et,0,272,1297189,642792,654397,3901,3901,0,,,19/1/2022 7:23
12/6/2021,Lop Buri,11,381,739289,367896,371393,8701,8660,41,,,19/1/2022 7:23
12/6/2021,Lampang,0,270,726902,354357,372545,6899,6564,335,59,20,19/1/2022 7:23
12/6/2021,Lamphun,0,306,401818,193230,208588,7266,7171,95,,,19/1/2022 7:23
12/6/2021,Si Sa Ket,3,438,1457790,725911,731879,4874,4874,0,,,19/1/2022 7:23
12/6/2021,Sakon Nakhon,0,135,1146926,570016,576910,5542,5542,0,,,19/1/2022 7:23
12/6/2021,Songkhla,68,2590,1429245,696525,732720,2071,2048,23,58,38,19/1/2022 7:23
12/6/2021,Satun,0,48,324391,161409,162982,3087,3058,29,35,25,19/1/2022 7:23
12/6/2021,Samut Prakarn,322,11096,1355249,645868,709381,2956,2895,61,,,19/1/2022 7:23
12/6/2021,Samut Songkhram,13,386,191737,91607,100130,17315,17259,56,34,17,19/1/2022 7:23
12/6/2021,Samut Sakhon,188,21155,587191,283020,304171,1347,1347,0,73,38,19/1/2022 7:23
12/6/2021,Saraburi,24,1062,643677,316181,327496,14753,14707,46,51,65,19/1/2022 7:23
12/6/2021,Sa kaeo,19,1148,561052,279978,281074,2761,2761,0,35,22,19/1/2022 7:23
12/6/2021,Sing Buri,2,146,205344,97567,107777,3421,3421,0,,,19/1/2022 7:23
12/6/2021,Suphan Buri,11,502,837218,404081,433137,20061,20061,0,,,19/1/2022 7:23
12/6/2021,Surat Thani,12,1834,1069905,526507,543398,4456,4439,17,66,32,19/1/2022 7:23
12/6/2021,Surin,2,195,1377402,685400,692002,10395,10377,18,,,19/1/2022 7:23
12/6/2021,Sukhothai,0,124,586606,284242,302364,7337,7029,308,,,19/1/2022 7:23
12/6/2021,Nong Khai,0,91,517219,256618,260601,12678,12669,9,27,13,19/1/2022 7:23
12/6/2021,Nong Bua Lam Phu,2,80,509323,254117,255206,3248,3248,0,,,19/1/2022 7:23
12/6/2021,Amnat Charoen,0,55,376371,187343,189028,2235,2235,0,,,19/1/2022 7:23
12/6/2021,Udon Thani,1,516,1567321,776506,790815,16592,16582,10,,,19/1/2022 7:23
12/6/2021,Uttaradit,0,98,447366,218091,229275,7129,7129,0,,,19/1/2022 7:23
12/6/2021,Uthai Thani,0,46,325515,159149,166366,2979,2979,0,,,19/1/2022 7:23
12/6/2021,Ubon Ratchathani,3,382,1867065,932291,934774,19665,19665,0,27,17,19/1/2022 7:23
12/6/2021,Ang Thong,3,335,275836,132062,143774,2258,2258,0,,,19/1/2022 7:23
12/6/2021,Chiang Rai,1,732,1297104,630696,666408,26342,26054,288,35,17,19/1/2022 7:23
12/6/2021,Chiang Mai,6,8426,1786156,863211,922945,80431,79438,993,50,25,19/1/2022 7:23
12/6/2021,Phetchaburi,34,7810,482299,232776,249523,41434,41240,194,,,19/1/2022 7:23
12/6/2021,Phetchabun,2,181,979800,483288,496512,23760,23760,0,,,19/1/2022 7:23
12/6/2021,Loei,0,108,638445,319953,318492,5204,5185,19,27,17,19/1/2022 7:23
12/6/2021,Phrae,0,89,435883,210160,225723,6005,6005,0,50,18,19/1/2022 7:23
12/6/2021,Mae Hong Son,0,54,285642,144738,140904,8603,8391,212,29,5,19/1/2022 7:23
12/6/2021,,0,153,,,,,,,,,19/1/2022 7:23
13/6/2021,Krabi,2,342,478523,237695,240828,2661,2547,114,,,19/1/2022 7:23
13/6/2021,Bangkok,998,75466,5557605,2607913,2949692,256622,230749,25873,61,27,19/1/2022 7:23
13/6/2021,Kanchanaburi,6,380,892655,447517,445138,61297,61077,220,36,18,19/1/2022 7:23
13/6/2021,Kalasin,0,138,976880,483049,493831,2792,2792,0,,,19/1/2022 7:23
13/6/2021,Kamphaeng Phet,13,200,713388,352344,361044,7265,7265,0,,,19/1/2022 7:23
13/6/2021,Khon Kaen,1,559,1792631,881416,911215,39567,39567,0,52,33,19/1/2022 7:23
13/6/2021,Chanthaburi,14,1294,535759,262053,273706,20687,20602,85,,,19/1/2022 7:23
13/6/2021,Chachoengsao,239,3519,722120,354040,368080,4415,4415,0,76,27,19/1/2022 7:23
13/6/2021,Chon Buri,32,6977,1576670,769103,807567,41441,40719,722,50,36,19/1/2022 7:23
13/6/2021,Chai Nat,0,99,321397,154547,166850,5221,5221,0,,,19/1/2022 7:23
13/6/2021,Chaiyaphum,4,332,1123720,555261,568459,6515,6506,9,,,19/1/2022 7:23
13/6/2021,Chumphon,0,149,509518,251488,258030,2539,2539,0,,,19/1/2022 7:23
13/6/2021,Trang,17,1342,640151,313123,327028,3134,3134,0,,,19/1/2022 7:23
13/6/2021,Trat,4,213,228460,112953,115507,19181,19065,116,,,19/1/2022 7:23
13/6/2021,Tak,5,698,674065,340821,333244,16539,16539,0,,,19/1/2022 7:23
13/6/2021,Nakhon Nayok,14,363,259655,128067,131588,4620,4620,0,,,19/1/2022 7:23
13/6/2021,Nakhon Pathom,36,2038,922334,443151,479183,8757,8744,13,49,20,19/1/2022 7:23
13/6/2021,Nakhon Phanom,0,148,717157,357396,359761,5327,5318,9,,,19/1/2022 7:23
13/6/2021,Nakhon Ratchasima,2,1018,2633864,1294474,1339390,120449,119801,648,56,26,19/1/2022 7:23
13/6/2021,Nakhon Si Thammarat,14,991,1549931,764739,785192,9919,9919,0,,,19/1/2022 7:23
13/6/2021,Nakhon Sawan,5,575,1037728,506276,531452,18315,18315,0,57,26,19/1/2022 7:23
13/6/2021,Nonthaburi,124,17059,1283748,597411,686337,2979,2961,18,42,21,19/1/2022 7:23
13/6/2021,Narathiwat,31,1236,807983,399778,408205,613,613,0,41,20,19/1/2022 7:23
13/6/2021,Nan,1,125,476110,238240,237870,12538,12477,61,,,19/1/2022 7:23
13/6/2021,Bueng Kan,0,38,422320,211778,210542,3482,3477,5,,,19/1/2022 7:23
13/6/2021,Buri Ram,5,243,1580295,784354,795941,23788,23726,62,,,19/1/2022 7:23
13/6/2021,Pathum Thani,79,6244,1184377,561210,623167,1664,1645,19,50,30,19/1/2022 7:23
13/6/2021,Prachuap Khiri Khan,34,2089,551074,272744,278330,36899,36826,73,,,19/1/2022 7:23
13/6/2021,Prachin Buri,10,439,494401,244052,250349,3921,3921,0,60,22,19/1/2022 7:23
13/6/2021,Pattani,41,601,728135,359504,368631,837,837,0,,,19/1/2022 7:23
13/6/2021,Phra Nakhon Si Ayutthaya,206,1910,820129,394020,426109,61845,61474,371,42,41,19/1/2022 7:23
13/6/2021,Phayao,2,103,465644,226629,239015,8699,8699,0,38,12,19/1/2022 7:23
13/6/2021,Phang-nga,2,84,268563,134041,134522,5909,5544,365,,,19/1/2022 7:23
13/6/2021,Phatthalung,2,471,523027,254844,268183,2836,2836,0,,,19/1/2022 7:23
13/6/2021,Phichit,3,158,531180,259128,272052,6377,6377,0,,,19/1/2022 7:23
13/6/2021,Phitsanulok,0,362,847068,414386,432682,28588,28523,65,,,19/1/2022 7:23
13/6/2021,Phuket,0,901,415684,196375,219309,28777,28224,553,50,24,19/1/2022 7:23
13/6/2021,Maha Sarakham,2,393,950820,466360,484460,3552,3552,0,,,19/1/2022 7:23
13/6/2021,Mukdahan,0,45,351117,175421,175696,6539,6539,0,,,19/1/2022 7:23
13/6/2021,Yala,23,682,540726,269152,271574,923,923,0,69,26,19/1/2022 7:23
13/6/2021,Yasothon,0,143,533972,266534,267438,1630,1630,0,,,19/1/2022 7:23
13/6/2021,Ranong,42,1015,194715,98283,96432,2092,2092,0,,,19/1/2022 7:23
13/6/2021,Rayong,15,1695,747267,367184,380083,23374,23094,280,49,48,19/1/2022 7:23
13/6/2021,Ratchaburi,7,1019,869140,422590,446550,13639,13639,0,,,19/1/2022 7:23
13/6/2021,Roi Et,1,273,1297189,642792,654397,3901,3901,0,,,19/1/2022 7:23
13/6/2021,Lop Buri,16,397,739289,367896,371393,8701,8660,41,,,19/1/2022 7:23
13/6/2021,Lampang,0,270,726902,354357,372545,6899,6564,335,36,17,19/1/2022 7:23
13/6/2021,Lamphun,0,306,401818,193230,208588,7266,7171,95,,,19/1/2022 7:23
13/6/2021,Si Sa Ket,2,440,1457790,725911,731879,4874,4874,0,,,19/1/2022 7:23
13/6/2021,Sakon Nakhon,0,135,1146926,570016,576910,5542,5542,0,,,19/1/2022 7:23
13/6/2021,Songkhla,232,2822,1429245,696525,732720,2071,2048,23,77,34,19/1/2022 7:23
13/6/2021,Satun,0,48,324391,161409,162982,3087,3058,29,55,21,19/1/2022 7:23
13/6/2021,Samut Prakarn,217,11313,1355249,645868,709381,2956,2895,61,,,19/1/2022 7:23
13/6/2021,Samut Songkhram,13,399,191737,91607,100130,17315,17259,56,35,12,19/1/2022 7:23
13/6/2021,Samut Sakhon,139,21294,587191,283020,304171,1347,1347,0,69,45,19/1/2022 7:23
13/6/2021,Saraburi,28,1090,643677,316181,327496,14753,14707,46,58,46,19/1/2022 7:23
13/6/2021,Sa kaeo,37,1185,561052,279978,281074,2761,2761,0,48,19,19/1/2022 7:23
13/6/2021,Sing Buri,1,147,205344,97567,107777,3421,3421,0,,,19/1/2022 7:23
13/6/2021,Suphan Buri,5,507,837218,404081,433137,20061,20061,0,,,19/1/2022 7:23
13/6/2021,Surat Thani,6,1840,1069905,526507,543398,4456,4439,17,62,29,19/1/2022 7:23
13/6/2021,Surin,0,195,1377402,685400,692002,10395,10377,18,,,19/1/2022 7:23
13/6/2021,Sukhothai,0,124,586606,284242,302364,7337,7029,308,,,19/1/2022 7:23
13/6/2021,Nong Khai,0,91,517219,256618,260601,12678,12669,9,32,13,19/1/2022 7:23
13/6/2021,Nong Bua Lam Phu,0,80,509323,254117,255206,3248,3248,0,,,19/1/2022 7:23
13/6/2021,Amnat Charoen,1,56,376371,187343,189028,2235,2235,0,,,19/1/2022 7:23
13/6/2021,Udon Thani,4,520,1567321,776506,790815,16592,16582,10,,,19/1/2022 7:23
13/6/2021,Uttaradit,0,98,447366,218091,229275,7129,7129,0,,,19/1/2022 7:23
13/6/2021,Uthai Thani,0,46,325515,159149,166366,2979,2979,0,,,19/1/2022 7:23
13/6/2021,Ubon Ratchathani,1,383,1867065,932291,934774,19665,19665,0,37,16,19/1/2022 7:23
13/6/2021,Ang Thong,0,335,275836,132062,143774,2258,2258,0,,,19/1/2022 7:23
13/6/2021,Chiang Rai,2,734,1297104,630696,666408,26342,26054,288,40,7,19/1/2022 7:23
13/6/2021,Chiang Mai,1,8427,1786156,863211,922945,80431,79438,993,59,22,19/1/2022 7:23
13/6/2021,Phetchaburi,62,7872,482299,232776,249523,41434,41240,194,,,19/1/2022 7:23
13/6/2021,Phetchabun,1,182,979800,483288,496512,23760,23760,0,,,19/1/2022 7:23
13/6/2021,Loei,0,108,638445,319953,318492,5204,5185,19,26,16,19/1/2022 7:23
13/6/2021,Phrae,0,89,435883,210160,225723,6005,6005,0,48,12,19/1/2022 7:23
13/6/2021,Mae Hong Son,0,54,285642,144738,140904,8603,8391,212,23,6,19/1/2022 7:23
13/6/2021,,0,153,,,,,,,,,19/1/2022 7:23
14/6/2021,Krabi,0,342,478523,237695,240828,2661,2547,114,,,19/1/2022 7:23
14/6/2021,Bangkok,1709,77175,5557605,2607913,2949692,256622,230749,25873,51,32,19/1/2022 7:23
14/6/2021,Kanchanaburi,2,382,892655,447517,445138,61297,61077,220,46,11,19/1/2022 7:23
14/6/2021,Kalasin,0,138,976880,483049,493831,2792,2792,0,,,19/1/2022 7:23
14/6/2021,Kamphaeng Phet,24,224,713388,352344,361044,7265,7265,0,,,19/1/2022 7:23
14/6/2021,Khon Kaen,0,559,1792631,881416,911215,39567,39567,0,59,27,19/1/2022 7:23
14/6/2021,Chanthaburi,5,1299,535759,262053,273706,20687,20602,85,,,19/1/2022 7:23
14/6/2021,Chachoengsao,38,3557,722120,354040,368080,4415,4415,0,51,23,19/1/2022 7:23
14/6/2021,Chon Buri,56,7033,1576670,769103,807567,41441,40719,722,42,27,19/1/2022 7:23
14/6/2021,Chai Nat,0,99,321397,154547,166850,5221,5221,0,,,19/1/2022 7:23
14/6/2021,Chaiyaphum,0,332,1123720,555261,568459,6515,6506,9,,,19/1/2022 7:23
14/6/2021,Chumphon,1,150,509518,251488,258030,2539,2539,0,,,19/1/2022 7:23
14/6/2021,Trang,31,1373,640151,313123,327028,3134,3134,0,,,19/1/2022 7:23
14/6/2021,Trat,4,217,228460,112953,115507,19181,19065,116,,,19/1/2022 7:23
14/6/2021,Tak,11,709,674065,340821,333244,16539,16539,0,,,19/1/2022 7:23
14/6/2021,Nakhon Nayok,8,371,259655,128067,131588,4620,4620,0,,,19/1/2022 7:23
14/6/2021,Nakhon Pathom,292,2330,922334,443151,479183,8757,8744,13,44,15,19/1/2022 7:23
14/6/2021,Nakhon Phanom,0,148,717157,357396,359761,5327,5318,9,,,19/1/2022 7:23
14/6/2021,Nakhon Ratchasima,8,1026,2633864,1294474,1339390,120449,119801,648,52,24,19/1/2022 7:23
14/6/2021,Nakhon Si Thammarat,93,1084,1549931,764739,785192,9919,9919,0,,,19/1/2022 7:23
14/6/2021,Nakhon Sawan,8,583,1037728,506276,531452,18315,18315,0,52,20,19/1/2022 7:23
14/6/2021,Nonthaburi,232,17291,1283748,597411,686337,2979,2961,18,38,13,19/1/2022 7:23
14/6/2021,Narathiwat,11,1247,807983,399778,408205,613,613,0,46,20,19/1/2022 7:23
14/6/2021,Nan,2,127,476110,238240,237870,12538,12477,61,,,19/1/2022 7:23
14/6/2021,Bueng Kan,0,38,422320,211778,210542,3482,3477,5,,,19/1/2022 7:23
14/6/2021,Buri Ram,3,246,1580295,784354,795941,23788,23726,62,,,19/1/2022 7:23
14/6/2021,Pathum Thani,83,6327,1184377,561210,623167,1664,1645,19,60,16,19/1/2022 7:23
14/6/2021,Prachuap Khiri Khan,6,2095,551074,272744,278330,36899,36826,73,,,19/1/2022 7:23
14/6/2021,Prachin Buri,6,445,494401,244052,250349,3921,3921,0,47,22,19/1/2022 7:23
14/6/2021,Pattani,67,668,728135,359504,368631,837,837,0,,,19/1/2022 7:23
14/6/2021,Phra Nakhon Si Ayutthaya,22,1932,820129,394020,426109,61845,61474,371,46,38,19/1/2022 7:23
14/6/2021,Phayao,2,105,465644,226629,239015,8699,8699,0,31,15,19/1/2022 7:23
14/6/2021,Phang-nga,15,99,268563,134041,134522,5909,5544,365,,,19/1/2022 7:23
14/6/2021,Phatthalung,0,471,523027,254844,268183,2836,2836,0,,,19/1/2022 7:23
14/6/2021,Phichit,3,161,531180,259128,272052,6377,6377,0,,,19/1/2022 7:23
14/6/2021,Phitsanulok,0,362,847068,414386,432682,28588,28523,65,,,19/1/2022 7:23
14/6/2021,Phuket,0,901,415684,196375,219309,28777,28224,553,49,23,19/1/2022 7:23
14/6/2021,Maha Sarakham,1,394,950820,466360,484460,3552,3552,0,,,19/1/2022 7:23
14/6/2021,Mukdahan,0,45,351117,175421,175696,6539,6539,0,,,19/1/2022 7:23
14/6/2021,Yala,17,699,540726,269152,271574,923,923,0,59,22,19/1/2022 7:23
14/6/2021,Yasothon,0,143,533972,266534,267438,1630,1630,0,,,19/1/2022 7:23
14/6/2021,Ranong,15,1030,194715,98283,96432,2092,2092,0,,,19/1/2022 7:23
14/6/2021,Rayong,10,1705,747267,367184,380083,23374,23094,280,47,28,19/1/2022 7:23
14/6/2021,Ratchaburi,14,1033,869140,422590,446550,13639,13639,0,,,19/1/2022 7:23
14/6/2021,Roi Et,2,275,1297189,642792,654397,3901,3901,0,,,19/1/2022 7:23
14/6/2021,Lop Buri,5,402,739289,367896,371393,8701,8660,41,,,19/1/2022 7:23
14/6/2021,Lampang,0,270,726902,354357,372545,6899,6564,335,29,17,19/1/2022 7:23
14/6/2021,Lamphun,0,306,401818,193230,208588,7266,7171,95,,,19/1/2022 7:23
14/6/2021,Si Sa Ket,3,443,1457790,725911,731879,4874,4874,0,,,19/1/2022 7:23
14/6/2021,Sakon Nakhon,0,135,1146926,570016,576910,5542,5542,0,,,19/1/2022 7:23
14/6/2021,Songkhla,106,2928,1429245,696525,732720,2071,2048,23,69,30,19/1/2022 7:23
14/6/2021,Satun,0,48,324391,161409,162982,3087,3058,29,64,19,19/1/2022 7:23
14/6/2021,Samut Prakarn,196,11509,1355249,645868,709381,2956,2895,61,,,19/1/2022 7:23
14/6/2021,Samut Songkhram,15,414,191737,91607,100130,17315,17259,56,25,12,19/1/2022 7:23
14/6/2021,Samut Sakhon,158,21452,587191,283020,304171,1347,1347,0,77,35,19/1/2022 7:23
14/6/2021,Saraburi,16,1106,643677,316181,327496,14753,14707,46,50,50,19/1/2022 7:23
14/6/2021,Sa kaeo,7,1192,561052,279978,281074,2761,2761,0,36,17,19/1/2022 7:23
14/6/2021,Sing Buri,0,147,205344,97567,107777,3421,3421,0,,,19/1/2022 7:23
14/6/2021,Suphan Buri,9,516,837218,404081,433137,20061,20061,0,,,19/1/2022 7:23
14/6/2021,Surat Thani,1,1841,1069905,526507,543398,4456,4439,17,63,32,19/1/2022 7:23
14/6/2021,Surin,0,195,1377402,685400,692002,10395,10377,18,,,19/1/2022 7:23
14/6/2021,Sukhothai,0,124,586606,284242,302364,7337,7029,308,,,19/1/2022 7:23
14/6/2021,Nong Khai,0,91,517219,256618,260601,12678,12669,9,32,14,19/1/2022 7:23
14/6/2021,Nong Bua Lam Phu,0,80,509323,254117,255206,3248,3248,0,,,19/1/2022 7:23
14/6/2021,Amnat Charoen,0,56,376371,187343,189028,2235,2235,0,,,19/1/2022 7:23
14/6/2021,Udon Thani,1,521,1567321,776506,790815,16592,16582,10,,,19/1/2022 7:23
14/6/2021,Uttaradit,6,104,447366,218091,229275,7129,7129,0,,,19/1/2022 7:23
14/6/2021,Uthai Thani,1,47,325515,159149,166366,2979,2979,0,,,19/1/2022 7:23
14/6/2021,Ubon Ratchathani,0,383,1867065,932291,934774,19665,19665,0,31,14,19/1/2022 7:23
14/6/2021,Ang Thong,0,335,275836,132062,143774,2258,2258,0,,,19/1/2022 7:23
14/6/2021,Chiang Rai,1,735,1297104,630696,666408,26342,26054,288,22,12,19/1/2022 7:23
14/6/2021,Chiang Mai,4,8431,1786156,863211,922945,80431,79438,993,54,20,19/1/2022 7:23
14/6/2021,Phetchaburi,22,7894,482299,232776,249523,41434,41240,194,,,19/1/2022 7:23
14/6/2021,Phetchabun,3,185,979800,483288,496512,23760,23760,0,,,19/1/2022 7:23
14/6/2021,Loei,0,108,638445,319953,318492,5204,5185,19,29,21,19/1/2022 7:23
14/6/2021,Phrae,0,89,435883,210160,225723,6005,6005,0,36,15,19/1/2022 7:23
14/6/2021,Mae Hong Son,0,54,285642,144738,140904,8603,8391,212,22,4,19/1/2022 7:23
14/6/2021,,0,153,,,,,,,,,19/1/2022 7:23
15/6/2021,Krabi,3,345,478523,237695,240828,2661,2547,114,,,19/1/2022 7:23
15/6/2021,Bangkok,1216,78391,5557605,2607913,2949692,256622,230749,25873,62,26,19/1/2022 7:23
15/6/2021,Kanchanaburi,5,387,892655,447517,445138,61297,61077,220,31,10,19/1/2022 7:23
15/6/2021,Kalasin,0,138,976880,483049,493831,2792,2792,0,,,19/1/2022 7:23
15/6/2021,Kamphaeng Phet,16,240,713388,352344,361044,7265,7265,0,,,19/1/2022 7:23
15/6/2021,Khon Kaen,4,563,1792631,881416,911215,39567,39567,0,51,27,19/1/2022 7:23
15/6/2021,Chanthaburi,3,1302,535759,262053,273706,20687,20602,85,,,19/1/2022 7:23
15/6/2021,Chachoengsao,369,3926,722120,354040,368080,4415,4415,0,44,29,19/1/2022 7:23
15/6/2021,Chon Buri,51,7084,1576670,769103,807567,41441,40719,722,38,32,19/1/2022 7:23
15/6/2021,Chai Nat,0,99,321397,154547,166850,5221,5221,0,,,19/1/2022 7:23
15/6/2021,Chaiyaphum,1,333,1123720,555261,568459,6515,6506,9,,,19/1/2022 7:23
15/6/2021,Chumphon,1,151,509518,251488,258030,2539,2539,0,,,19/1/2022 7:23
15/6/2021,Trang,24,1397,640151,313123,327028,3134,3134,0,,,19/1/2022 7:23
15/6/2021,Trat,1,218,228460,112953,115507,19181,19065,116,,,19/1/2022 7:23
15/6/2021,Tak,11,720,674065,340821,333244,16539,16539,0,,,19/1/2022 7:23
15/6/2021,Nakhon Nayok,9,380,259655,128067,131588,4620,4620,0,,,19/1/2022 7:23
15/6/2021,Nakhon Pathom,88,2418,922334,443151,479183,8757,8744,13,36,12,19/1/2022 7:23
15/6/2021,Nakhon Phanom,0,148,717157,357396,359761,5327,5318,9,,,19/1/2022 7:23
15/6/2021,Nakhon Ratchasima,3,1029,2633864,1294474,1339390,120449,119801,648,47,23,19/1/2022 7:23
15/6/2021,Nakhon Si Thammarat,48,1132,1549931,764739,785192,9919,9919,0,,,19/1/2022 7:23
15/6/2021,Nakhon Sawan,1,584,1037728,506276,531452,18315,18315,0,36,23,19/1/2022 7:23
15/6/2021,Nonthaburi,56,17347,1283748,597411,686337,2979,2961,18,26,14,19/1/2022 7:23
15/6/2021,Narathiwat,4,1251,807983,399778,408205,613,613,0,44,17,19/1/2022 7:23
15/6/2021,Nan,0,127,476110,238240,237870,12538,12477,61,,,19/1/2022 7:23
15/6/2021,Bueng Kan,2,40,422320,211778,210542,3482,3477,5,,,19/1/2022 7:23
15/6/2021,Buri Ram,3,249,1580295,784354,795941,23788,23726,62,,,19/1/2022 7:23
15/6/2021,Pathum Thani,202,6529,1184377,561210,623167,1664,1645,19,37,33,19/1/2022 7:23
15/6/2021,Prachuap Khiri Khan,0,2095,551074,272744,278330,36899,36826,73,,,19/1/2022 7:23
15/6/2021,Prachin Buri,10,455,494401,244052,250349,3921,3921,0,53,26,19/1/2022 7:23
15/6/2021,Pattani,61,729,728135,359504,368631,837,837,0,,,19/1/2022 7:23
15/6/2021,Phra Nakhon Si Ayutthaya,33,1965,820129,394020,426109,61845,61474,371,43,38,19/1/2022 7:23
15/6/2021,Phayao,0,105,465644,226629,239015,8699,8699,0,28,16,19/1/2022 7:23
15/6/2021,Phang-nga,5,104,268563,134041,134522,5909,5544,365,,,19/1/2022 7:23
15/6/2021,Phatthalung,2,473,523027,254844,268183,2836,2836,0,,,19/1/2022 7:23
15/6/2021,Phichit,0,161,531180,259128,272052,6377,6377,0,,,19/1/2022 7:23
15/6/2021,Phitsanulok,0,362,847068,414386,432682,28588,28523,65,,,19/1/2022 7:23
15/6/2021,Phuket,4,905,415684,196375,219309,28777,28224,553,63,24,19/1/2022 7:23
15/6/2021,Maha Sarakham,0,394,950820,466360,484460,3552,3552,0,,,19/1/2022 7:23
15/6/2021,Mukdahan,0,45,351117,175421,175696,6539,6539,0,,,19/1/2022 7:23
15/6/2021,Yala,23,722,540726,269152,271574,923,923,0,51,22,19/1/2022 7:23
15/6/2021,Yasothon,1,144,533972,266534,267438,1630,1630,0,,,19/1/2022 7:23
15/6/2021,Ranong,76,1106,194715,98283,96432,2092,2092,0,,,19/1/2022 7:23
15/6/2021,Rayong,5,1710,747267,367184,380083,23374,23094,280,32,29,19/1/2022 7:23
15/6/2021,Ratchaburi,1,1034,869140,422590,446550,13639,13639,0,,,19/1/2022 7:23
15/6/2021,Roi Et,2,277,1297189,642792,654397,3901,3901,0,,,19/1/2022 7:23
15/6/2021,Lop Buri,1,403,739289,367896,371393,8701,8660,41,,,19/1/2022 7:23
15/6/2021,Lampang,0,270,726902,354357,372545,6899,6564,335,29,16,19/1/2022 7:23
15/6/2021,Lamphun,0,306,401818,193230,208588,7266,7171,95,,,19/1/2022 7:23
15/6/2021,Si Sa Ket,0,443,1457790,725911,731879,4874,4874,0,,,19/1/2022 7:23
15/6/2021,Sakon Nakhon,1,136,1146926,570016,576910,5542,5542,0,,,19/1/2022 7:23
15/6/2021,Songkhla,58,2986,1429245,696525,732720,2071,2048,23,60,35,19/1/2022 7:23
15/6/2021,Satun,0,48,324391,161409,162982,3087,3058,29,42,19,19/1/2022 7:23
15/6/2021,Samut Prakarn,337,11846,1355249,645868,709381,2956,2895,61,,,19/1/2022 7:23
15/6/2021,Samut Songkhram,12,426,191737,91607,100130,17315,17259,56,24,10,19/1/2022 7:23
15/6/2021,Samut Sakhon,163,21615,587191,283020,304171,1347,1347,0,62,33,19/1/2022 7:23
15/6/2021,Saraburi,21,1127,643677,316181,327496,14753,14707,46,59,51,19/1/2022 7:23
15/6/2021,Sa kaeo,0,1192,561052,279978,281074,2761,2761,0,31,15,19/1/2022 7:23
15/6/2021,Sing Buri,0,147,205344,97567,107777,3421,3421,0,,,19/1/2022 7:23
15/6/2021,Suphan Buri,9,525,837218,404081,433137,20061,20061,0,,,19/1/2022 7:23
15/6/2021,Surat Thani,4,1845,1069905,526507,543398,4456,4439,17,69,33,19/1/2022 7:23
15/6/2021,Surin,1,196,1377402,685400,692002,10395,10377,18,,,19/1/2022 7:23
15/6/2021,Sukhothai,0,124,586606,284242,302364,7337,7029,308,,,19/1/2022 7:23
15/6/2021,Nong Khai,0,91,517219,256618,260601,12678,12669,9,34,14,19/1/2022 7:23
15/6/2021,Nong Bua Lam Phu,0,80,509323,254117,255206,3248,3248,0,,,19/1/2022 7:23
15/6/2021,Amnat Charoen,1,57,376371,187343,189028,2235,2235,0,,,19/1/2022 7:23
15/6/2021,Udon Thani,1,522,1567321,776506,790815,16592,16582,10,,,19/1/2022 7:23
15/6/2021,Uttaradit,0,104,447366,218091,229275,7129,7129,0,,,19/1/2022 7:23
15/6/2021,Uthai Thani,0,47,325515,159149,166366,2979,2979,0,,,19/1/2022 7:23
15/6/2021,Ubon Ratchathani,1,384,1867065,932291,934774,19665,19665,0,28,14,19/1/2022 7:23
15/6/2021,Ang Thong,1,336,275836,132062,143774,2258,2258,0,,,19/1/2022 7:23
15/6/2021,Chiang Rai,3,738,1297104,630696,666408,26342,26054,288,27,13,19/1/2022 7:23
15/6/2021,Chiang Mai,1,8432,1786156,863211,922945,80431,79438,993,48,21,19/1/2022 7:23
15/6/2021,Phetchaburi,40,7934,482299,232776,249523,41434,41240,194,,,19/1/2022 7:23
15/6/2021,Phetchabun,0,185,979800,483288,496512,23760,23760,0,,,19/1/2022 7:23
15/6/2021,Loei,1,109,638445,319953,318492,5204,5185,19,26,18,19/1/2022 7:23
15/6/2021,Phrae,0,89,435883,210160,225723,6005,6005,0,36,14,19/1/2022 7:23
15/6/2021,Mae Hong Son,0,54,285642,144738,140904,8603,8391,212,18,3,19/1/2022 7:23
15/6/2021,,0,153,,,,,,,,,19/1/2022 7:23
16/6/2021,Krabi,9,354,478523,237695,240828,2661,2547,114,,,19/1/2022 7:23
16/6/2021,Bangkok,829,79220,5557605,2607913,2949692,256622,230749,25873,46,22,19/1/2022 7:23
16/6/2021,Kanchanaburi,4,391,892655,447517,445138,61297,61077,220,29,11,19/1/2022 7:23
16/6/2021,Kalasin,1,139,976880,483049,493831,2792,2792,0,,,19/1/2022 7:23
16/6/2021,Kamphaeng Phet,17,257,713388,352344,361044,7265,7265,0,,,19/1/2022 7:23
16/6/2021,Khon Kaen,2,565,1792631,881416,911215,39567,39567,0,54,30,19/1/2022 7:23
16/6/2021,Chanthaburi,12,1314,535759,262053,273706,20687,20602,85,,,19/1/2022 7:23
16/6/2021,Chachoengsao,98,4024,722120,354040,368080,4415,4415,0,49,32,19/1/2022 7:23
16/6/2021,Chon Buri,109,7193,1576670,769103,807567,41441,40719,722,38,33,19/1/2022 7:23
16/6/2021,Chai Nat,2,101,321397,154547,166850,5221,5221,0,,,19/1/2022 7:23
16/6/2021,Chaiyaphum,4,337,1123720,555261,568459,6515,6506,9,,,19/1/2022 7:23
16/6/2021,Chumphon,1,152,509518,251488,258030,2539,2539,0,,,19/1/2022 7:23
16/6/2021,Trang,38,1435,640151,313123,327028,3134,3134,0,,,19/1/2022 7:23
16/6/2021,Trat,15,233,228460,112953,115507,19181,19065,116,,,19/1/2022 7:23
16/6/2021,Tak,6,726,674065,340821,333244,16539,16539,0,,,19/1/2022 7:23
16/6/2021,Nakhon Nayok,16,396,259655,128067,131588,4620,4620,0,,,19/1/2022 7:23
16/6/2021,Nakhon Pathom,52,2470,922334,443151,479183,8757,8744,13,32,15,19/1/2022 7:23
16/6/2021,Nakhon Phanom,0,148,717157,357396,359761,5327,5318,9,,,19/1/2022 7:23
16/6/2021,Nakhon Ratchasima,2,1031,2633864,1294474,1339390,120449,119801,648,46,24,19/1/2022 7:23
16/6/2021,Nakhon Si Thammarat,50,1182,1549931,764739,785192,9919,9919,0,,,19/1/2022 7:23
16/6/2021,Nakhon Sawan,9,593,1037728,506276,531452,18315,18315,0,43,21,19/1/2022 7:23
16/6/2021,Nonthaburi,204,17551,1283748,597411,686337,2979,2961,18,22,21,19/1/2022 7:23
16/6/2021,Narathiwat,32,1283,807983,399778,408205,613,613,0,44,24,19/1/2022 7:23
16/6/2021,Nan,7,134,476110,238240,237870,12538,12477,61,,,19/1/2022 7:23
16/6/2021,Bueng Kan,1,41,422320,211778,210542,3482,3477,5,,,19/1/2022 7:23
16/6/2021,Buri Ram,1,250,1580295,784354,795941,23788,23726,62,,,19/1/2022 7:23
16/6/2021,Pathum Thani,89,6618,1184377,561210,623167,1664,1645,19,43,21,19/1/2022 7:23
16/6/2021,Prachuap Khiri Khan,34,2129,551074,272744,278330,36899,36826,73,,,19/1/2022 7:23
16/6/2021,Prachin Buri,12,467,494401,244052,250349,3921,3921,0,55,27,19/1/2022 7:23
16/6/2021,Pattani,42,771,728135,359504,368631,837,837,0,,,19/1/2022 7:23
16/6/2021,Phra Nakhon Si Ayutthaya,50,2015,820129,394020,426109,61845,61474,371,44,34,19/1/2022 7:23
16/6/2021,Phayao,0,105,465644,226629,239015,8699,8699,0,32,16,19/1/2022 7:23
16/6/2021,Phang-nga,5,109,268563,134041,134522,5909,5544,365,,,19/1/2022 7:23
16/6/2021,Phatthalung,2,475,523027,254844,268183,2836,2836,0,,,19/1/2022 7:23
16/6/2021,Phichit,0,161,531180,259128,272052,6377,6377,0,,,19/1/2022 7:23
16/6/2021,Phitsanulok,4,366,847068,414386,432682,28588,28523,65,,,19/1/2022 7:23
16/6/2021,Phuket,3,908,415684,196375,219309,28777,28224,553,51,25,19/1/2022 7:23
16/6/2021,Maha Sarakham,4,398,950820,466360,484460,3552,3552,0,,,19/1/2022 7:23
16/6/2021,Mukdahan,0,45,351117,175421,175696,6539,6539,0,,,19/1/2022 7:23
16/6/2021,Yala,49,771,540726,269152,271574,923,923,0,53,26,19/1/2022 7:23
16/6/2021,Yasothon,0,144,533972,266534,267438,1630,1630,0,,,19/1/2022 7:23
16/6/2021,Ranong,19,1125,194715,98283,96432,2092,2092,0,,,19/1/2022 7:23
16/6/2021,Rayong,14,1724,747267,367184,380083,23374,23094,280,33,33,19/1/2022 7:23
16/6/2021,Ratchaburi,6,1040,869140,422590,446550,13639,13639,0,,,19/1/2022 7:23
16/6/2021,Roi Et,0,277,1297189,642792,654397,3901,3901,0,,,19/1/2022 7:23
16/6/2021,Lop Buri,3,406,739289,367896,371393,8701,8660,41,,,19/1/2022 7:23
16/6/2021,Lampang,0,270,726902,354357,372545,6899,6564,335,31,16,19/1/2022 7:23
16/6/2021,Lamphun,0,306,401818,193230,208588,7266,7171,95,,,19/1/2022 7:23
16/6/2021,Si Sa Ket,1,444,1457790,725911,731879,4874,4874,0,,,19/1/2022 7:23
16/6/2021,Sakon Nakhon,1,137,1146926,570016,576910,5542,5542,0,,,19/1/2022 7:23
16/6/2021,Songkhla,61,3047,1429245,696525,732720,2071,2048,23,71,32,19/1/2022 7:23
16/6/2021,Satun,3,51,324391,161409,162982,3087,3058,29,49,22,19/1/2022 7:23
16/6/2021,Samut Prakarn,163,12009,1355249,645868,709381,2956,2895,61,,,19/1/2022 7:23
16/6/2021,Samut Songkhram,34,460,191737,91607,100130,17315,17259,56,18,11,19/1/2022 7:23
16/6/2021,Samut Sakhon,101,21716,587191,283020,304171,1347,1347,0,61,29,19/1/2022 7:23
16/6/2021,Saraburi,16,1143,643677,316181,327496,14753,14707,46,49,39,19/1/2022 7:23
16/6/2021,Sa kaeo,15,1207,561052,279978,281074,2761,2761,0,25,18,19/1/2022 7:23
16/6/2021,Sing Buri,1,148,205344,97567,107777,3421,3421,0,,,19/1/2022 7:23
16/6/2021,Suphan Buri,19,544,837218,404081,433137,20061,20061,0,,,19/1/2022 7:23
16/6/2021,Surat Thani,10,1855,1069905,526507,543398,4456,4439,17,67,37,19/1/2022 7:23
16/6/2021,Surin,1,197,1377402,685400,692002,10395,10377,18,,,19/1/2022 7:23
16/6/2021,Sukhothai,1,125,586606,284242,302364,7337,7029,308,,,19/1/2022 7:23
16/6/2021,Nong Khai,0,91,517219,256618,260601,12678,12669,9,35,14,19/1/2022 7:23
16/6/2021,Nong Bua Lam Phu,1,81,509323,254117,255206,3248,3248,0,,,19/1/2022 7:23
16/6/2021,Amnat Charoen,0,57,376371,187343,189028,2235,2235,0,,,19/1/2022 7:23
16/6/2021,Udon Thani,5,527,1567321,776506,790815,16592,16582,10,,,19/1/2022 7:23
16/6/2021,Uttaradit,1,105,447366,218091,229275,7129,7129,0,,,19/1/2022 7:23
16/6/2021,Uthai Thani,0,47,325515,159149,166366,2979,2979,0,,,19/1/2022 7:23
16/6/2021,Ubon Ratchathani,3,387,1867065,932291,934774,19665,19665,0,29,14,19/1/2022 7:23
16/6/2021,Ang Thong,2,338,275836,132062,143774,2258,2258,0,,,19/1/2022 7:23
16/6/2021,Chiang Rai,6,744,1297104,630696,666408,26342,26054,288,30,12,19/1/2022 7:23
16/6/2021,Chiang Mai,0,8432,1786156,863211,922945,80431,79438,993,45,22,19/1/2022 7:23
16/6/2021,Phetchaburi,23,7957,482299,232776,249523,41434,41240,194,,,19/1/2022 7:23
16/6/2021,Phetchabun,5,190,979800,483288,496512,23760,23760,0,,,19/1/2022 7:23
16/6/2021,Loei,1,110,638445,319953,318492,5204,5185,19,25,15,19/1/2022 7:23
16/6/2021,Phrae,0,89,435883,210160,225723,6005,6005,0,31,15,19/1/2022 7:23
16/6/2021,Mae Hong Son,0,54,285642,144738,140904,8603,8391,212,15,4,19/1/2022 7:23
16/6/2021,,0,153,,,,,,,,,19/1/2022 7:23
17/6/2021,Krabi,4,358,478523,237695,240828,2661,2547,114,,,19/1/2022 7:23
17/6/2021,Bangkok,1477,80697,5557605,2607913,2949692,256622,230749,25873,46,25,19/1/2022 7:23
17/6/2021,Kanchanaburi,3,394,892655,447517,445138,61297,61077,220,30,13,19/1/2022 7:23
17/6/2021,Kalasin,3,142,976880,483049,493831,2792,2792,0,,,19/1/2022 7:23
17/6/2021,Kamphaeng Phet,8,265,713388,352344,361044,7265,7265,0,,,19/1/2022 7:23
17/6/2021,Khon Kaen,2,567,1792631,881416,911215,39567,39567,0,56,33,19/1/2022 7:23
17/6/2021,Chanthaburi,12,1326,535759,262053,273706,20687,20602,85,,,19/1/2022 7:23
17/6/2021,Chachoengsao,31,4055,722120,354040,368080,4415,4415,0,57,32,19/1/2022 7:23
17/6/2021,Chon Buri,75,7268,1576670,769103,807567,41441,40719,722,44,32,19/1/2022 7:23
17/6/2021,Chai Nat,0,101,321397,154547,166850,5221,5221,0,,,19/1/2022 7:23
17/6/2021,Chaiyaphum,0,337,1123720,555261,568459,6515,6506,9,,,19/1/2022 7:23
17/6/2021,Chumphon,1,153,509518,251488,258030,2539,2539,0,,,19/1/2022 7:23
17/6/2021,Trang,25,1460,640151,313123,327028,3134,3134,0,,,19/1/2022 7:23
17/6/2021,Trat,9,242,228460,112953,115507,19181,19065,116,,,19/1/2022 7:23
17/6/2021,Tak,4,730,674065,340821,333244,16539,16539,0,,,19/1/2022 7:23
17/6/2021,Nakhon Nayok,10,406,259655,128067,131588,4620,4620,0,,,19/1/2022 7:23
17/6/2021,Nakhon Pathom,130,2600,922334,443151,479183,8757,8744,13,36,20,19/1/2022 7:23
17/6/2021,Nakhon Phanom,0,148,717157,357396,359761,5327,5318,9,,,19/1/2022 7:23
17/6/2021,Nakhon Ratchasima,1,1032,2633864,1294474,1339390,120449,119801,648,52,27,19/1/2022 7:23
17/6/2021,Nakhon Si Thammarat,24,1206,1549931,764739,785192,9919,9919,0,,,19/1/2022 7:23
17/6/2021,Nakhon Sawan,9,602,1037728,506276,531452,18315,18315,0,33,23,19/1/2022 7:23
17/6/2021,Nonthaburi,116,17667,1283748,597411,686337,2979,2961,18,36,230,19/1/2022 7:23
17/6/2021,Narathiwat,67,1350,807983,399778,408205,613,613,0,60,21,19/1/2022 7:23
17/6/2021,Nan,2,136,476110,238240,237870,12538,12477,61,,,19/1/2022 7:23
17/6/2021,Bueng Kan,1,42,422320,211778,210542,3482,3477,5,,,19/1/2022 7:23
17/6/2021,Buri Ram,3,253,1580295,784354,795941,23788,23726,62,,,19/1/2022 7:23
17/6/2021,Pathum Thani,71,6689,1184377,561210,623167,1664,1645,19,49,19,19/1/2022 7:23
17/6/2021,Prachuap Khiri Khan,27,2156,551074,272744,278330,36899,36826,73,,,19/1/2022 7:23
17/6/2021,Prachin Buri,40,507,494401,244052,250349,3921,3921,0,55,28,19/1/2022 7:23
17/6/2021,Pattani,58,829,728135,359504,368631,837,837,0,,,19/1/2022 7:23
17/6/2021,Phra Nakhon Si Ayutthaya,43,2058,820129,394020,426109,61845,61474,371,44,36,19/1/2022 7:23
17/6/2021,Phayao,7,112,465644,226629,239015,8699,8699,0,27,17,19/1/2022 7:23
17/6/2021,Phang-nga,4,113,268563,134041,134522,5909,5544,365,,,19/1/2022 7:23
17/6/2021,Phatthalung,13,488,523027,254844,268183,2836,2836,0,,,19/1/2022 7:23
17/6/2021,Phichit,1,162,531180,259128,272052,6377,6377,0,,,19/1/2022 7:23
17/6/2021,Phitsanulok,2,368,847068,414386,432682,28588,28523,65,,,19/1/2022 7:23
17/6/2021,Phuket,5,913,415684,196375,219309,28777,28224,553,54,27,19/1/2022 7:23
17/6/2021,Maha Sarakham,17,415,950820,466360,484460,3552,3552,0,,,19/1/2022 7:23
17/6/2021,Mukdahan,0,45,351117,175421,175696,6539,6539,0,,,19/1/2022 7:23
17/6/2021,Yala,35,806,540726,269152,271574,923,923,0,58,23,19/1/2022 7:23
17/6/2021,Yasothon,1,145,533972,266534,267438,1630,1630,0,,,19/1/2022 7:23
17/6/2021,Ranong,13,1138,194715,98283,96432,2092,2092,0,,,19/1/2022 7:23
17/6/2021,Rayong,4,1728,747267,367184,380083,23374,23094,280,42,27,19/1/2022 7:23
17/6/2021,Ratchaburi,9,1049,869140,422590,446550,13639,13639,0,,,19/1/2022 7:23
17/6/2021,Roi Et,3,280,1297189,642792,654397,3901,3901,0,,,19/1/2022 7:23
17/6/2021,Lop Buri,0,406,739289,367896,371393,8701,8660,41,,,19/1/2022 7:23
17/6/2021,Lampang,0,270,726902,354357,372545,6899,6564,335,29,19,19/1/2022 7:23
17/6/2021,Lamphun,0,306,401818,193230,208588,7266,7171,95,,,19/1/2022 7:23
17/6/2021,Si Sa Ket,1,445,1457790,725911,731879,4874,4874,0,,,19/1/2022 7:23
17/6/2021,Sakon Nakhon,0,137,1146926,570016,576910,5542,5542,0,,,19/1/2022 7:23
17/6/2021,Songkhla,30,3077,1429245,696525,732720,2071,2048,23,67,33,19/1/2022 7:23
17/6/2021,Satun,1,52,324391,161409,162982,3087,3058,29,54,20,19/1/2022 7:23
17/6/2021,Samut Prakarn,390,12399,1355249,645868,709381,2956,2895,61,,,19/1/2022 7:23
17/6/2021,Samut Songkhram,14,474,191737,91607,100130,17315,17259,56,20,14,19/1/2022 7:23
17/6/2021,Samut Sakhon,171,21887,587191,283020,304171,1347,1347,0,61,30,19/1/2022 7:23
17/6/2021,Saraburi,23,1166,643677,316181,327496,14753,14707,46,45,51,19/1/2022 7:23
17/6/2021,Sa kaeo,17,1224,561052,279978,281074,2761,2761,0,32,22,19/1/2022 7:23
17/6/2021,Sing Buri,0,148,205344,97567,107777,3421,3421,0,,,19/1/2022 7:23
17/6/2021,Suphan Buri,19,563,837218,404081,433137,20061,20061,0,,,19/1/2022 7:23
17/6/2021,Surat Thani,11,1866,1069905,526507,543398,4456,4439,17,74,40,19/1/2022 7:23
17/6/2021,Surin,4,201,1377402,685400,692002,10395,10377,18,,,19/1/2022 7:23
17/6/2021,Sukhothai,0,125,586606,284242,302364,7337,7029,308,,,19/1/2022 7:23
17/6/2021,Nong Khai,1,92,517219,256618,260601,12678,12669,9,34,14,19/1/2022 7:23
17/6/2021,Nong Bua Lam Phu,4,85,509323,254117,255206,3248,3248,0,,,19/1/2022 7:23
17/6/2021,Amnat Charoen,0,57,376371,187343,189028,2235,2235,0,,,19/1/2022 7:23
17/6/2021,Udon Thani,8,535,1567321,776506,790815,16592,16582,10,,,19/1/2022 7:23
17/6/2021,Uttaradit,5,110,447366,218091,229275,7129,7129,0,,,19/1/2022 7:23
17/6/2021,Uthai Thani,0,47,325515,159149,166366,2979,2979,0,,,19/1/2022 7:23
17/6/2021,Ubon Ratchathani,3,390,1867065,932291,934774,19665,19665,0,27,24,19/1/2022 7:23
17/6/2021,Ang Thong,0,338,275836,132062,143774,2258,2258,0,,,19/1/2022 7:23
17/6/2021,Chiang Rai,23,767,1297104,630696,666408,26342,26054,288,23,14,19/1/2022 7:23
17/6/2021,Chiang Mai,1,8433,1786156,863211,922945,80431,79438,993,47,23,19/1/2022 7:23
17/6/2021,Phetchaburi,31,7988,482299,232776,249523,41434,41240,194,,,19/1/2022 7:23
17/6/2021,Phetchabun,2,192,979800,483288,496512,23760,23760,0,,,19/1/2022 7:23
17/6/2021,Loei,0,110,638445,319953,318492,5204,5185,19,21,19,19/1/2022 7:23
17/6/2021,Phrae,0,89,435883,210160,225723,6005,6005,0,27,17,19/1/2022 7:23
17/6/2021,Mae Hong Son,0,54,285642,144738,140904,8603,8391,212,17,4,19/1/2022 7:23
17/6/2021,,0,153,,,,,,,,,19/1/2022 7:23
18/6/2021,Krabi,3,361,478523,237695,240828,2661,2547,114,,,19/1/2022 7:23
18/6/2021,Bangkok,1292,81989,5557605,2607913,2949692,256622,230749,25873,50,25,19/1/2022 7:23
18/6/2021,Kanchanaburi,7,401,892655,447517,445138,61297,61077,220,35,13,19/1/2022 7:23
18/6/2021,Kalasin,5,147,976880,483049,493831,2792,2792,0,,,19/1/2022 7:23
18/6/2021,Kamphaeng Phet,9,274,713388,352344,361044,7265,7265,0,,,19/1/2022 7:23
18/6/2021,Khon Kaen,2,569,1792631,881416,911215,39567,39567,0,63,37,19/1/2022 7:23
18/6/2021,Chanthaburi,8,1334,535759,262053,273706,20687,20602,85,,,19/1/2022 7:23
18/6/2021,Chachoengsao,74,4129,722120,354040,368080,4415,4415,0,58,31,19/1/2022 7:23
18/6/2021,Chon Buri,142,7410,1576670,769103,807567,41441,40719,722,46,31,19/1/2022 7:23
18/6/2021,Chai Nat,0,101,321397,154547,166850,5221,5221,0,,,19/1/2022 7:23
18/6/2021,Chaiyaphum,1,338,1123720,555261,568459,6515,6506,9,,,19/1/2022 7:23
18/6/2021,Chumphon,0,153,509518,251488,258030,2539,2539,0,,,19/1/2022 7:23
18/6/2021,Trang,13,1473,640151,313123,327028,3134,3134,0,,,19/1/2022 7:23
18/6/2021,Trat,3,245,228460,112953,115507,19181,19065,116,,,19/1/2022 7:23
18/6/2021,Tak,5,735,674065,340821,333244,16539,16539,0,,,19/1/2022 7:23
18/6/2021,Nakhon Nayok,14,420,259655,128067,131588,4620,4620,0,,,19/1/2022 7:23
18/6/2021,Nakhon Pathom,88,2688,922334,443151,479183,8757,8744,13,47,20,19/1/2022 7:23
18/6/2021,Nakhon Phanom,0,148,717157,357396,359761,5327,5318,9,,,19/1/2022 7:23
18/6/2021,Nakhon Ratchasima,10,1042,2633864,1294474,1339390,120449,119801,648,56,30,19/1/2022 7:23
18/6/2021,Nakhon Si Thammarat,67,1273,1549931,764739,785192,9919,9919,0,,,19/1/2022 7:23
18/6/2021,Nakhon Sawan,4,606,1037728,506276,531452,18315,18315,0,44,26,19/1/2022 7:23
18/6/2021,Nonthaburi,165,17832,1283748,597411,686337,2979,2961,18,31,16,19/1/2022 7:23
18/6/2021,Narathiwat,22,1372,807983,399778,408205,613,613,0,41,18,19/1/2022 7:23
18/6/2021,Nan,7,143,476110,238240,237870,12538,12477,61,,,19/1/2022 7:23
18/6/2021,Bueng Kan,1,43,422320,211778,210542,3482,3477,5,,,19/1/2022 7:23
18/6/2021,Buri Ram,4,257,1580295,784354,795941,23788,23726,62,,,19/1/2022 7:23
18/6/2021,Pathum Thani,93,6782,1184377,561210,623167,1664,1645,19,45,17,19/1/2022 7:23
18/6/2021,Prachuap Khiri Khan,50,2206,551074,272744,278330,36899,36826,73,,,19/1/2022 7:23
18/6/2021,Prachin Buri,17,524,494401,244052,250349,3921,3921,0,58,34,19/1/2022 7:23
18/6/2021,Pattani,95,924,728135,359504,368631,837,837,0,,,19/1/2022 7:23
18/6/2021,Phra Nakhon Si Ayutthaya,30,2088,820129,394020,426109,61845,61474,371,35,39,19/1/2022 7:23
18/6/2021,Phayao,13,125,465644,226629,239015,8699,8699,0,28,23,19/1/2022 7:23
18/6/2021,Phang-nga,9,122,268563,134041,134522,5909,5544,365,,,19/1/2022 7:23
18/6/2021,Phatthalung,0,488,523027,254844,268183,2836,2836,0,,,19/1/2022 7:23
18/6/2021,Phichit,0,162,531180,259128,272052,6377,6377,0,,,19/1/2022 7:23
18/6/2021,Phitsanulok,0,368,847068,414386,432682,28588,28523,65,,,19/1/2022 7:23
18/6/2021,Phuket,5,918,415684,196375,219309,28777,28224,553,56,27,19/1/2022 7:23
18/6/2021,Maha Sarakham,9,424,950820,466360,484460,3552,3552,0,,,19/1/2022 7:23
18/6/2021,Mukdahan,0,45,351117,175421,175696,6539,6539,0,,,19/1/2022 7:23
18/6/2021,Yala,46,852,540726,269152,271574,923,923,0,51,24,19/1/2022 7:23
18/6/2021,Yasothon,0,145,533972,266534,267438,1630,1630,0,,,19/1/2022 7:23
18/6/2021,Ranong,22,1160,194715,98283,96432,2092,2092,0,,,19/1/2022 7:23
18/6/2021,Rayong,7,1735,747267,367184,380083,23374,23094,280,43,26,19/1/2022 7:23
18/6/2021,Ratchaburi,12,1061,869140,422590,446550,13639,13639,0,,,19/1/2022 7:23
18/6/2021,Roi Et,13,293,1297189,642792,654397,3901,3901,0,,,19/1/2022 7:23
18/6/2021,Lop Buri,2,408,739289,367896,371393,8701,8660,41,,,19/1/2022 7:23
18/6/2021,Lampang,0,270,726902,354357,372545,6899,6564,335,35,25,19/1/2022 7:23
18/6/2021,Lamphun,0,306,401818,193230,208588,7266,7171,95,,,19/1/2022 7:23
18/6/2021,Si Sa Ket,0,445,1457790,725911,731879,4874,4874,0,,,19/1/2022 7:23
18/6/2021,Sakon Nakhon,1,138,1146926,570016,576910,5542,5542,0,,,19/1/2022 7:23
18/6/2021,Songkhla,152,3229,1429245,696525,732720,2071,2048,23,68,37,19/1/2022 7:23
18/6/2021,Satun,0,52,324391,161409,162982,3087,3058,29,55,23,19/1/2022 7:23
18/6/2021,Samut Prakarn,240,12639,1355249,645868,709381,2956,2895,61,,,19/1/2022 7:23
18/6/2021,Samut Songkhram,9,483,191737,91607,100130,17315,17259,56,28,15,19/1/2022 7:23
18/6/2021,Samut Sakhon,193,22080,587191,283020,304171,1347,1347,0,62,30,19/1/2022 7:23
18/6/2021,Saraburi,13,1179,643677,316181,327496,14753,14707,46,53,49,19/1/2022 7:23
18/6/2021,Sa kaeo,9,1233,561052,279978,281074,2761,2761,0,39,25,19/1/2022 7:23
18/6/2021,Sing Buri,1,149,205344,97567,107777,3421,3421,0,,,19/1/2022 7:23
18/6/2021,Suphan Buri,3,566,837218,404081,433137,20061,20061,0,,,19/1/2022 7:23
18/6/2021,Surat Thani,11,1877,1069905,526507,543398,4456,4439,17,83,41,19/1/2022 7:23
18/6/2021,Surin,1,202,1377402,685400,692002,10395,10377,18,,,19/1/2022 7:23
18/6/2021,Sukhothai,0,125,586606,284242,302364,7337,7029,308,,,19/1/2022 7:23
18/6/2021,Nong Khai,2,94,517219,256618,260601,12678,12669,9,36,17,19/1/2022 7:23
18/6/2021,Nong Bua Lam Phu,2,87,509323,254117,255206,3248,3248,0,,,19/1/2022 7:23
18/6/2021,Amnat Charoen,0,57,376371,187343,189028,2235,2235,0,,,19/1/2022 7:23
18/6/2021,Udon Thani,0,535,1567321,776506,790815,16592,16582,10,,,19/1/2022 7:23
18/6/2021,Uttaradit,2,112,447366,218091,229275,7129,7129,0,,,19/1/2022 7:23
18/6/2021,Uthai Thani,0,47,325515,159149,166366,2979,2979,0,,,19/1/2022 7:23
18/6/2021,Ubon Ratchathani,1,391,1867065,932291,934774,19665,19665,0,54,26,19/1/2022 7:23
18/6/2021,Ang Thong,0,338,275836,132062,143774,2258,2258,0,,,19/1/2022 7:23
18/6/2021,Chiang Rai,10,777,1297104,630696,666408,26342,26054,288,33,17,19/1/2022 7:23
18/6/2021,Chiang Mai,1,8434,1786156,863211,922945,80431,79438,993,51,24,19/1/2022 7:23
18/6/2021,Phetchaburi,34,8022,482299,232776,249523,41434,41240,194,,,19/1/2022 7:23
18/6/2021,Phetchabun,3,195,979800,483288,496512,23760,23760,0,,,19/1/2022 7:23
18/6/2021,Loei,0,110,638445,319953,318492,5204,5185,19,19,22,19/1/2022 7:23
18/6/2021,Phrae,1,90,435883,210160,225723,6005,6005,0,33,25,19/1/2022 7:23
18/6/2021,Mae Hong Son,0,54,285642,144738,140904,8603,8391,212,17,5,19/1/2022 7:23
18/6/2021,,0,153,,,,,,,,,19/1/2022 7:23
19/6/2021,Krabi,2,363,478523,237695,240828,2661,2547,114,,,19/1/2022 7:23
19/6/2021,Bangkok,1643,83632,5557605,2607913,2949692,256622,230749,25873,50,27,19/1/2022 7:23
19/6/2021,Kanchanaburi,7,408,892655,447517,445138,61297,61077,220,37,22,19/1/2022 7:23
19/6/2021,Kalasin,9,156,976880,483049,493831,2792,2792,0,,,19/1/2022 7:23
19/6/2021,Kamphaeng Phet,6,280,713388,352344,361044,7265,7265,0,,,19/1/2022 7:23
19/6/2021,Khon Kaen,2,571,1792631,881416,911215,39567,39567,0,62,45,19/1/2022 7:23
19/6/2021,Chanthaburi,16,1350,535759,262053,273706,20687,20602,85,,,19/1/2022 7:23
19/6/2021,Chachoengsao,42,4171,722120,354040,368080,4415,4415,0,51,35,19/1/2022 7:23
19/6/2021,Chon Buri,146,7556,1576670,769103,807567,41441,40719,722,50,29,19/1/2022 7:23
19/6/2021,Chai Nat,2,103,321397,154547,166850,5221,5221,0,,,19/1/2022 7:23
19/6/2021,Chaiyaphum,8,346,1123720,555261,568459,6515,6506,9,,,19/1/2022 7:23
19/6/2021,Chumphon,0,153,509518,251488,258030,2539,2539,0,,,19/1/2022 7:23
19/6/2021,Trang,28,1501,640151,313123,327028,3134,3134,0,,,19/1/2022 7:23
19/6/2021,Trat,15,260,228460,112953,115507,19181,19065,116,,,19/1/2022 7:23
19/6/2021,Tak,3,738,674065,340821,333244,16539,16539,0,,,19/1/2022 7:23
19/6/2021,Nakhon Nayok,22,442,259655,128067,131588,4620,4620,0,,,19/1/2022 7:23
19/6/2021,Nakhon Pathom,81,2769,922334,443151,479183,8757,8744,13,47,24,19/1/2022 7:23
19/6/2021,Nakhon Phanom,0,148,717157,357396,359761,5327,5318,9,,,19/1/2022 7:23
19/6/2021,Nakhon Ratchasima,12,1054,2633864,1294474,1339390,120449,119801,648,60,33,19/1/2022 7:23
19/6/2021,Nakhon Si Thammarat,39,1312,1549931,764739,785192,9919,9919,0,,,19/1/2022 7:23
19/6/2021,Nakhon Sawan,14,620,1037728,506276,531452,18315,18315,0,52,29,19/1/2022 7:23
19/6/2021,Nonthaburi,78,17910,1283748,597411,686337,2979,2961,18,33,22,19/1/2022 7:23
19/6/2021,Narathiwat,46,1418,807983,399778,408205,613,613,0,43,13,19/1/2022 7:23
19/6/2021,Nan,2,145,476110,238240,237870,12538,12477,61,,,19/1/2022 7:23
19/6/2021,Bueng Kan,0,43,422320,211778,210542,3482,3477,5,,,19/1/2022 7:23
19/6/2021,Buri Ram,1,258,1580295,784354,795941,23788,23726,62,,,19/1/2022 7:23
19/6/2021,Pathum Thani,173,6955,1184377,561210,623167,1664,1645,19,41,20,19/1/2022 7:23
19/6/2021,Prachuap Khiri Khan,45,2251,551074,272744,278330,36899,36826,73,,,19/1/2022 7:23
19/6/2021,Prachin Buri,18,542,494401,244052,250349,3921,3921,0,68,33,19/1/2022 7:23
19/6/2021,Pattani,68,992,728135,359504,368631,837,837,0,,,19/1/2022 7:23
19/6/2021,Phra Nakhon Si Ayutthaya,38,2126,820129,394020,426109,61845,61474,371,36,40,19/1/2022 7:23
19/6/2021,Phayao,13,138,465644,226629,239015,8699,8699,0,44,21,19/1/2022 7:23
19/6/2021,Phang-nga,30,152,268563,134041,134522,5909,5544,365,,,19/1/2022 7:23
19/6/2021,Phatthalung,7,495,523027,254844,268183,2836,2836,0,,,19/1/2022 7:23
19/6/2021,Phichit,0,162,531180,259128,272052,6377,6377,0,,,19/1/2022 7:23
19/6/2021,Phitsanulok,2,370,847068,414386,432682,28588,28523,65,,,19/1/2022 7:23
19/6/2021,Phuket,5,923,415684,196375,219309,28777,28224,553,56,27,19/1/2022 7:23
19/6/2021,Maha Sarakham,4,428,950820,466360,484460,3552,3552,0,,,19/1/2022 7:23
19/6/2021,Mukdahan,0,45,351117,175421,175696,6539,6539,0,,,19/1/2022 7:23
19/6/2021,Yala,42,894,540726,269152,271574,923,923,0,56,17,19/1/2022 7:23
19/6/2021,Yasothon,1,146,533972,266534,267438,1630,1630,0,,,19/1/2022 7:23
19/6/2021,Ranong,21,1181,194715,98283,96432,2092,2092,0,,,19/1/2022 7:23
19/6/2021,Rayong,8,1743,747267,367184,380083,23374,23094,280,43,29,19/1/2022 7:23
19/6/2021,Ratchaburi,7,1068,869140,422590,446550,13639,13639,0,,,19/1/2022 7:23
19/6/2021,Roi Et,6,299,1297189,642792,654397,3901,3901,0,,,19/1/2022 7:23
19/6/2021,Lop Buri,6,414,739289,367896,371393,8701,8660,41,,,19/1/2022 7:23
19/6/2021,Lampang,0,270,726902,354357,372545,6899,6564,335,43,29,19/1/2022 7:23
19/6/2021,Lamphun,0,306,401818,193230,208588,7266,7171,95,,,19/1/2022 7:23
19/6/2021,Si Sa Ket,1,446,1457790,725911,731879,4874,4874,0,,,19/1/2022 7:23
19/6/2021,Sakon Nakhon,0,138,1146926,570016,576910,5542,5542,0,,,19/1/2022 7:23
19/6/2021,Songkhla,83,3312,1429245,696525,732720,2071,2048,23,74,32,19/1/2022 7:23
19/6/2021,Satun,33,85,324391,161409,162982,3087,3058,29,58,18,19/1/2022 7:23
19/6/2021,Samut Prakarn,495,13134,1355249,645868,709381,2956,2895,61,,,19/1/2022 7:23
19/6/2021,Samut Songkhram,13,496,191737,91607,100130,17315,17259,56,29,17,19/1/2022 7:23
19/6/2021,Samut Sakhon,171,22251,587191,283020,304171,1347,1347,0,55,33,19/1/2022 7:23
19/6/2021,Saraburi,21,1200,643677,316181,327496,14753,14707,46,59,49,19/1/2022 7:23
19/6/2021,Sa kaeo,20,1253,561052,279978,281074,2761,2761,0,46,28,19/1/2022 7:23
19/6/2021,Sing Buri,1,150,205344,97567,107777,3421,3421,0,,,19/1/2022 7:23
19/6/2021,Suphan Buri,4,570,837218,404081,433137,20061,20061,0,,,19/1/2022 7:23
19/6/2021,Surat Thani,7,1884,1069905,526507,543398,4456,4439,17,91,35,19/1/2022 7:23
19/6/2021,Surin,1,203,1377402,685400,692002,10395,10377,18,,,19/1/2022 7:23
19/6/2021,Sukhothai,0,125,586606,284242,302364,7337,7029,308,,,19/1/2022 7:23
19/6/2021,Nong Khai,0,94,517219,256618,260601,12678,12669,9,40,17,19/1/2022 7:23
19/6/2021,Nong Bua Lam Phu,0,87,509323,254117,255206,3248,3248,0,,,19/1/2022 7:23
19/6/2021,Amnat Charoen,0,57,376371,187343,189028,2235,2235,0,,,19/1/2022 7:23
19/6/2021,Udon Thani,0,535,1567321,776506,790815,16592,16582,10,,,19/1/2022 7:23
19/6/2021,Uttaradit,0,112,447366,218091,229275,7129,7129,0,,,19/1/2022 7:23
19/6/2021,Uthai Thani,0,47,325515,159149,166366,2979,2979,0,,,19/1/2022 7:23
19/6/2021,Ubon Ratchathani,1,392,1867065,932291,934774,19665,19665,0,59,34,19/1/2022 7:23
19/6/2021,Ang Thong,1,339,275836,132062,143774,2258,2258,0,,,19/1/2022 7:23
19/6/2021,Chiang Rai,17,794,1297104,630696,666408,26342,26054,288,41,15,19/1/2022 7:23
19/6/2021,Chiang Mai,1,8435,1786156,863211,922945,80431,79438,993,53,30,19/1/2022 7:23
19/6/2021,Phetchaburi,70,8092,482299,232776,249523,41434,41240,194,,,19/1/2022 7:23
19/6/2021,Phetchabun,5,200,979800,483288,496512,23760,23760,0,,,19/1/2022 7:23
19/6/2021,Loei,0,110,638445,319953,318492,5204,5185,19,40,27,19/1/2022 7:23
19/6/2021,Phrae,4,94,435883,210160,225723,6005,6005,0,49,24,19/1/2022 7:23
19/6/2021,Mae Hong Son,0,54,285642,144738,140904,8603,8391,212,23,7,19/1/2022 7:23
19/6/2021,,0,153,,,,,,,,,19/1/2022 7:23
20/6/2021,Krabi,7,370,478523,237695,240828,2661,2547,114,,,19/1/2022 7:23
20/6/2021,Bangkok,1367,84999,5557605,2607913,2949692,256622,230749,25873,45,44,19/1/2022 7:23
20/6/2021,Kanchanaburi,1,409,892655,447517,445138,61297,61077,220,50,40,19/1/2022 7:23
20/6/2021,Kalasin,3,159,976880,483049,493831,2792,2792,0,,,19/1/2022 7:23
20/6/2021,Kamphaeng Phet,7,287,713388,352344,361044,7265,7265,0,,,19/1/2022 7:23
20/6/2021,Khon Kaen,6,577,1792631,881416,911215,39567,39567,0,77,54,19/1/2022 7:23
20/6/2021,Chanthaburi,28,1378,535759,262053,273706,20687,20602,85,,,19/1/2022 7:23
20/6/2021,Chachoengsao,61,4232,722120,354040,368080,4415,4415,0,53,43,19/1/2022 7:23
20/6/2021,Chon Buri,178,7734,1576670,769103,807567,41441,40719,722,42,40,19/1/2022 7:23
20/6/2021,Chai Nat,1,104,321397,154547,166850,5221,5221,0,,,19/1/2022 7:23
20/6/2021,Chaiyaphum,1,347,1123720,555261,568459,6515,6506,9,,,19/1/2022 7:23
20/6/2021,Chumphon,1,154,509518,251488,258030,2539,2539,0,,,19/1/2022 7:23
20/6/2021,Trang,50,1551,640151,313123,327028,3134,3134,0,,,19/1/2022 7:23
20/6/2021,Trat,15,275,228460,112953,115507,19181,19065,116,,,19/1/2022 7:23
20/6/2021,Tak,2,740,674065,340821,333244,16539,16539,0,,,19/1/2022 7:23
20/6/2021,Nakhon Nayok,9,451,259655,128067,131588,4620,4620,0,,,19/1/2022 7:23
20/6/2021,Nakhon Pathom,127,2896,922334,443151,479183,8757,8744,13,41,40,19/1/2022 7:23
20/6/2021,Nakhon Phanom,0,148,717157,357396,359761,5327,5318,9,,,19/1/2022 7:23
20/6/2021,Nakhon Ratchasima,14,1068,2633864,1294474,1339390,120449,119801,648,61,44,19/1/2022 7:23
20/6/2021,Nakhon Si Thammarat,27,1339,1549931,764739,785192,9919,9919,0,,,19/1/2022 7:23
20/6/2021,Nakhon Sawan,6,626,1037728,506276,531452,18315,18315,0,55,51,19/1/2022 7:23
20/6/2021,Nonthaburi,169,18079,1283748,597411,686337,2979,2961,18,35,33,19/1/2022 7:23
20/6/2021,Narathiwat,108,1526,807983,399778,408205,613,613,0,26,15,19/1/2022 7:23
20/6/2021,Nan,0,145,476110,238240,237870,12538,12477,61,,,19/1/2022 7:23
20/6/2021,Bueng Kan,2,45,422320,211778,210542,3482,3477,5,,,19/1/2022 7:23
20/6/2021,Buri Ram,3,261,1580295,784354,795941,23788,23726,62,,,19/1/2022 7:23
20/6/2021,Pathum Thani,129,7084,1184377,561210,623167,1664,1645,19,49,20,19/1/2022 7:23
20/6/2021,Prachuap Khiri Khan,32,2283,551074,272744,278330,36899,36826,73,,,19/1/2022 7:23
20/6/2021,Prachin Buri,10,552,494401,244052,250349,3921,3921,0,60,45,19/1/2022 7:23
20/6/2021,Pattani,127,1119,728135,359504,368631,837,837,0,,,19/1/2022 7:23
20/6/2021,Phra Nakhon Si Ayutthaya,19,2145,820129,394020,426109,61845,61474,371,41,58,19/1/2022 7:23
20/6/2021,Phayao,2,140,465644,226629,239015,8699,8699,0,43,43,19/1/2022 7:23
20/6/2021,Phang-nga,27,179,268563,134041,134522,5909,5544,365,,,19/1/2022 7:23
20/6/2021,Phatthalung,2,497,523027,254844,268183,2836,2836,0,,,19/1/2022 7:23
20/6/2021,Phichit,0,162,531180,259128,272052,6377,6377,0,,,19/1/2022 7:23
20/6/2021,Phitsanulok,0,370,847068,414386,432682,28588,28523,65,,,19/1/2022 7:23
20/6/2021,Phuket,2,925,415684,196375,219309,28777,28224,553,56,26,19/1/2022 7:23
20/6/2021,Maha Sarakham,0,428,950820,466360,484460,3552,3552,0,,,19/1/2022 7:23
20/6/2021,Mukdahan,0,45,351117,175421,175696,6539,6539,0,,,19/1/2022 7:23
20/6/2021,Yala,58,952,540726,269152,271574,923,923,0,38,15,19/1/2022 7:23
20/6/2021,Yasothon,1,147,533972,266534,267438,1630,1630,0,,,19/1/2022 7:23
20/6/2021,Ranong,17,1198,194715,98283,96432,2092,2092,0,,,19/1/2022 7:23
20/6/2021,Rayong,4,1747,747267,367184,380083,23374,23094,280,45,36,19/1/2022 7:23
20/6/2021,Ratchaburi,13,1081,869140,422590,446550,13639,13639,0,,,19/1/2022 7:23
20/6/2021,Roi Et,6,305,1297189,642792,654397,3901,3901,0,,,19/1/2022 7:23
20/6/2021,Lop Buri,4,418,739289,367896,371393,8701,8660,41,,,19/1/2022 7:23
20/6/2021,Lampang,0,270,726902,354357,372545,6899,6564,335,50,46,19/1/2022 7:23
20/6/2021,Lamphun,0,306,401818,193230,208588,7266,7171,95,,,19/1/2022 7:23
20/6/2021,Si Sa Ket,2,448,1457790,725911,731879,4874,4874,0,,,19/1/2022 7:23
20/6/2021,Sakon Nakhon,8,146,1146926,570016,576910,5542,5542,0,,,19/1/2022 7:23
20/6/2021,Songkhla,154,3466,1429245,696525,732720,2071,2048,23,66,26,19/1/2022 7:23
20/6/2021,Satun,0,85,324391,161409,162982,3087,3058,29,40,15,19/1/2022 7:23
20/6/2021,Samut Prakarn,501,13635,1355249,645868,709381,2956,2895,61,,,19/1/2022 7:23
20/6/2021,Samut Songkhram,10,506,191737,91607,100130,17315,17259,56,32,34,19/1/2022 7:23
20/6/2021,Samut Sakhon,192,22443,587191,283020,304171,1347,1347,0,63,51,19/1/2022 7:23
20/6/2021,Saraburi,13,1213,643677,316181,327496,14753,14707,46,57,67,19/1/2022 7:23
20/6/2021,Sa kaeo,10,1263,561052,279978,281074,2761,2761,0,48,38,19/1/2022 7:23
20/6/2021,Sing Buri,0,150,205344,97567,107777,3421,3421,0,,,19/1/2022 7:23
20/6/2021,Suphan Buri,8,578,837218,404081,433137,20061,20061,0,,,19/1/2022 7:23
20/6/2021,Surat Thani,4,1888,1069905,526507,543398,4456,4439,17,77,37,19/1/2022 7:23
20/6/2021,Surin,6,209,1377402,685400,692002,10395,10377,18,,,19/1/2022 7:23
20/6/2021,Sukhothai,0,125,586606,284242,302364,7337,7029,308,,,19/1/2022 7:23
20/6/2021,Nong Khai,0,94,517219,256618,260601,12678,12669,9,42,20,19/1/2022 7:23
20/6/2021,Nong Bua Lam Phu,0,87,509323,254117,255206,3248,3248,0,,,19/1/2022 7:23
20/6/2021,Amnat Charoen,0,57,376371,187343,189028,2235,2235,0,,,19/1/2022 7:23
20/6/2021,Udon Thani,5,540,1567321,776506,790815,16592,16582,10,,,19/1/2022 7:23
20/6/2021,Uttaradit,0,112,447366,218091,229275,7129,7129,0,,,19/1/2022 7:23
20/6/2021,Uthai Thani,0,47,325515,159149,166366,2979,2979,0,,,19/1/2022 7:23
20/6/2021,Ubon Ratchathani,2,394,1867065,932291,934774,19665,19665,0,67,37,19/1/2022 7:23
20/6/2021,Ang Thong,5,344,275836,132062,143774,2258,2258,0,,,19/1/2022 7:23
20/6/2021,Chiang Rai,28,822,1297104,630696,666408,26342,26054,288,37,35,19/1/2022 7:23
20/6/2021,Chiang Mai,3,8438,1786156,863211,922945,80431,79438,993,63,44,19/1/2022 7:23
20/6/2021,Phetchaburi,76,8168,482299,232776,249523,41434,41240,194,,,19/1/2022 7:23
20/6/2021,Phetchabun,7,207,979800,483288,496512,23760,23760,0,,,19/1/2022 7:23
20/6/2021,Loei,0,110,638445,319953,318492,5204,5185,19,42,43,19/1/2022 7:23
20/6/2021,Phrae,2,96,435883,210160,225723,6005,6005,0,56,42,19/1/2022 7:23
20/6/2021,Mae Hong Son,0,54,285642,144738,140904,8603,8391,212,26,11,19/1/2022 7:23
20/6/2021,,0,153,,,,,,,,,19/1/2022 7:23
21/6/2021,Krabi,6,376,478523,237695,240828,2661,2547,114,,,19/1/2022 7:23
21/6/2021,Bangkok,640,85639,5557605,2607913,2949692,256622,230749,25873,74,54,19/1/2022 7:23
21/6/2021,Kanchanaburi,5,414,892655,447517,445138,61297,61077,220,81,40,19/1/2022 7:23
21/6/2021,Kalasin,1,160,976880,483049,493831,2792,2792,0,,,19/1/2022 7:23
21/6/2021,Kamphaeng Phet,5,292,713388,352344,361044,7265,7265,0,,,19/1/2022 7:23
21/6/2021,Khon Kaen,3,580,1792631,881416,911215,39567,39567,0,81,60,19/1/2022 7:23
21/6/2021,Chanthaburi,11,1389,535759,262053,273706,20687,20602,85,,,19/1/2022 7:23
21/6/2021,Chachoengsao,75,4307,722120,354040,368080,4415,4415,0,64,47,19/1/2022 7:23
21/6/2021,Chon Buri,191,7925,1576670,769103,807567,41441,40719,722,60,52,19/1/2022 7:23
21/6/2021,Chai Nat,1,105,321397,154547,166850,5221,5221,0,,,19/1/2022 7:23
21/6/2021,Chaiyaphum,0,347,1123720,555261,568459,6515,6506,9,,,19/1/2022 7:23
21/6/2021,Chumphon,2,156,509518,251488,258030,2539,2539,0,,,19/1/2022 7:23
21/6/2021,Trang,15,1566,640151,313123,327028,3134,3134,0,,,19/1/2022 7:23
21/6/2021,Trat,1,276,228460,112953,115507,19181,19065,116,,,19/1/2022 7:23
21/6/2021,Tak,1,741,674065,340821,333244,16539,16539,0,,,19/1/2022 7:23
21/6/2021,Nakhon Nayok,10,461,259655,128067,131588,4620,4620,0,,,19/1/2022 7:23
21/6/2021,Nakhon Pathom,359,3255,922334,443151,479183,8757,8744,13,64,45,19/1/2022 7:23
21/6/2021,Nakhon Phanom,0,148,717157,357396,359761,5327,5318,9,,,19/1/2022 7:23
21/6/2021,Nakhon Ratchasima,7,1075,2633864,1294474,1339390,120449,119801,648,72,53,19/1/2022 7:23
21/6/2021,Nakhon Si Thammarat,28,1367,1549931,764739,785192,9919,9919,0,,,19/1/2022 7:23
21/6/2021,Nakhon Sawan,4,630,1037728,506276,531452,18315,18315,0,101,34,19/1/2022 7:23
21/6/2021,Nonthaburi,117,18196,1283748,597411,686337,2979,2961,18,52,50,19/1/2022 7:23
21/6/2021,Narathiwat,42,1568,807983,399778,408205,613,613,0,32,21,19/1/2022 7:23
21/6/2021,Nan,1,146,476110,238240,237870,12538,12477,61,,,19/1/2022 7:23
21/6/2021,Bueng Kan,0,45,422320,211778,210542,3482,3477,5,,,19/1/2022 7:23
21/6/2021,Buri Ram,1,262,1580295,784354,795941,23788,23726,62,,,19/1/2022 7:23
21/6/2021,Pathum Thani,166,7250,1184377,561210,623167,1664,1645,19,64,38,19/1/2022 7:23
21/6/2021,Prachuap Khiri Khan,42,2325,551074,272744,278330,36899,36826,73,,,19/1/2022 7:23
21/6/2021,Prachin Buri,48,600,494401,244052,250349,3921,3921,0,79,51,19/1/2022 7:23
21/6/2021,Pattani,84,1203,728135,359504,368631,837,837,0,,,19/1/2022 7:23
21/6/2021,Phra Nakhon Si Ayutthaya,28,2173,820129,394020,426109,61845,61474,371,64,62,19/1/2022 7:23
21/6/2021,Phayao,9,149,465644,226629,239015,8699,8699,0,63,23,19/1/2022 7:23
21/6/2021,Phang-nga,31,210,268563,134041,134522,5909,5544,365,,,19/1/2022 7:23
21/6/2021,Phatthalung,13,510,523027,254844,268183,2836,2836,0,,,19/1/2022 7:23
21/6/2021,Phichit,0,162,531180,259128,272052,6377,6377,0,,,19/1/2022 7:23
21/6/2021,Phitsanulok,1,371,847068,414386,432682,28588,28523,65,,,19/1/2022 7:23
21/6/2021,Phuket,5,930,415684,196375,219309,28777,28224,553,54,23,19/1/2022 7:23
21/6/2021,Maha Sarakham,0,428,950820,466360,484460,3552,3552,0,,,19/1/2022 7:23
21/6/2021,Mukdahan,0,45,351117,175421,175696,6539,6539,0,,,19/1/2022 7:23
21/6/2021,Yala,74,1026,540726,269152,271574,923,923,0,35,22,19/1/2022 7:23
21/6/2021,Yasothon,0,147,533972,266534,267438,1630,1630,0,,,19/1/2022 7:23
21/6/2021,Ranong,10,1208,194715,98283,96432,2092,2092,0,,,19/1/2022 7:23
21/6/2021,Rayong,12,1759,747267,367184,380083,23374,23094,280,50,42,19/1/2022 7:23
21/6/2021,Ratchaburi,14,1095,869140,422590,446550,13639,13639,0,,,19/1/2022 7:23
21/6/2021,Roi Et,5,310,1297189,642792,654397,3901,3901,0,,,19/1/2022 7:23
21/6/2021,Lop Buri,3,421,739289,367896,371393,8701,8660,41,,,19/1/2022 7:23
21/6/2021,Lampang,0,270,726902,354357,372545,6899,6564,335,68,30,19/1/2022 7:23
21/6/2021,Lamphun,1,307,401818,193230,208588,7266,7171,95,,,19/1/2022 7:23
21/6/2021,Si Sa Ket,0,448,1457790,725911,731879,4874,4874,0,,,19/1/2022 7:23
21/6/2021,Sakon Nakhon,8,154,1146926,570016,576910,5542,5542,0,,,19/1/2022 7:23
21/6/2021,Songkhla,162,3628,1429245,696525,732720,2071,2048,23,51,36,19/1/2022 7:23
21/6/2021,Satun,9,94,324391,161409,162982,3087,3058,29,24,15,19/1/2022 7:23
21/6/2021,Samut Prakarn,545,14180,1355249,645868,709381,2956,2895,61,,,19/1/2022 7:23
21/6/2021,Samut Songkhram,11,517,191737,91607,100130,17315,17259,56,54,39,19/1/2022 7:23
21/6/2021,Samut Sakhon,179,22622,587191,283020,304171,1347,1347,0,87,59,19/1/2022 7:23
21/6/2021,Saraburi,26,1239,643677,316181,327496,14753,14707,46,82,62,19/1/2022 7:23
21/6/2021,Sa kaeo,37,1300,561052,279978,281074,2761,2761,0,61,41,19/1/2022 7:23
21/6/2021,Sing Buri,0,150,205344,97567,107777,3421,3421,0,,,19/1/2022 7:23
21/6/2021,Suphan Buri,13,591,837218,404081,433137,20061,20061,0,,,19/1/2022 7:23
21/6/2021,Surat Thani,1,1889,1069905,526507,543398,4456,4439,17,69,36,19/1/2022 7:23
21/6/2021,Surin,3,212,1377402,685400,692002,10395,10377,18,,,19/1/2022 7:23
21/6/2021,Sukhothai,0,125,586606,284242,302364,7337,7029,308,,,19/1/2022 7:23
21/6/2021,Nong Khai,1,95,517219,256618,260601,12678,12669,9,48,16,19/1/2022 7:23
21/6/2021,Nong Bua Lam Phu,0,87,509323,254117,255206,3248,3248,0,,,19/1/2022 7:23
21/6/2021,Amnat Charoen,0,57,376371,187343,189028,2235,2235,0,,,19/1/2022 7:23
21/6/2021,Udon Thani,3,543,1567321,776506,790815,16592,16582,10,,,19/1/2022 7:23
21/6/2021,Uttaradit,0,112,447366,218091,229275,7129,7129,0,,,19/1/2022 7:23
21/6/2021,Uthai Thani,3,50,325515,159149,166366,2979,2979,0,,,19/1/2022 7:23
21/6/2021,Ubon Ratchathani,5,399,1867065,932291,934774,19665,19665,0,61,51,19/1/2022 7:23
21/6/2021,Ang Thong,3,347,275836,132062,143774,2258,2258,0,,,19/1/2022 7:23
21/6/2021,Chiang Rai,21,843,1297104,630696,666408,26342,26054,288,60,18,19/1/2022 7:23
21/6/2021,Chiang Mai,2,8440,1786156,863211,922945,80431,79438,993,74,30,19/1/2022 7:23
21/6/2021,Phetchaburi,60,8228,482299,232776,249523,41434,41240,194,,,19/1/2022 7:23
21/6/2021,Phetchabun,7,214,979800,483288,496512,23760,23760,0,,,19/1/2022 7:23
21/6/2021,Loei,4,114,638445,319953,318492,5204,5185,19,66,35,19/1/2022 7:23
21/6/2021,Phrae,0,96,435883,210160,225723,6005,6005,0,71,29,19/1/2022 7:23
21/6/2021,Mae Hong Son,0,54,285642,144738,140904,8603,8391,212,45,10,19/1/2022 7:23
21/6/2021,,0,153,,,,,,,,,19/1/2022 7:23
22/6/2021,Krabi,9,385,478523,237695,240828,2661,2547,114,,,19/1/2022 7:23
22/6/2021,Bangkok,1220,86859,5557605,2607913,2949692,256622,230749,25873,94,41,19/1/2022 7:23
22/6/2021,Kanchanaburi,12,426,892655,447517,445138,61297,61077,220,81,20,19/1/2022 7:23
22/6/2021,Kalasin,2,162,976880,483049,493831,2792,2792,0,,,19/1/2022 7:23
22/6/2021,Kamphaeng Phet,7,299,713388,352344,361044,7265,7265,0,,,19/1/2022 7:23
22/6/2021,Khon Kaen,0,580,1792631,881416,911215,39567,39567,0,90,52,19/1/2022 7:23
22/6/2021,Chanthaburi,20,1409,535759,262053,273706,20687,20602,85,,,19/1/2022 7:23
22/6/2021,Chachoengsao,60,4367,722120,354040,368080,4415,4415,0,71,39,19/1/2022 7:23
22/6/2021,Chon Buri,335,8260,1576670,769103,807567,41441,40719,722,71,40,19/1/2022 7:23
22/6/2021,Chai Nat,0,105,321397,154547,166850,5221,5221,0,,,19/1/2022 7:23
22/6/2021,Chaiyaphum,0,347,1123720,555261,568459,6515,6506,9,,,19/1/2022 7:23
22/6/2021,Chumphon,5,161,509518,251488,258030,2539,2539,0,,,19/1/2022 7:23
22/6/2021,Trang,20,1586,640151,313123,327028,3134,3134,0,,,19/1/2022 7:23
22/6/2021,Trat,3,279,228460,112953,115507,19181,19065,116,,,19/1/2022 7:23
22/6/2021,Tak,2,743,674065,340821,333244,16539,16539,0,,,19/1/2022 7:23
22/6/2021,Nakhon Nayok,4,465,259655,128067,131588,4620,4620,0,,,19/1/2022 7:23
22/6/2021,Nakhon Pathom,162,3417,922334,443151,479183,8757,8744,13,70,28,19/1/2022 7:23
22/6/2021,Nakhon Phanom,4,152,717157,357396,359761,5327,5318,9,,,19/1/2022 7:23
22/6/2021,Nakhon Ratchasima,10,1085,2633864,1294474,1339390,120449,119801,648,78,43,19/1/2022 7:23
22/6/2021,Nakhon Si Thammarat,25,1392,1549931,764739,785192,9919,9919,0,,,19/1/2022 7:23
22/6/2021,Nakhon Sawan,11,641,1037728,506276,531452,18315,18315,0,67,30,19/1/2022 7:23
22/6/2021,Nonthaburi,170,18366,1283748,597411,686337,2979,2961,18,60,44,19/1/2022 7:23
22/6/2021,Narathiwat,61,1629,807983,399778,408205,613,613,0,48,27,19/1/2022 7:23
22/6/2021,Nan,0,146,476110,238240,237870,12538,12477,61,,,19/1/2022 7:23
22/6/2021,Bueng Kan,0,45,422320,211778,210542,3482,3477,5,,,19/1/2022 7:23
22/6/2021,Buri Ram,0,262,1580295,784354,795941,23788,23726,62,,,19/1/2022 7:23
22/6/2021,Pathum Thani,211,7461,1184377,561210,623167,1664,1645,19,69,25,19/1/2022 7:23
22/6/2021,Prachuap Khiri Khan,2,2327,551074,272744,278330,36899,36826,73,,,19/1/2022 7:23
22/6/2021,Prachin Buri,16,616,494401,244052,250349,3921,3921,0,83,42,19/1/2022 7:23
22/6/2021,Pattani,81,1284,728135,359504,368631,837,837,0,,,19/1/2022 7:23
22/6/2021,Phra Nakhon Si Ayutthaya,45,2218,820129,394020,426109,61845,61474,371,71,49,19/1/2022 7:23
22/6/2021,Phayao,0,149,465644,226629,239015,8699,8699,0,46,25,19/1/2022 7:23
22/6/2021,Phang-nga,3,213,268563,134041,134522,5909,5544,365,,,19/1/2022 7:23
22/6/2021,Phatthalung,4,514,523027,254844,268183,2836,2836,0,,,19/1/2022 7:23
22/6/2021,Phichit,1,163,531180,259128,272052,6377,6377,0,,,19/1/2022 7:23
22/6/2021,Phitsanulok,1,372,847068,414386,432682,28588,28523,65,,,19/1/2022 7:23
22/6/2021,Phuket,4,934,415684,196375,219309,28777,28224,553,52,30,19/1/2022 7:23
22/6/2021,Maha Sarakham,2,430,950820,466360,484460,3552,3552,0,,,19/1/2022 7:23
22/6/2021,Mukdahan,0,45,351117,175421,175696,6539,6539,0,,,19/1/2022 7:23
22/6/2021,Yala,46,1072,540726,269152,271574,923,923,0,48,30,19/1/2022 7:23
22/6/2021,Yasothon,1,148,533972,266534,267438,1630,1630,0,,,19/1/2022 7:23
22/6/2021,Ranong,7,1215,194715,98283,96432,2092,2092,0,,,19/1/2022 7:23
22/6/2021,Rayong,63,1822,747267,367184,380083,23374,23094,280,58,34,19/1/2022 7:23
22/6/2021,Ratchaburi,15,1110,869140,422590,446550,13639,13639,0,,,19/1/2022 7:23
22/6/2021,Roi Et,2,312,1297189,642792,654397,3901,3901,0,,,19/1/2022 7:23
22/6/2021,Lop Buri,4,425,739289,367896,371393,8701,8660,41,,,19/1/2022 7:23
22/6/2021,Lampang,0,270,726902,354357,372545,6899,6564,335,42,30,19/1/2022 7:23
22/6/2021,Lamphun,0,307,401818,193230,208588,7266,7171,95,,,19/1/2022 7:23
22/6/2021,Si Sa Ket,1,449,1457790,725911,731879,4874,4874,0,,,19/1/2022 7:23
22/6/2021,Sakon Nakhon,5,159,1146926,570016,576910,5542,5542,0,,,19/1/2022 7:23
22/6/2021,Songkhla,293,3921,1429245,696525,732720,2071,2048,23,73,27,19/1/2022 7:23
22/6/2021,Satun,0,94,324391,161409,162982,3087,3058,29,31,16,19/1/2022 7:23
22/6/2021,Samut Prakarn,696,14876,1355249,645868,709381,2956,2895,61,,,19/1/2022 7:23
22/6/2021,Samut Songkhram,27,544,191737,91607,100130,17315,17259,56,59,24,19/1/2022 7:23
22/6/2021,Samut Sakhon,250,22872,587191,283020,304171,1347,1347,0,97,42,19/1/2022 7:23
22/6/2021,Saraburi,11,1250,643677,316181,327496,14753,14707,46,82,51,19/1/2022 7:23
22/6/2021,Sa kaeo,2,1302,561052,279978,281074,2761,2761,0,65,30,19/1/2022 7:23
22/6/2021,Sing Buri,0,150,205344,97567,107777,3421,3421,0,,,19/1/2022 7:23
22/6/2021,Suphan Buri,14,605,837218,404081,433137,20061,20061,0,,,19/1/2022 7:23
22/6/2021,Surat Thani,9,1898,1069905,526507,543398,4456,4439,17,82,32,19/1/2022 7:23
22/6/2021,Surin,2,214,1377402,685400,692002,10395,10377,18,,,19/1/2022 7:23
22/6/2021,Sukhothai,2,127,586606,284242,302364,7337,7029,308,,,19/1/2022 7:23
22/6/2021,Nong Khai,0,95,517219,256618,260601,12678,12669,9,40,12,19/1/2022 7:23
22/6/2021,Nong Bua Lam Phu,0,87,509323,254117,255206,3248,3248,0,,,19/1/2022 7:23
22/6/2021,Amnat Charoen,0,57,376371,187343,189028,2235,2235,0,,,19/1/2022 7:23
22/6/2021,Udon Thani,6,549,1567321,776506,790815,16592,16582,10,,,19/1/2022 7:23
22/6/2021,Uttaradit,0,112,447366,218091,229275,7129,7129,0,,,19/1/2022 7:23
22/6/2021,Uthai Thani,0,50,325515,159149,166366,2979,2979,0,,,19/1/2022 7:23
22/6/2021,Ubon Ratchathani,2,401,1867065,932291,934774,19665,19665,0,77,35,19/1/2022 7:23
22/6/2021,Ang Thong,3,350,275836,132062,143774,2258,2258,0,,,19/1/2022 7:23
22/6/2021,Chiang Rai,42,885,1297104,630696,666408,26342,26054,288,48,19,19/1/2022 7:23
22/6/2021,Chiang Mai,3,8443,1786156,863211,922945,80431,79438,993,62,29,19/1/2022 7:23
22/6/2021,Phetchaburi,27,8255,482299,232776,249523,41434,41240,194,,,19/1/2022 7:23
22/6/2021,Phetchabun,3,217,979800,483288,496512,23760,23760,0,,,19/1/2022 7:23
22/6/2021,Loei,10,124,638445,319953,318492,5204,5185,19,57,28,19/1/2022 7:23
22/6/2021,Phrae,1,97,435883,210160,225723,6005,6005,0,62,28,19/1/2022 7:23
22/6/2021,Mae Hong Son,0,54,285642,144738,140904,8603,8391,212,39,9,19/1/2022 7:23
22/6/2021,,0,153,,,,,,,,,19/1/2022 7:23
23/6/2021,Krabi,19,404,478523,237695,240828,2661,2547,114,,,19/1/2022 7:23
23/6/2021,Bangkok,988,87847,5557605,2607913,2949692,256622,230749,25873,68,25,19/1/2022 7:23
23/6/2021,Kanchanaburi,31,457,892655,447517,445138,61297,61077,220,50,15,19/1/2022 7:23
23/6/2021,Kalasin,2,164,976880,483049,493831,2792,2792,0,,,19/1/2022 7:23
23/6/2021,Kamphaeng Phet,9,308,713388,352344,361044,7265,7265,0,,,19/1/2022 7:23
23/6/2021,Khon Kaen,3,583,1792631,881416,911215,39567,39567,0,81,41,19/1/2022 7:23
23/6/2021,Chanthaburi,18,1427,535759,262053,273706,20687,20602,85,,,19/1/2022 7:23
23/6/2021,Chachoengsao,31,4398,722120,354040,368080,4415,4415,0,62,28,19/1/2022 7:23
23/6/2021,Chon Buri,144,8404,1576670,769103,807567,41441,40719,722,57,30,19/1/2022 7:23
23/6/2021,Chai Nat,1,106,321397,154547,166850,5221,5221,0,,,19/1/2022 7:23
23/6/2021,Chaiyaphum,10,357,1123720,555261,568459,6515,6506,9,,,19/1/2022 7:23
23/6/2021,Chumphon,1,162,509518,251488,258030,2539,2539,0,,,19/1/2022 7:23
23/6/2021,Trang,5,1591,640151,313123,327028,3134,3134,0,,,19/1/2022 7:23
23/6/2021,Trat,1,280,228460,112953,115507,19181,19065,116,,,19/1/2022 7:23
23/6/2021,Tak,2,745,674065,340821,333244,16539,16539,0,,,19/1/2022 7:23
23/6/2021,Nakhon Nayok,1,466,259655,128067,131588,4620,4620,0,,,19/1/2022 7:23
23/6/2021,Nakhon Pathom,79,3496,922334,443151,479183,8757,8744,13,51,22,19/1/2022 7:23
23/6/2021,Nakhon Phanom,3,155,717157,357396,359761,5327,5318,9,,,19/1/2022 7:23
23/6/2021,Nakhon Ratchasima,7,1092,2633864,1294474,1339390,120449,119801,648,72,27,19/1/2022 7:23
23/6/2021,Nakhon Si Thammarat,8,1400,1549931,764739,785192,9919,9919,0,,,19/1/2022 7:23
23/6/2021,Nakhon Sawan,4,645,1037728,506276,531452,18315,18315,0,56,22,19/1/2022 7:23
23/6/2021,Nonthaburi,70,18436,1283748,597411,686337,2979,2961,18,45,18,19/1/2022 7:23
23/6/2021,Narathiwat,89,1718,807983,399778,408205,613,613,0,63,25,19/1/2022 7:23
23/6/2021,Nan,1,147,476110,238240,237870,12538,12477,61,,,19/1/2022 7:23
23/6/2021,Bueng Kan,0,45,422320,211778,210542,3482,3477,5,,,19/1/2022 7:23
23/6/2021,Buri Ram,1,263,1580295,784354,795941,23788,23726,62,,,19/1/2022 7:23
23/6/2021,Pathum Thani,93,7554,1184377,561210,623167,1664,1645,19,60,17,19/1/2022 7:23
23/6/2021,Prachuap Khiri Khan,15,2342,551074,272744,278330,36899,36826,73,,,19/1/2022 7:23
23/6/2021,Prachin Buri,15,631,494401,244052,250349,3921,3921,0,74,28,19/1/2022 7:23
23/6/2021,Pattani,120,1404,728135,359504,368631,837,837,0,,,19/1/2022 7:23
23/6/2021,Phra Nakhon Si Ayutthaya,32,2250,820129,394020,426109,61845,61474,371,58,40,19/1/2022 7:23
23/6/2021,Phayao,18,167,465644,226629,239015,8699,8699,0,48,18,19/1/2022 7:23
23/6/2021,Phang-nga,1,214,268563,134041,134522,5909,5544,365,,,19/1/2022 7:23
23/6/2021,Phatthalung,16,530,523027,254844,268183,2836,2836,0,,,19/1/2022 7:23
23/6/2021,Phichit,0,163,531180,259128,272052,6377,6377,0,,,19/1/2022 7:23
23/6/2021,Phitsanulok,3,375,847068,414386,432682,28588,28523,65,,,19/1/2022 7:23
23/6/2021,Phuket,3,937,415684,196375,219309,28777,28224,553,57,25,19/1/2022 7:23
23/6/2021,Maha Sarakham,1,431,950820,466360,484460,3552,3552,0,,,19/1/2022 7:23
23/6/2021,Mukdahan,0,45,351117,175421,175696,6539,6539,0,,,19/1/2022 7:23
23/6/2021,Yala,71,1143,540726,269152,271574,923,923,0,64,27,19/1/2022 7:23
23/6/2021,Yasothon,0,148,533972,266534,267438,1630,1630,0,,,19/1/2022 7:23
23/6/2021,Ranong,5,1220,194715,98283,96432,2092,2092,0,,,19/1/2022 7:23
23/6/2021,Rayong,15,1837,747267,367184,380083,23374,23094,280,56,26,19/1/2022 7:23
23/6/2021,Ratchaburi,91,1201,869140,422590,446550,13639,13639,0,,,19/1/2022 7:23
23/6/2021,Roi Et,1,313,1297189,642792,654397,3901,3901,0,,,19/1/2022 7:23
23/6/2021,Lop Buri,3,428,739289,367896,371393,8701,8660,41,,,19/1/2022 7:23
23/6/2021,Lampang,0,270,726902,354357,372545,6899,6564,335,48,23,19/1/2022 7:23
23/6/2021,Lamphun,0,307,401818,193230,208588,7266,7171,95,,,19/1/2022 7:23
23/6/2021,Si Sa Ket,2,451,1457790,725911,731879,4874,4874,0,,,19/1/2022 7:23
23/6/2021,Sakon Nakhon,4,163,1146926,570016,576910,5542,5542,0,,,19/1/2022 7:23
23/6/2021,Songkhla,193,4114,1429245,696525,732720,2071,2048,23,51,35,19/1/2022 7:23
23/6/2021,Satun,3,97,324391,161409,162982,3087,3058,29,45,29,19/1/2022 7:23
23/6/2021,Samut Prakarn,501,15377,1355249,645868,709381,2956,2895,61,,,19/1/2022 7:23
23/6/2021,Samut Songkhram,19,563,191737,91607,100130,17315,17259,56,43,16,19/1/2022 7:23
23/6/2021,Samut Sakhon,240,23112,587191,283020,304171,1347,1347,0,79,30,19/1/2022 7:23
23/6/2021,Saraburi,40,1290,643677,316181,327496,14753,14707,46,64,51,19/1/2022 7:23
23/6/2021,Sa kaeo,12,1314,561052,279978,281074,2761,2761,0,55,21,19/1/2022 7:23
23/6/2021,Sing Buri,0,150,205344,97567,107777,3421,3421,0,,,19/1/2022 7:23
23/6/2021,Suphan Buri,10,615,837218,404081,433137,20061,20061,0,,,19/1/2022 7:23
23/6/2021,Surat Thani,3,1901,1069905,526507,543398,4456,4439,17,73,36,19/1/2022 7:23
23/6/2021,Surin,7,221,1377402,685400,692002,10395,10377,18,,,19/1/2022 7:23
23/6/2021,Sukhothai,0,127,586606,284242,302364,7337,7029,308,,,19/1/2022 7:23
23/6/2021,Nong Khai,2,97,517219,256618,260601,12678,12669,9,30,10,19/1/2022 7:23
23/6/2021,Nong Bua Lam Phu,1,88,509323,254117,255206,3248,3248,0,,,19/1/2022 7:23
23/6/2021,Amnat Charoen,0,57,376371,187343,189028,2235,2235,0,,,19/1/2022 7:23
23/6/2021,Udon Thani,6,555,1567321,776506,790815,16592,16582,10,,,19/1/2022 7:23
23/6/2021,Uttaradit,3,115,447366,218091,229275,7129,7129,0,,,19/1/2022 7:23
23/6/2021,Uthai Thani,1,51,325515,159149,166366,2979,2979,0,,,19/1/2022 7:23
23/6/2021,Ubon Ratchathani,7,408,1867065,932291,934774,19665,19665,0,61,23,19/1/2022 7:23
23/6/2021,Ang Thong,0,350,275836,132062,143774,2258,2258,0,,,19/1/2022 7:23
23/6/2021,Chiang Rai,19,904,1297104,630696,666408,26342,26054,288,50,14,19/1/2022 7:23
23/6/2021,Chiang Mai,3,8446,1786156,863211,922945,80431,79438,993,61,25,19/1/2022 7:23
23/6/2021,Phetchaburi,62,8317,482299,232776,249523,41434,41240,194,,,19/1/2022 7:23
23/6/2021,Phetchabun,2,219,979800,483288,496512,23760,23760,0,,,19/1/2022 7:23
23/6/2021,Loei,3,127,638445,319953,318492,5204,5185,19,58,18,19/1/2022 7:23
23/6/2021,Phrae,0,97,435883,210160,225723,6005,6005,0,61,18,19/1/2022 7:23
23/6/2021,Mae Hong Son,0,54,285642,144738,140904,8603,8391,212,38,5,19/1/2022 7:23
23/6/2021,,0,153,,,,,,,,,19/1/2022 7:23
24/6/2021,Krabi,11,415,478523,237695,240828,2661,2547,114,,,19/1/2022 7:23
24/6/2021,Bangkok,1391,89238,5557605,2607913,2949692,256622,230749,25873,46,35,19/1/2022 7:23
24/6/2021,Kanchanaburi,8,465,892655,447517,445138,61297,61077,220,36,19,19/1/2022 7:23
24/6/2021,Kalasin,1,165,976880,483049,493831,2792,2792,0,,,19/1/2022 7:23
24/6/2021,Kamphaeng Phet,1,309,713388,352344,361044,7265,7265,0,,,19/1/2022 7:23
24/6/2021,Khon Kaen,1,584,1792631,881416,911215,39567,39567,0,67,39,19/1/2022 7:23
24/6/2021,Chanthaburi,7,1434,535759,262053,273706,20687,20602,85,,,19/1/2022 7:23
24/6/2021,Chachoengsao,70,4468,722120,354040,368080,4415,4415,0,46,33,19/1/2022 7:23
24/6/2021,Chon Buri,257,8661,1576670,769103,807567,41441,40719,722,40,40,19/1/2022 7:23
24/6/2021,Chai Nat,6,112,321397,154547,166850,5221,5221,0,,,19/1/2022 7:23
24/6/2021,Chaiyaphum,9,366,1123720,555261,568459,6515,6506,9,,,19/1/2022 7:23
24/6/2021,Chumphon,4,166,509518,251488,258030,2539,2539,0,,,19/1/2022 7:23
24/6/2021,Trang,22,1613,640151,313123,327028,3134,3134,0,,,19/1/2022 7:23
24/6/2021,Trat,3,283,228460,112953,115507,19181,19065,116,,,19/1/2022 7:23
24/6/2021,Tak,0,745,674065,340821,333244,16539,16539,0,,,19/1/2022 7:23
24/6/2021,Nakhon Nayok,10,476,259655,128067,131588,4620,4620,0,,,19/1/2022 7:23
24/6/2021,Nakhon Pathom,91,3587,922334,443151,479183,8757,8744,13,38,26,19/1/2022 7:23
24/6/2021,Nakhon Phanom,1,156,717157,357396,359761,5327,5318,9,,,19/1/2022 7:23
24/6/2021,Nakhon Ratchasima,20,1112,2633864,1294474,1339390,120449,119801,648,47,34,19/1/2022 7:23
24/6/2021,Nakhon Si Thammarat,31,1431,1549931,764739,785192,9919,9919,0,,,19/1/2022 7:23
24/6/2021,Nakhon Sawan,11,656,1037728,506276,531452,18315,18315,0,42,29,19/1/2022 7:23
24/6/2021,Nonthaburi,171,18607,1283748,597411,686337,2979,2961,18,29,20,19/1/2022 7:23
24/6/2021,Narathiwat,87,1805,807983,399778,408205,613,613,0,54,23,19/1/2022 7:23
24/6/2021,Nan,0,147,476110,238240,237870,12538,12477,61,,,19/1/2022 7:23
24/6/2021,Bueng Kan,0,45,422320,211778,210542,3482,3477,5,,,19/1/2022 7:23
24/6/2021,Buri Ram,7,270,1580295,784354,795941,23788,23726,62,,,19/1/2022 7:23
24/6/2021,Pathum Thani,157,7711,1184377,561210,623167,1664,1645,19,38,26,19/1/2022 7:23
24/6/2021,Prachuap Khiri Khan,29,2371,551074,272744,278330,36899,36826,73,,,19/1/2022 7:23
24/6/2021,Prachin Buri,26,657,494401,244052,250349,3921,3921,0,59,37,19/1/2022 7:23
24/6/2021,Pattani,72,1476,728135,359504,368631,837,837,0,,,19/1/2022 7:23
24/6/2021,Phra Nakhon Si Ayutthaya,47,2297,820129,394020,426109,61845,61474,371,37,50,19/1/2022 7:23
24/6/2021,Phayao,1,168,465644,226629,239015,8699,8699,0,32,22,19/1/2022 7:23
24/6/2021,Phang-nga,8,222,268563,134041,134522,5909,5544,365,,,19/1/2022 7:23
24/6/2021,Phatthalung,9,539,523027,254844,268183,2836,2836,0,,,19/1/2022 7:23
24/6/2021,Phichit,5,168,531180,259128,272052,6377,6377,0,,,19/1/2022 7:23
24/6/2021,Phitsanulok,3,378,847068,414386,432682,28588,28523,65,,,19/1/2022 7:23
24/6/2021,Phuket,2,939,415684,196375,219309,28777,28224,553,55,21,19/1/2022 7:23
24/6/2021,Maha Sarakham,8,439,950820,466360,484460,3552,3552,0,,,19/1/2022 7:23
24/6/2021,Mukdahan,0,45,351117,175421,175696,6539,6539,0,,,19/1/2022 7:23
24/6/2021,Yala,119,1262,540726,269152,271574,923,923,0,57,22,19/1/2022 7:23
24/6/2021,Yasothon,0,148,533972,266534,267438,1630,1630,0,,,19/1/2022 7:23
24/6/2021,Ranong,42,1262,194715,98283,96432,2092,2092,0,,,19/1/2022 7:23
24/6/2021,Rayong,92,1929,747267,367184,380083,23374,23094,280,38,37,19/1/2022 7:23
24/6/2021,Ratchaburi,19,1220,869140,422590,446550,13639,13639,0,,,19/1/2022 7:23
24/6/2021,Roi Et,6,319,1297189,642792,654397,3901,3901,0,,,19/1/2022 7:23
24/6/2021,Lop Buri,8,436,739289,367896,371393,8701,8660,41,,,19/1/2022 7:23
24/6/2021,Lampang,0,270,726902,354357,372545,6899,6564,335,36,20,19/1/2022 7:23
24/6/2021,Lamphun,0,307,401818,193230,208588,7266,7171,95,,,19/1/2022 7:23
24/6/2021,Si Sa Ket,3,454,1457790,725911,731879,4874,4874,0,,,19/1/2022 7:23
24/6/2021,Sakon Nakhon,9,172,1146926,570016,576910,5542,5542,0,,,19/1/2022 7:23
24/6/2021,Songkhla,409,4523,1429245,696525,732720,2071,2048,23,66,28,19/1/2022 7:23
24/6/2021,Satun,8,105,324391,161409,162982,3087,3058,29,49,14,19/1/2022 7:23
24/6/2021,Samut Prakarn,297,15674,1355249,645868,709381,2956,2895,61,,,19/1/2022 7:23
24/6/2021,Samut Songkhram,22,585,191737,91607,100130,17315,17259,56,29,22,19/1/2022 7:23
24/6/2021,Samut Sakhon,259,23371,587191,283020,304171,1347,1347,0,57,34,19/1/2022 7:23
24/6/2021,Saraburi,23,1313,643677,316181,327496,14753,14707,46,56,51,19/1/2022 7:23
24/6/2021,Sa kaeo,21,1335,561052,279978,281074,2761,2761,0,44,25,19/1/2022 7:23
24/6/2021,Sing Buri,2,152,205344,97567,107777,3421,3421,0,,,19/1/2022 7:23
24/6/2021,Suphan Buri,17,632,837218,404081,433137,20061,20061,0,,,19/1/2022 7:23
24/6/2021,Surat Thani,3,1904,1069905,526507,543398,4456,4439,17,70,33,19/1/2022 7:23
24/6/2021,Surin,3,224,1377402,685400,692002,10395,10377,18,,,19/1/2022 7:23
24/6/2021,Sukhothai,1,128,586606,284242,302364,7337,7029,308,,,19/1/2022 7:23
24/6/2021,Nong Khai,1,98,517219,256618,260601,12678,12669,9,25,9,19/1/2022 7:23
24/6/2021,Nong Bua Lam Phu,6,94,509323,254117,255206,3248,3248,0,,,19/1/2022 7:23
24/6/2021,Amnat Charoen,0,57,376371,187343,189028,2235,2235,0,,,19/1/2022 7:23
24/6/2021,Udon Thani,2,557,1567321,776506,790815,16592,16582,10,,,19/1/2022 7:23
24/6/2021,Uttaradit,12,127,447366,218091,229275,7129,7129,0,,,19/1/2022 7:23
24/6/2021,Uthai Thani,1,52,325515,159149,166366,2979,2979,0,,,19/1/2022 7:23
24/6/2021,Ubon Ratchathani,6,414,1867065,932291,934774,19665,19665,0,49,27,19/1/2022 7:23
24/6/2021,Ang Thong,6,356,275836,132062,143774,2258,2258,0,,,19/1/2022 7:23
24/6/2021,Chiang Rai,47,951,1297104,630696,666408,26342,26054,288,41,14,19/1/2022 7:23
24/6/2021,Chiang Mai,2,8448,1786156,863211,922945,80431,79438,993,53,27,19/1/2022 7:23
24/6/2021,Phetchaburi,64,8381,482299,232776,249523,41434,41240,194,,,19/1/2022 7:23
24/6/2021,Phetchabun,9,228,979800,483288,496512,23760,23760,0,,,19/1/2022 7:23
24/6/2021,Loei,2,129,638445,319953,318492,5204,5185,19,41,29,19/1/2022 7:23
24/6/2021,Phrae,0,97,435883,210160,225723,6005,6005,0,46,23,19/1/2022 7:23
24/6/2021,Mae Hong Son,0,54,285642,144738,140904,8603,8391,212,22,4,19/1/2022 7:23
24/6/2021,,0,153,,,,,,,,,19/1/2022 7:23
25/6/2021,Krabi,3,418,478523,237695,240828,2661,2547,114,,,19/1/2022 7:23
25/6/2021,Bangkok,1200,90438,5557605,2607913,2949692,256622,230749,25873,67,28,19/1/2022 7:23
25/6/2021,Kanchanaburi,54,519,892655,447517,445138,61297,61077,220,49,12,19/1/2022 7:23
25/6/2021,Kalasin,2,167,976880,483049,493831,2792,2792,0,,,19/1/2022 7:23
25/6/2021,Kamphaeng Phet,3,312,713388,352344,361044,7265,7265,0,,,19/1/2022 7:23
25/6/2021,Khon Kaen,9,593,1792631,881416,911215,39567,39567,0,66,43,19/1/2022 7:23
25/6/2021,Chanthaburi,23,1457,535759,262053,273706,20687,20602,85,,,19/1/2022 7:23
25/6/2021,Chachoengsao,88,4556,722120,354040,368080,4415,4415,0,56,33,19/1/2022 7:23
25/6/2021,Chon Buri,183,8844,1576670,769103,807567,41441,40719,722,55,40,19/1/2022 7:23
25/6/2021,Chai Nat,2,114,321397,154547,166850,5221,5221,0,,,19/1/2022 7:23
25/6/2021,Chaiyaphum,7,373,1123720,555261,568459,6515,6506,9,,,19/1/2022 7:23
25/6/2021,Chumphon,3,169,509518,251488,258030,2539,2539,0,,,19/1/2022 7:23
25/6/2021,Trang,7,1620,640151,313123,327028,3134,3134,0,,,19/1/2022 7:23
25/6/2021,Trat,3,286,228460,112953,115507,19181,19065,116,,,19/1/2022 7:23
25/6/2021,Tak,4,749,674065,340821,333244,16539,16539,0,,,19/1/2022 7:23
25/6/2021,Nakhon Nayok,10,486,259655,128067,131588,4620,4620,0,,,19/1/2022 7:23
25/6/2021,Nakhon Pathom,119,3706,922334,443151,479183,8757,8744,13,55,25,19/1/2022 7:23
25/6/2021,Nakhon Phanom,2,158,717157,357396,359761,5327,5318,9,,,19/1/2022 7:23
25/6/2021,Nakhon Ratchasima,10,1122,2633864,1294474,1339390,120449,119801,648,62,28,19/1/2022 7:23
25/6/2021,Nakhon Si Thammarat,12,1443,1549931,764739,785192,9919,9919,0,,,19/1/2022 7:23
25/6/2021,Nakhon Sawan,9,665,1037728,506276,531452,18315,18315,0,58,26,19/1/2022 7:23
25/6/2021,Nonthaburi,158,18765,1283748,597411,686337,2979,2961,18,39,18,19/1/2022 7:23
25/6/2021,Narathiwat,60,1865,807983,399778,408205,613,613,0,48,18,19/1/2022 7:23
25/6/2021,Nan,0,147,476110,238240,237870,12538,12477,61,,,19/1/2022 7:23
25/6/2021,Bueng Kan,0,45,422320,211778,210542,3482,3477,5,,,19/1/2022 7:23
25/6/2021,Buri Ram,2,272,1580295,784354,795941,23788,23726,62,,,19/1/2022 7:23
25/6/2021,Pathum Thani,192,7903,1184377,561210,623167,1664,1645,19,61,23,19/1/2022 7:23
25/6/2021,Prachuap Khiri Khan,50,2421,551074,272744,278330,36899,36826,73,,,19/1/2022 7:23
25/6/2021,Prachin Buri,2,659,494401,244052,250349,3921,3921,0,74,28,19/1/2022 7:23
25/6/2021,Pattani,79,1555,728135,359504,368631,837,837,0,,,19/1/2022 7:23
25/6/2021,Phra Nakhon Si Ayutthaya,28,2325,820129,394020,426109,61845,61474,371,50,44,19/1/2022 7:23
25/6/2021,Phayao,8,176,465644,226629,239015,8699,8699,0,35,16,19/1/2022 7:23
25/6/2021,Phang-nga,2,224,268563,134041,134522,5909,5544,365,,,19/1/2022 7:23
25/6/2021,Phatthalung,16,555,523027,254844,268183,2836,2836,0,,,19/1/2022 7:23
25/6/2021,Phichit,0,168,531180,259128,272052,6377,6377,0,,,19/1/2022 7:23
25/6/2021,Phitsanulok,5,383,847068,414386,432682,28588,28523,65,,,19/1/2022 7:23
25/6/2021,Phuket,2,941,415684,196375,219309,28777,28224,553,51,28,19/1/2022 7:23
25/6/2021,Maha Sarakham,10,449,950820,466360,484460,3552,3552,0,,,19/1/2022 7:23
25/6/2021,Mukdahan,0,45,351117,175421,175696,6539,6539,0,,,19/1/2022 7:23
25/6/2021,Yala,215,1477,540726,269152,271574,923,923,0,50,17,19/1/2022 7:23
25/6/2021,Yasothon,0,148,533972,266534,267438,1630,1630,0,,,19/1/2022 7:23
25/6/2021,Ranong,24,1286,194715,98283,96432,2092,2092,0,,,19/1/2022 7:23
25/6/2021,Rayong,30,1959,747267,367184,380083,23374,23094,280,57,33,19/1/2022 7:23
25/6/2021,Ratchaburi,36,1256,869140,422590,446550,13639,13639,0,,,19/1/2022 7:23
25/6/2021,Roi Et,7,326,1297189,642792,654397,3901,3901,0,,,19/1/2022 7:23
25/6/2021,Lop Buri,0,436,739289,367896,371393,8701,8660,41,,,19/1/2022 7:23
25/6/2021,Lampang,0,270,726902,354357,372545,6899,6564,335,41,91,19/1/2022 7:23
25/6/2021,Lamphun,0,307,401818,193230,208588,7266,7171,95,,,19/1/2022 7:23
25/6/2021,Si Sa Ket,5,459,1457790,725911,731879,4874,4874,0,,,19/1/2022 7:23
25/6/2021,Sakon Nakhon,7,179,1146926,570016,576910,5542,5542,0,,,19/1/2022 7:23
25/6/2021,Songkhla,217,4740,1429245,696525,732720,2071,2048,23,51,31,19/1/2022 7:23
25/6/2021,Satun,10,115,324391,161409,162982,3087,3058,29,23,24,19/1/2022 7:23
25/6/2021,Samut Prakarn,187,15861,1355249,645868,709381,2956,2895,61,,,19/1/2022 7:23
25/6/2021,Samut Songkhram,10,595,191737,91607,100130,17315,17259,56,41,19,19/1/2022 7:23
25/6/2021,Samut Sakhon,295,23666,587191,283020,304171,1347,1347,0,65,32,19/1/2022 7:23
25/6/2021,Saraburi,33,1346,643677,316181,327496,14753,14707,46,64,53,19/1/2022 7:23
25/6/2021,Sa kaeo,23,1358,561052,279978,281074,2761,2761,0,49,24,19/1/2022 7:23
25/6/2021,Sing Buri,1,153,205344,97567,107777,3421,3421,0,,,19/1/2022 7:23
25/6/2021,Suphan Buri,16,648,837218,404081,433137,20061,20061,0,,,19/1/2022 7:23
25/6/2021,Surat Thani,3,1907,1069905,526507,543398,4456,4439,17,69,38,19/1/2022 7:23
25/6/2021,Surin,2,226,1377402,685400,692002,10395,10377,18,,,19/1/2022 7:23
25/6/2021,Sukhothai,19,147,586606,284242,302364,7337,7029,308,,,19/1/2022 7:23
25/6/2021,Nong Khai,1,99,517219,256618,260601,12678,12669,9,22,9,19/1/2022 7:23
25/6/2021,Nong Bua Lam Phu,1,95,509323,254117,255206,3248,3248,0,,,19/1/2022 7:23
25/6/2021,Amnat Charoen,5,62,376371,187343,189028,2235,2235,0,,,19/1/2022 7:23
25/6/2021,Udon Thani,9,566,1567321,776506,790815,16592,16582,10,,,19/1/2022 7:23
25/6/2021,Uttaradit,0,127,447366,218091,229275,7129,7129,0,,,19/1/2022 7:23
25/6/2021,Uthai Thani,0,52,325515,159149,166366,2979,2979,0,,,19/1/2022 7:23
25/6/2021,Ubon Ratchathani,4,418,1867065,932291,934774,19665,19665,0,52,32,19/1/2022 7:23
25/6/2021,Ang Thong,8,364,275836,132062,143774,2258,2258,0,,,19/1/2022 7:23
25/6/2021,Chiang Rai,28,979,1297104,630696,666408,26342,26054,288,37,10,19/1/2022 7:23
25/6/2021,Chiang Mai,1,8449,1786156,863211,922945,80431,79438,993,60,22,19/1/2022 7:23
25/6/2021,Phetchaburi,71,8452,482299,232776,249523,41434,41240,194,,,19/1/2022 7:23
25/6/2021,Phetchabun,5,233,979800,483288,496512,23760,23760,0,,,19/1/2022 7:23
25/6/2021,Loei,1,130,638445,319953,318492,5204,5185,19,50,26,19/1/2022 7:23
25/6/2021,Phrae,3,100,435883,210160,225723,6005,6005,0,51,28,19/1/2022 7:23
25/6/2021,Mae Hong Son,0,54,285642,144738,140904,8603,8391,212,17,7,19/1/2022 7:23
25/6/2021,,0,153,,,,,,,,,19/1/2022 7:23
26/6/2021,Krabi,5,423,478523,237695,240828,2661,2547,114,,,19/1/2022 7:23
26/6/2021,Bangkok,1319,91757,5557605,2607913,2949692,256622,230749,25873,54,19,19/1/2022 7:23
26/6/2021,Kanchanaburi,12,531,892655,447517,445138,61297,61077,220,31,10,19/1/2022 7:23
26/6/2021,Kalasin,3,170,976880,483049,493831,2792,2792,0,,,19/1/2022 7:23
26/6/2021,Kamphaeng Phet,13,325,713388,352344,361044,7265,7265,0,,,19/1/2022 7:23
26/6/2021,Khon Kaen,2,595,1792631,881416,911215,39567,39567,0,70,38,19/1/2022 7:23
26/6/2021,Chanthaburi,5,1462,535759,262053,273706,20687,20602,85,,,19/1/2022 7:23
26/6/2021,Chachoengsao,62,4618,722120,354040,368080,4415,4415,0,57,33,19/1/2022 7:23
26/6/2021,Chon Buri,323,9167,1576670,769103,807567,41441,40719,722,52,33,19/1/2022 7:23
26/6/2021,Chai Nat,3,117,321397,154547,166850,5221,5221,0,,,19/1/2022 7:23
26/6/2021,Chaiyaphum,25,398,1123720,555261,568459,6515,6506,9,,,19/1/2022 7:23
26/6/2021,Chumphon,6,175,509518,251488,258030,2539,2539,0,,,19/1/2022 7:23
26/6/2021,Trang,16,1636,640151,313123,327028,3134,3134,0,,,19/1/2022 7:23
26/6/2021,Trat,0,286,228460,112953,115507,19181,19065,116,,,19/1/2022 7:23
26/6/2021,Tak,1,750,674065,340821,333244,16539,16539,0,,,19/1/2022 7:23
26/6/2021,Nakhon Nayok,17,503,259655,128067,131588,4620,4620,0,,,19/1/2022 7:23
26/6/2021,Nakhon Pathom,136,3842,922334,443151,479183,8757,8744,13,55,21,19/1/2022 7:23
26/6/2021,Nakhon Phanom,6,164,717157,357396,359761,5327,5318,9,,,19/1/2022 7:23
26/6/2021,Nakhon Ratchasima,13,1135,2633864,1294474,1339390,120449,119801,648,57,25,19/1/2022 7:23
26/6/2021,Nakhon Si Thammarat,7,1450,1549931,764739,785192,9919,9919,0,,,19/1/2022 7:23
26/6/2021,Nakhon Sawan,9,674,1037728,506276,531452,18315,18315,0,51,25,19/1/2022 7:23
26/6/2021,Nonthaburi,196,18961,1283748,597411,686337,2979,2961,18,34,16,19/1/2022 7:23
26/6/2021,Narathiwat,61,1926,807983,399778,408205,613,613,0,37,15,19/1/2022 7:23
26/6/2021,Nan,1,148,476110,238240,237870,12538,12477,61,,,19/1/2022 7:23
26/6/2021,Bueng Kan,1,46,422320,211778,210542,3482,3477,5,,,19/1/2022 7:23
26/6/2021,Buri Ram,2,274,1580295,784354,795941,23788,23726,62,,,19/1/2022 7:23
26/6/2021,Pathum Thani,229,8132,1184377,561210,623167,1664,1645,19,56,21,19/1/2022 7:23
26/6/2021,Prachuap Khiri Khan,74,2495,551074,272744,278330,36899,36826,73,,,19/1/2022 7:23
26/6/2021,Prachin Buri,3,662,494401,244052,250349,3921,3921,0,60,28,19/1/2022 7:23
26/6/2021,Pattani,153,1708,728135,359504,368631,837,837,0,,,19/1/2022 7:23
26/6/2021,Phra Nakhon Si Ayutthaya,43,2368,820129,394020,426109,61845,61474,371,53,44,19/1/2022 7:23
26/6/2021,Phayao,1,177,465644,226629,239015,8699,8699,0,38,18,19/1/2022 7:23
26/6/2021,Phang-nga,38,262,268563,134041,134522,5909,5544,365,,,19/1/2022 7:23
26/6/2021,Phatthalung,9,564,523027,254844,268183,2836,2836,0,,,19/1/2022 7:23
26/6/2021,Phichit,0,168,531180,259128,272052,6377,6377,0,,,19/1/2022 7:23
26/6/2021,Phitsanulok,5,388,847068,414386,432682,28588,28523,65,,,19/1/2022 7:23
26/6/2021,Phuket,4,945,415684,196375,219309,28777,28224,553,55,25,19/1/2022 7:23
26/6/2021,Maha Sarakham,2,451,950820,466360,484460,3552,3552,0,,,19/1/2022 7:23
26/6/2021,Mukdahan,0,45,351117,175421,175696,6539,6539,0,,,19/1/2022 7:23
26/6/2021,Yala,135,1612,540726,269152,271574,923,923,0,39,21,19/1/2022 7:23
26/6/2021,Yasothon,0,148,533972,266534,267438,1630,1630,0,,,19/1/2022 7:23
26/6/2021,Ranong,9,1295,194715,98283,96432,2092,2092,0,,,19/1/2022 7:23
26/6/2021,Rayong,30,1989,747267,367184,380083,23374,23094,280,58,33,19/1/2022 7:23
26/6/2021,Ratchaburi,36,1292,869140,422590,446550,13639,13639,0,,,19/1/2022 7:23
26/6/2021,Roi Et,4,330,1297189,642792,654397,3901,3901,0,,,19/1/2022 7:23
26/6/2021,Lop Buri,13,449,739289,367896,371393,8701,8660,41,,,19/1/2022 7:23
26/6/2021,Lampang,0,270,726902,354357,372545,6899,6564,335,46,21,19/1/2022 7:23
26/6/2021,Lamphun,0,307,401818,193230,208588,7266,7171,95,,,19/1/2022 7:23
26/6/2021,Si Sa Ket,6,465,1457790,725911,731879,4874,4874,0,,,19/1/2022 7:23
26/6/2021,Sakon Nakhon,2,181,1146926,570016,576910,5542,5542,0,,,19/1/2022 7:23
26/6/2021,Songkhla,242,4982,1429245,696525,732720,2071,2048,23,58,34,19/1/2022 7:23
26/6/2021,Satun,10,125,324391,161409,162982,3087,3058,29,41,21,19/1/2022 7:23
26/6/2021,Samut Prakarn,322,16183,1355249,645868,709381,2956,2895,61,,,19/1/2022 7:23
26/6/2021,Samut Songkhram,18,613,191737,91607,100130,17315,17259,56,37,16,19/1/2022 7:23
26/6/2021,Samut Sakhon,291,23957,587191,283020,304171,1347,1347,0,58,27,19/1/2022 7:23
26/6/2021,Saraburi,25,1371,643677,316181,327496,14753,14707,46,62,46,19/1/2022 7:23
26/6/2021,Sa kaeo,21,1379,561052,279978,281074,2761,2761,0,44,23,19/1/2022 7:23
26/6/2021,Sing Buri,1,154,205344,97567,107777,3421,3421,0,,,19/1/2022 7:23
26/6/2021,Suphan Buri,17,665,837218,404081,433137,20061,20061,0,,,19/1/2022 7:23
26/6/2021,Surat Thani,4,1911,1069905,526507,543398,4456,4439,17,66,31,19/1/2022 7:23
26/6/2021,Surin,8,234,1377402,685400,692002,10395,10377,18,,,19/1/2022 7:23
26/6/2021,Sukhothai,2,149,586606,284242,302364,7337,7029,308,,,19/1/2022 7:23
26/6/2021,Nong Khai,3,102,517219,256618,260601,12678,12669,9,23,9,19/1/2022 7:23
26/6/2021,Nong Bua Lam Phu,2,97,509323,254117,255206,3248,3248,0,,,19/1/2022 7:23
26/6/2021,Amnat Charoen,1,63,376371,187343,189028,2235,2235,0,,,19/1/2022 7:23
26/6/2021,Udon Thani,27,593,1567321,776506,790815,16592,16582,10,,,19/1/2022 7:23
26/6/2021,Uttaradit,12,139,447366,218091,229275,7129,7129,0,,,19/1/2022 7:23
26/6/2021,Uthai Thani,1,53,325515,159149,166366,2979,2979,0,,,19/1/2022 7:23
26/6/2021,Ubon Ratchathani,8,426,1867065,932291,934774,19665,19665,0,60,32,19/1/2022 7:23
26/6/2021,Ang Thong,8,372,275836,132062,143774,2258,2258,0,,,19/1/2022 7:23
26/6/2021,Chiang Rai,20,999,1297104,630696,666408,26342,26054,288,25,12,19/1/2022 7:23
26/6/2021,Chiang Mai,7,8456,1786156,863211,922945,80431,79438,993,54,27,19/1/2022 7:23
26/6/2021,Phetchaburi,59,8511,482299,232776,249523,41434,41240,194,,,19/1/2022 7:23
26/6/2021,Phetchabun,8,241,979800,483288,496512,23760,23760,0,,,19/1/2022 7:23
26/6/2021,Loei,1,131,638445,319953,318492,5204,5185,19,50,18,19/1/2022 7:23
26/6/2021,Phrae,2,102,435883,210160,225723,6005,6005,0,63,16,19/1/2022 7:23
26/6/2021,Mae Hong Son,0,54,285642,144738,140904,8603,8391,212,32,9,19/1/2022 7:23
26/6/2021,,0,153,,,,,,,,,19/1/2022 7:23
27/6/2021,Krabi,5,428,478523,237695,240828,2661,2547,114,,,19/1/2022 7:23
27/6/2021,Bangkok,1390,93147,5557605,2607913,2949692,256622,230749,25873,36,25,19/1/2022 7:23
27/6/2021,Kanchanaburi,15,546,892655,447517,445138,61297,61077,220,29,11,19/1/2022 7:23
27/6/2021,Kalasin,7,177,976880,483049,493831,2792,2792,0,,,19/1/2022 7:23
27/6/2021,Kamphaeng Phet,3,328,713388,352344,361044,7265,7265,0,,,19/1/2022 7:23
27/6/2021,Khon Kaen,10,605,1792631,881416,911215,39567,39567,0,65,25,19/1/2022 7:23
27/6/2021,Chanthaburi,26,1488,535759,262053,273706,20687,20602,85,,,19/1/2022 7:23
27/6/2021,Chachoengsao,93,4711,722120,354040,368080,4415,4415,0,49,30,19/1/2022 7:23
27/6/2021,Chon Buri,155,9322,1576670,769103,807567,41441,40719,722,47,32,19/1/2022 7:23
27/6/2021,Chai Nat,2,119,321397,154547,166850,5221,5221,0,,,19/1/2022 7:23
27/6/2021,Chaiyaphum,8,406,1123720,555261,568459,6515,6506,9,,,19/1/2022 7:23
27/6/2021,Chumphon,1,176,509518,251488,258030,2539,2539,0,,,19/1/2022 7:23
27/6/2021,Trang,10,1646,640151,313123,327028,3134,3134,0,,,19/1/2022 7:23
27/6/2021,Trat,4,290,228460,112953,115507,19181,19065,116,,,19/1/2022 7:23
27/6/2021,Tak,79,829,674065,340821,333244,16539,16539,0,,,19/1/2022 7:23
27/6/2021,Nakhon Nayok,18,521,259655,128067,131588,4620,4620,0,,,19/1/2022 7:23
27/6/2021,Nakhon Pathom,76,3918,922334,443151,479183,8757,8744,13,48,23,19/1/2022 7:23
27/6/2021,Nakhon Phanom,2,166,717157,357396,359761,5327,5318,9,,,19/1/2022 7:23
27/6/2021,Nakhon Ratchasima,19,1154,2633864,1294474,1339390,120449,119801,648,52,26,19/1/2022 7:23
27/6/2021,Nakhon Si Thammarat,21,1471,1549931,764739,785192,9919,9919,0,,,19/1/2022 7:23
27/6/2021,Nakhon Sawan,21,695,1037728,506276,531452,18315,18315,0,48,23,19/1/2022 7:23
27/6/2021,Nonthaburi,196,19157,1283748,597411,686337,2979,2961,18,27,17,19/1/2022 7:23
27/6/2021,Narathiwat,54,1980,807983,399778,408205,613,613,0,37,15,19/1/2022 7:23
27/6/2021,Nan,1,149,476110,238240,237870,12538,12477,61,,,19/1/2022 7:23
27/6/2021,Bueng Kan,0,46,422320,211778,210542,3482,3477,5,,,19/1/2022 7:23
27/6/2021,Buri Ram,4,278,1580295,784354,795941,23788,23726,62,,,19/1/2022 7:23
27/6/2021,Pathum Thani,127,8259,1184377,561210,623167,1664,1645,19,55,22,19/1/2022 7:23
27/6/2021,Prachuap Khiri Khan,53,2548,551074,272744,278330,36899,36826,73,,,19/1/2022 7:23
27/6/2021,Prachin Buri,60,722,494401,244052,250349,3921,3921,0,60,32,19/1/2022 7:23
27/6/2021,Pattani,189,1897,728135,359504,368631,837,837,0,,,19/1/2022 7:23
27/6/2021,Phra Nakhon Si Ayutthaya,55,2423,820129,394020,426109,61845,61474,371,47,33,19/1/2022 7:23
27/6/2021,Phayao,7,184,465644,226629,239015,8699,8699,0,36,17,19/1/2022 7:23
27/6/2021,Phang-nga,63,325,268563,134041,134522,5909,5544,365,,,19/1/2022 7:23
27/6/2021,Phatthalung,15,579,523027,254844,268183,2836,2836,0,,,19/1/2022 7:23
27/6/2021,Phichit,1,169,531180,259128,272052,6377,6377,0,,,19/1/2022 7:23
27/6/2021,Phitsanulok,4,392,847068,414386,432682,28588,28523,65,,,19/1/2022 7:23
27/6/2021,Phuket,1,946,415684,196375,219309,28777,28224,553,53,30,19/1/2022 7:23
27/6/2021,Maha Sarakham,2,453,950820,466360,484460,3552,3552,0,,,19/1/2022 7:23
27/6/2021,Mukdahan,0,45,351117,175421,175696,6539,6539,0,,,19/1/2022 7:23
27/6/2021,Yala,94,1706,540726,269152,271574,923,923,0,47,16,19/1/2022 7:23
27/6/2021,Yasothon,5,153,533972,266534,267438,1630,1630,0,,,19/1/2022 7:23
27/6/2021,Ranong,17,1312,194715,98283,96432,2092,2092,0,,,19/1/2022 7:23
27/6/2021,Rayong,14,2003,747267,367184,380083,23374,23094,280,71,35,19/1/2022 7:23
27/6/2021,Ratchaburi,32,1324,869140,422590,446550,13639,13639,0,,,19/1/2022 7:23
27/6/2021,Roi Et,11,341,1297189,642792,654397,3901,3901,0,,,19/1/2022 7:23
27/6/2021,Lop Buri,6,455,739289,367896,371393,8701,8660,41,,,19/1/2022 7:23
27/6/2021,Lampang,0,270,726902,354357,372545,6899,6564,335,36,20,19/1/2022 7:23
27/6/2021,Lamphun,0,307,401818,193230,208588,7266,7171,95,,,19/1/2022 7:23
27/6/2021,Si Sa Ket,3,468,1457790,725911,731879,4874,4874,0,,,19/1/2022 7:23
27/6/2021,Sakon Nakhon,6,187,1146926,570016,576910,5542,5542,0,,,19/1/2022 7:23
27/6/2021,Songkhla,157,5139,1429245,696525,732720,2071,2048,23,65,30,19/1/2022 7:23
27/6/2021,Satun,2,127,324391,161409,162982,3087,3058,29,44,23,19/1/2022 7:23
27/6/2021,Samut Prakarn,231,16414,1355249,645868,709381,2956,2895,61,,,19/1/2022 7:23
27/6/2021,Samut Songkhram,25,638,191737,91607,100130,17315,17259,56,30,17,19/1/2022 7:23
27/6/2021,Samut Sakhon,289,24246,587191,283020,304171,1347,1347,0,51,24,19/1/2022 7:23
27/6/2021,Saraburi,45,1416,643677,316181,327496,14753,14707,46,57,57,19/1/2022 7:23
27/6/2021,Sa kaeo,27,1406,561052,279978,281074,2761,2761,0,44,18,19/1/2022 7:23
27/6/2021,Sing Buri,7,161,205344,97567,107777,3421,3421,0,,,19/1/2022 7:23
27/6/2021,Suphan Buri,25,690,837218,404081,433137,20061,20061,0,,,19/1/2022 7:23
27/6/2021,Surat Thani,24,1935,1069905,526507,543398,4456,4439,17,69,22,19/1/2022 7:23
27/6/2021,Surin,14,248,1377402,685400,692002,10395,10377,18,,,19/1/2022 7:23
27/6/2021,Sukhothai,1,150,586606,284242,302364,7337,7029,308,,,19/1/2022 7:23
27/6/2021,Nong Khai,5,107,517219,256618,260601,12678,12669,9,22,8,19/1/2022 7:23
27/6/2021,Nong Bua Lam Phu,2,99,509323,254117,255206,3248,3248,0,,,19/1/2022 7:23
27/6/2021,Amnat Charoen,1,64,376371,187343,189028,2235,2235,0,,,19/1/2022 7:23
27/6/2021,Udon Thani,10,603,1567321,776506,790815,16592,16582,10,,,19/1/2022 7:23
27/6/2021,Uttaradit,11,150,447366,218091,229275,7129,7129,0,,,19/1/2022 7:23
27/6/2021,Uthai Thani,2,55,325515,159149,166366,2979,2979,0,,,19/1/2022 7:23
27/6/2021,Ubon Ratchathani,12,438,1867065,932291,934774,19665,19665,0,58,22,19/1/2022 7:23
27/6/2021,Ang Thong,10,382,275836,132062,143774,2258,2258,0,,,19/1/2022 7:23
27/6/2021,Chiang Rai,18,1017,1297104,630696,666408,26342,26054,288,24,12,19/1/2022 7:23
27/6/2021,Chiang Mai,12,8468,1786156,863211,922945,80431,79438,993,56,22,19/1/2022 7:23
27/6/2021,Phetchaburi,69,8580,482299,232776,249523,41434,41240,194,,,19/1/2022 7:23
27/6/2021,Phetchabun,11,252,979800,483288,496512,23760,23760,0,,,19/1/2022 7:23
27/6/2021,Loei,1,132,638445,319953,318492,5204,5185,19,37,14,19/1/2022 7:23
27/6/2021,Phrae,0,102,435883,210160,225723,6005,6005,0,44,14,19/1/2022 7:23
27/6/2021,Mae Hong Son,0,54,285642,144738,140904,8603,8391,212,32,9,19/1/2022 7:23
27/6/2021,,0,153,,,,,,,,,19/1/2022 7:23
28/6/2021,Krabi,2,430,478523,237695,240828,2661,2547,114,,,19/1/2022 7:23
28/6/2021,Bangkok,1688,94835,5557605,2607913,2949692,256622,230749,25873,48,32,19/1/2022 7:23
28/6/2021,Kanchanaburi,4,550,892655,447517,445138,61297,61077,220,30,14,19/1/2022 7:23
28/6/2021,Kalasin,7,184,976880,483049,493831,2792,2792,0,,,19/1/2022 7:23
28/6/2021,Kamphaeng Phet,1,329,713388,352344,361044,7265,7265,0,,,19/1/2022 7:23
28/6/2021,Khon Kaen,13,618,1792631,881416,911215,39567,39567,0,50,27,19/1/2022 7:23
28/6/2021,Chanthaburi,7,1495,535759,262053,273706,20687,20602,85,,,19/1/2022 7:23
28/6/2021,Chachoengsao,43,4754,722120,354040,368080,4415,4415,0,51,30,19/1/2022 7:23
28/6/2021,Chon Buri,394,9716,1576670,769103,807567,41441,40719,722,39,33,19/1/2022 7:23
28/6/2021,Chai Nat,2,121,321397,154547,166850,5221,5221,0,,,19/1/2022 7:23
28/6/2021,Chaiyaphum,8,414,1123720,555261,568459,6515,6506,9,,,19/1/2022 7:23
28/6/2021,Chumphon,2,178,509518,251488,258030,2539,2539,0,,,19/1/2022 7:23
28/6/2021,Trang,9,1655,640151,313123,327028,3134,3134,0,,,19/1/2022 7:23
28/6/2021,Trat,6,296,228460,112953,115507,19181,19065,116,,,19/1/2022 7:23
28/6/2021,Tak,453,1282,674065,340821,333244,16539,16539,0,,,19/1/2022 7:23
28/6/2021,Nakhon Nayok,15,536,259655,128067,131588,4620,4620,0,,,19/1/2022 7:23
28/6/2021,Nakhon Pathom,199,4117,922334,443151,479183,8757,8744,13,46,23,19/1/2022 7:23
28/6/2021,Nakhon Phanom,10,176,717157,357396,359761,5327,5318,9,,,19/1/2022 7:23
28/6/2021,Nakhon Ratchasima,47,1201,2633864,1294474,1339390,120449,119801,648,44,29,19/1/2022 7:23
28/6/2021,Nakhon Si Thammarat,23,1494,1549931,764739,785192,9919,9919,0,,,19/1/2022 7:23
28/6/2021,Nakhon Sawan,16,711,1037728,506276,531452,18315,18315,0,41,29,19/1/2022 7:23
28/6/2021,Nonthaburi,224,19381,1283748,597411,686337,2979,2961,18,27,18,19/1/2022 7:23
28/6/2021,Narathiwat,86,2066,807983,399778,408205,613,613,0,34,18,19/1/2022 7:23
28/6/2021,Nan,4,153,476110,238240,237870,12538,12477,61,,,19/1/2022 7:23
28/6/2021,Bueng Kan,0,46,422320,211778,210542,3482,3477,5,,,19/1/2022 7:23
28/6/2021,Buri Ram,5,283,1580295,784354,795941,23788,23726,62,,,19/1/2022 7:23
28/6/2021,Pathum Thani,111,8370,1184377,561210,623167,1664,1645,19,62,23,19/1/2022 7:23
28/6/2021,Prachuap Khiri Khan,45,2593,551074,272744,278330,36899,36826,73,,,19/1/2022 7:23
28/6/2021,Prachin Buri,4,726,494401,244052,250349,3921,3921,0,58,27,19/1/2022 7:23
28/6/2021,Pattani,178,2075,728135,359504,368631,837,837,0,,,19/1/2022 7:23
28/6/2021,Phra Nakhon Si Ayutthaya,52,2475,820129,394020,426109,61845,61474,371,30,38,19/1/2022 7:23
28/6/2021,Phayao,4,188,465644,226629,239015,8699,8699,0,31,20,19/1/2022 7:23
28/6/2021,Phang-nga,0,325,268563,134041,134522,5909,5544,365,,,19/1/2022 7:23
28/6/2021,Phatthalung,3,582,523027,254844,268183,2836,2836,0,,,19/1/2022 7:23
28/6/2021,Phichit,1,170,531180,259128,272052,6377,6377,0,,,19/1/2022 7:23
28/6/2021,Phitsanulok,4,396,847068,414386,432682,28588,28523,65,,,19/1/2022 7:23
28/6/2021,Phuket,0,946,415684,196375,219309,28777,28224,553,59,23,19/1/2022 7:23
28/6/2021,Maha Sarakham,2,455,950820,466360,484460,3552,3552,0,,,19/1/2022 7:23
28/6/2021,Mukdahan,1,46,351117,175421,175696,6539,6539,0,,,19/1/2022 7:23
28/6/2021,Yala,98,1804,540726,269152,271574,923,923,0,41,16,19/1/2022 7:23
28/6/2021,Yasothon,3,156,533972,266534,267438,1630,1630,0,,,19/1/2022 7:23
28/6/2021,Ranong,44,1356,194715,98283,96432,2092,2092,0,,,19/1/2022 7:23
28/6/2021,Rayong,123,2126,747267,367184,380083,23374,23094,280,64,35,19/1/2022 7:23
28/6/2021,Ratchaburi,60,1384,869140,422590,446550,13639,13639,0,,,19/1/2022 7:23
28/6/2021,Roi Et,7,348,1297189,642792,654397,3901,3901,0,,,19/1/2022 7:23
28/6/2021,Lop Buri,6,461,739289,367896,371393,8701,8660,41,,,19/1/2022 7:23
28/6/2021,Lampang,2,272,726902,354357,372545,6899,6564,335,37,21,19/1/2022 7:23
28/6/2021,Lamphun,0,307,401818,193230,208588,7266,7171,95,,,19/1/2022 7:23
28/6/2021,Si Sa Ket,12,480,1457790,725911,731879,4874,4874,0,,,19/1/2022 7:23
28/6/2021,Sakon Nakhon,7,194,1146926,570016,576910,5542,5542,0,,,19/1/2022 7:23
28/6/2021,Songkhla,275,5414,1429245,696525,732720,2071,2048,23,58,27,19/1/2022 7:23
28/6/2021,Satun,9,136,324391,161409,162982,3087,3058,29,43,10,19/1/2022 7:23
28/6/2021,Samut Prakarn,397,16811,1355249,645868,709381,2956,2895,61,,,19/1/2022 7:23
28/6/2021,Samut Songkhram,21,659,191737,91607,100130,17315,17259,56,35,21,19/1/2022 7:23
28/6/2021,Samut Sakhon,296,24542,587191,283020,304171,1347,1347,0,53,34,19/1/2022 7:23
28/6/2021,Saraburi,157,1573,643677,316181,327496,14753,14707,46,50,49,19/1/2022 7:23
28/6/2021,Sa kaeo,20,1426,561052,279978,281074,2761,2761,0,42,17,19/1/2022 7:23
28/6/2021,Sing Buri,15,176,205344,97567,107777,3421,3421,0,,,19/1/2022 7:23
28/6/2021,Suphan Buri,5,695,837218,404081,433137,20061,20061,0,,,19/1/2022 7:23
28/6/2021,Surat Thani,14,1949,1069905,526507,543398,4456,4439,17,70,22,19/1/2022 7:23
28/6/2021,Surin,14,262,1377402,685400,692002,10395,10377,18,,,19/1/2022 7:23
28/6/2021,Sukhothai,1,151,586606,284242,302364,7337,7029,308,,,19/1/2022 7:23
28/6/2021,Nong Khai,2,109,517219,256618,260601,12678,12669,9,19,9,19/1/2022 7:23
28/6/2021,Nong Bua Lam Phu,2,101,509323,254117,255206,3248,3248,0,,,19/1/2022 7:23
28/6/2021,Amnat Charoen,0,64,376371,187343,189028,2235,2235,0,,,19/1/2022 7:23
28/6/2021,Udon Thani,20,623,1567321,776506,790815,16592,16582,10,,,19/1/2022 7:23
28/6/2021,Uttaradit,5,155,447366,218091,229275,7129,7129,0,,,19/1/2022 7:23
28/6/2021,Uthai Thani,0,55,325515,159149,166366,2979,2979,0,,,19/1/2022 7:23
28/6/2021,Ubon Ratchathani,6,444,1867065,932291,934774,19665,19665,0,50,20,19/1/2022 7:23
28/6/2021,Ang Thong,0,382,275836,132062,143774,2258,2258,0,,,19/1/2022 7:23
28/6/2021,Chiang Rai,8,1025,1297104,630696,666408,26342,26054,288,29,16,19/1/2022 7:23
28/6/2021,Chiang Mai,1,8469,1786156,863211,922945,80431,79438,993,49,25,19/1/2022 7:23
28/6/2021,Phetchaburi,87,8667,482299,232776,249523,41434,41240,194,,,19/1/2022 7:23
28/6/2021,Phetchabun,10,262,979800,483288,496512,23760,23760,0,,,19/1/2022 7:23
28/6/2021,Loei,6,138,638445,319953,318492,5204,5185,19,19,17,19/1/2022 7:23
28/6/2021,Phrae,0,102,435883,210160,225723,6005,6005,0,33,14,19/1/2022 7:23
28/6/2021,Mae Hong Son,0,54,285642,144738,140904,8603,8391,212,39,10,19/1/2022 7:23
28/6/2021,,0,153,,,,,,,,,19/1/2022 7:23
29/6/2021,Krabi,1,431,478523,237695,240828,2661,2547,114,,,19/1/2022 7:23
29/6/2021,Bangkok,1696,96531,5557605,2607913,2949692,256622,230749,25873,61,25,19/1/2022 7:23
29/6/2021,Kanchanaburi,21,571,892655,447517,445138,61297,61077,220,34,10,19/1/2022 7:23
29/6/2021,Kalasin,5,189,976880,483049,493831,2792,2792,0,,,19/1/2022 7:23
29/6/2021,Kamphaeng Phet,6,335,713388,352344,361044,7265,7265,0,,,19/1/2022 7:23
29/6/2021,Khon Kaen,17,635,1792631,881416,911215,39567,39567,0,110,33,19/1/2022 7:23
29/6/2021,Chanthaburi,9,1504,535759,262053,273706,20687,20602,85,,,19/1/2022 7:23
29/6/2021,Chachoengsao,41,4795,722120,354040,368080,4415,4415,0,57,30,19/1/2022 7:23
29/6/2021,Chon Buri,147,9863,1576670,769103,807567,41441,40719,722,57,31,19/1/2022 7:23
29/6/2021,Chai Nat,8,129,321397,154547,166850,5221,5221,0,,,19/1/2022 7:23
29/6/2021,Chaiyaphum,12,426,1123720,555261,568459,6515,6506,9,,,19/1/2022 7:23
29/6/2021,Chumphon,1,179,509518,251488,258030,2539,2539,0,,,19/1/2022 7:23
29/6/2021,Trang,6,1661,640151,313123,327028,3134,3134,0,,,19/1/2022 7:23
29/6/2021,Trat,0,296,228460,112953,115507,19181,19065,116,,,19/1/2022 7:23
29/6/2021,Tak,65,1347,674065,340821,333244,16539,16539,0,,,19/1/2022 7:23
29/6/2021,Nakhon Nayok,12,548,259655,128067,131588,4620,4620,0,,,19/1/2022 7:23
29/6/2021,Nakhon Pathom,170,4287,922334,443151,479183,8757,8744,13,49,15,19/1/2022 7:23
29/6/2021,Nakhon Phanom,1,177,717157,357396,359761,5327,5318,9,,,19/1/2022 7:23
29/6/2021,Nakhon Ratchasima,36,1237,2633864,1294474,1339390,120449,119801,648,53,22,19/1/2022 7:23
29/6/2021,Nakhon Si Thammarat,15,1509,1549931,764739,785192,9919,9919,0,,,19/1/2022 7:23
29/6/2021,Nakhon Sawan,8,719,1037728,506276,531452,18315,18315,0,54,28,19/1/2022 7:23
29/6/2021,Nonthaburi,186,19567,1283748,597411,686337,2979,2961,18,34,15,19/1/2022 7:23
29/6/2021,Narathiwat,83,2149,807983,399778,408205,613,613,0,45,16,19/1/2022 7:23
29/6/2021,Nan,5,158,476110,238240,237870,12538,12477,61,,,19/1/2022 7:23
29/6/2021,Bueng Kan,4,50,422320,211778,210542,3482,3477,5,,,19/1/2022 7:23
29/6/2021,Buri Ram,12,295,1580295,784354,795941,23788,23726,62,,,19/1/2022 7:23
29/6/2021,Pathum Thani,182,8552,1184377,561210,623167,1664,1645,19,64,24,19/1/2022 7:23
29/6/2021,Prachuap Khiri Khan,33,2626,551074,272744,278330,36899,36826,73,,,19/1/2022 7:23
29/6/2021,Prachin Buri,3,729,494401,244052,250349,3921,3921,0,60,24,19/1/2022 7:23
29/6/2021,Pattani,143,2218,728135,359504,368631,837,837,0,,,19/1/2022 7:23
29/6/2021,Phra Nakhon Si Ayutthaya,49,2524,820129,394020,426109,61845,61474,371,37,33,19/1/2022 7:23
29/6/2021,Phayao,2,190,465644,226629,239015,8699,8699,0,36,19,19/1/2022 7:23
29/6/2021,Phang-nga,12,337,268563,134041,134522,5909,5544,365,,,19/1/2022 7:23
29/6/2021,Phatthalung,7,589,523027,254844,268183,2836,2836,0,,,19/1/2022 7:23
29/6/2021,Phichit,3,173,531180,259128,272052,6377,6377,0,,,19/1/2022 7:23
29/6/2021,Phitsanulok,4,400,847068,414386,432682,28588,28523,65,,,19/1/2022 7:23
29/6/2021,Phuket,3,949,415684,196375,219309,28777,28224,553,52,29,19/1/2022 7:23
29/6/2021,Maha Sarakham,0,455,950820,466360,484460,3552,3552,0,,,19/1/2022 7:23
29/6/2021,Mukdahan,0,46,351117,175421,175696,6539,6539,0,,,19/1/2022 7:23
29/6/2021,Yala,89,1893,540726,269152,271574,923,923,0,37,18,19/1/2022 7:23
29/6/2021,Yasothon,0,156,533972,266534,267438,1630,1630,0,,,19/1/2022 7:23
29/6/2021,Ranong,23,1379,194715,98283,96432,2092,2092,0,,,19/1/2022 7:23
29/6/2021,Rayong,52,2178,747267,367184,380083,23374,23094,280,67,34,19/1/2022 7:23
29/6/2021,Ratchaburi,32,1416,869140,422590,446550,13639,13639,0,,,19/1/2022 7:23
29/6/2021,Roi Et,2,350,1297189,642792,654397,3901,3901,0,,,19/1/2022 7:23
29/6/2021,Lop Buri,12,473,739289,367896,371393,8701,8660,41,,,19/1/2022 7:23
29/6/2021,Lampang,1,273,726902,354357,372545,6899,6564,335,51,21,19/1/2022 7:23
29/6/2021,Lamphun,0,307,401818,193230,208588,7266,7171,95,,,19/1/2022 7:23
29/6/2021,Si Sa Ket,17,497,1457790,725911,731879,4874,4874,0,,,19/1/2022 7:23
29/6/2021,Sakon Nakhon,4,198,1146926,570016,576910,5542,5542,0,,,19/1/2022 7:23
29/6/2021,Songkhla,183,5597,1429245,696525,732720,2071,2048,23,50,32,19/1/2022 7:23
29/6/2021,Satun,1,137,324391,161409,162982,3087,3058,29,24,22,19/1/2022 7:23
29/6/2021,Samut Prakarn,647,17458,1355249,645868,709381,2956,2895,61,,,19/1/2022 7:23
29/6/2021,Samut Songkhram,21,680,191737,91607,100130,17315,17259,56,43,15,19/1/2022 7:23
29/6/2021,Samut Sakhon,294,24836,587191,283020,304171,1347,1347,0,73,35,19/1/2022 7:23
29/6/2021,Saraburi,44,1617,643677,316181,327496,14753,14707,46,57,35,19/1/2022 7:23
29/6/2021,Sa kaeo,28,1454,561052,279978,281074,2761,2761,0,37,17,19/1/2022 7:23
29/6/2021,Sing Buri,1,177,205344,97567,107777,3421,3421,0,,,19/1/2022 7:23
29/6/2021,Suphan Buri,15,710,837218,404081,433137,20061,20061,0,,,19/1/2022 7:23
29/6/2021,Surat Thani,20,1969,1069905,526507,543398,4456,4439,17,59,16,19/1/2022 7:23
29/6/2021,Surin,12,274,1377402,685400,692002,10395,10377,18,,,19/1/2022 7:23
29/6/2021,Sukhothai,1,152,586606,284242,302364,7337,7029,308,,,19/1/2022 7:23
29/6/2021,Nong Khai,1,110,517219,256618,260601,12678,12669,9,20,8,19/1/2022 7:23
29/6/2021,Nong Bua Lam Phu,3,104,509323,254117,255206,3248,3248,0,,,19/1/2022 7:23
29/6/2021,Amnat Charoen,1,65,376371,187343,189028,2235,2235,0,,,19/1/2022 7:23
29/6/2021,Udon Thani,16,639,1567321,776506,790815,16592,16582,10,,,19/1/2022 7:23
29/6/2021,Uttaradit,2,157,447366,218091,229275,7129,7129,0,,,19/1/2022 7:23
29/6/2021,Uthai Thani,1,56,325515,159149,166366,2979,2979,0,,,19/1/2022 7:23
29/6/2021,Ubon Ratchathani,9,453,1867065,932291,934774,19665,19665,0,42,17,19/1/2022 7:23
29/6/2021,Ang Thong,16,398,275836,132062,143774,2258,2258,0,,,19/1/2022 7:23
29/6/2021,Chiang Rai,11,1036,1297104,630696,666408,26342,26054,288,35,14,19/1/2022 7:23
29/6/2021,Chiang Mai,6,8475,1786156,863211,922945,80431,79438,993,57,27,19/1/2022 7:23
29/6/2021,Phetchaburi,82,8749,482299,232776,249523,41434,41240,194,,,19/1/2022 7:23
29/6/2021,Phetchabun,4,266,979800,483288,496512,23760,23760,0,,,19/1/2022 7:23
29/6/2021,Loei,2,140,638445,319953,318492,5204,5185,19,29,15,19/1/2022 7:23
29/6/2021,Phrae,1,103,435883,210160,225723,6005,6005,0,34,18,19/1/2022 7:23
29/6/2021,Mae Hong Son,0,54,285642,144738,140904,8603,8391,212,40,4,19/1/2022 7:23
29/6/2021,,0,153,,,,,,,,,19/1/2022 7:23
30/6/2021,Krabi,0,431,478523,237695,240828,2661,2547,114,,,19/1/2022 7:23
30/6/2021,Bangkok,1852,98383,5557605,2607913,2949692,256622,230749,25873,49,24,19/1/2022 7:23
30/6/2021,Kanchanaburi,19,590,892655,447517,445138,61297,61077,220,26,8,19/1/2022 7:23
30/6/2021,Kalasin,27,216,976880,483049,493831,2792,2792,0,,,19/1/2022 7:23
30/6/2021,Kamphaeng Phet,14,349,713388,352344,361044,7265,7265,0,,,19/1/2022 7:23
30/6/2021,Khon Kaen,33,668,1792631,881416,911215,39567,39567,0,60,32,19/1/2022 7:23
30/6/2021,Chanthaburi,12,1516,535759,262053,273706,20687,20602,85,,,19/1/2022 7:23
30/6/2021,Chachoengsao,70,4865,722120,354040,368080,4415,4415,0,50,31,19/1/2022 7:23
30/6/2021,Chon Buri,208,10071,1576670,769103,807567,41441,40719,722,47,30,19/1/2022 7:23
30/6/2021,Chai Nat,6,135,321397,154547,166850,5221,5221,0,,,19/1/2022 7:23
30/6/2021,Chaiyaphum,18,444,1123720,555261,568459,6515,6506,9,,,19/1/2022 7:23
30/6/2021,Chumphon,6,185,509518,251488,258030,2539,2539,0,,,19/1/2022 7:23
30/6/2021,Trang,6,1667,640151,313123,327028,3134,3134,0,,,19/1/2022 7:23
30/6/2021,Trat,6,302,228460,112953,115507,19181,19065,116,,,19/1/2022 7:23
30/6/2021,Tak,12,1359,674065,340821,333244,16539,16539,0,,,19/1/2022 7:23
30/6/2021,Nakhon Nayok,10,558,259655,128067,131588,4620,4620,0,,,19/1/2022 7:23
30/6/2021,Nakhon Pathom,191,4478,922334,443151,479183,8757,8744,13,33,15,19/1/2022 7:23
30/6/2021,Nakhon Phanom,7,184,717157,357396,359761,5327,5318,9,,,19/1/2022 7:23
30/6/2021,Nakhon Ratchasima,27,1264,2633864,1294474,1339390,120449,119801,648,42,25,19/1/2022 7:23
30/6/2021,Nakhon Si Thammarat,8,1517,1549931,764739,785192,9919,9919,0,,,19/1/2022 7:23
30/6/2021,Nakhon Sawan,25,744,1037728,506276,531452,18315,18315,0,52,20,19/1/2022 7:23
30/6/2021,Nonthaburi,155,19722,1283748,597411,686337,2979,2961,18,33,13,19/1/2022 7:23
30/6/2021,Narathiwat,69,2218,807983,399778,408205,613,613,0,30,17,19/1/2022 7:23
30/6/2021,Nan,2,160,476110,238240,237870,12538,12477,61,,,19/1/2022 7:23
30/6/2021,Bueng Kan,0,50,422320,211778,210542,3482,3477,5,,,19/1/2022 7:23
30/6/2021,Buri Ram,7,302,1580295,784354,795941,23788,23726,62,,,19/1/2022 7:23
30/6/2021,Pathum Thani,178,8730,1184377,561210,623167,1664,1645,19,57,20,19/1/2022 7:23
30/6/2021,Prachuap Khiri Khan,70,2696,551074,272744,278330,36899,36826,73,,,19/1/2022 7:23
30/6/2021,Prachin Buri,10,739,494401,244052,250349,3921,3921,0,55,25,19/1/2022 7:23
30/6/2021,Pattani,81,2299,728135,359504,368631,837,837,0,,,19/1/2022 7:23
30/6/2021,Phra Nakhon Si Ayutthaya,45,2569,820129,394020,426109,61845,61474,371,35,35,19/1/2022 7:23
30/6/2021,Phayao,1,191,465644,226629,239015,8699,8699,0,36,17,19/1/2022 7:23
30/6/2021,Phang-nga,1,338,268563,134041,134522,5909,5544,365,,,19/1/2022 7:23
30/6/2021,Phatthalung,2,591,523027,254844,268183,2836,2836,0,,,19/1/2022 7:23
30/6/2021,Phichit,10,183,531180,259128,272052,6377,6377,0,,,19/1/2022 7:23
30/6/2021,Phitsanulok,4,404,847068,414386,432682,28588,28523,65,,,19/1/2022 7:23
30/6/2021,Phuket,5,954,415684,196375,219309,28777,28224,553,58,28,19/1/2022 7:23
30/6/2021,Maha Sarakham,3,458,950820,466360,484460,3552,3552,0,,,19/1/2022 7:23
30/6/2021,Mukdahan,1,47,351117,175421,175696,6539,6539,0,,,19/1/2022 7:23
30/6/2021,Yala,106,1999,540726,269152,271574,923,923,0,44,23,19/1/2022 7:23
30/6/2021,Yasothon,6,162,533972,266534,267438,1630,1630,0,,,19/1/2022 7:23
30/6/2021,Ranong,31,1410,194715,98283,96432,2092,2092,0,,,19/1/2022 7:23
30/6/2021,Rayong,41,2219,747267,367184,380083,23374,23094,280,52,34,19/1/2022 7:23
30/6/2021,Ratchaburi,47,1463,869140,422590,446550,13639,13639,0,,,19/1/2022 7:23
30/6/2021,Roi Et,11,361,1297189,642792,654397,3901,3901,0,,,19/1/2022 7:23
30/6/2021,Lop Buri,6,479,739289,367896,371393,8701,8660,41,,,19/1/2022 7:23
30/6/2021,Lampang,1,274,726902,354357,372545,6899,6564,335,50,19,19/1/2022 7:23
30/6/2021,Lamphun,0,307,401818,193230,208588,7266,7171,95,,,19/1/2022 7:23
30/6/2021,Si Sa Ket,5,502,1457790,725911,731879,4874,4874,0,,,19/1/2022 7:23
30/6/2021,Sakon Nakhon,6,204,1146926,570016,576910,5542,5542,0,,,19/1/2022 7:23
30/6/2021,Songkhla,171,5768,1429245,696525,732720,2071,2048,23,60,31,19/1/2022 7:23
30/6/2021,Satun,10,147,324391,161409,162982,3087,3058,29,29,24,19/1/2022 7:23
30/6/2021,Samut Prakarn,433,17891,1355249,645868,709381,2956,2895,61,,,19/1/2022 7:23
30/6/2021,Samut Songkhram,19,699,191737,91607,100130,17315,17259,56,31,13,19/1/2022 7:23
30/6/2021,Samut Sakhon,340,25176,587191,283020,304171,1347,1347,0,66,29,19/1/2022 7:23
30/6/2021,Saraburi,53,1670,643677,316181,327496,14753,14707,46,37,41,19/1/2022 7:23
30/6/2021,Sa kaeo,9,1463,561052,279978,281074,2761,2761,0,34,16,19/1/2022 7:23
30/6/2021,Sing Buri,5,182,205344,97567,107777,3421,3421,0,,,19/1/2022 7:23
30/6/2021,Suphan Buri,31,741,837218,404081,433137,20061,20061,0,,,19/1/2022 7:23
30/6/2021,Surat Thani,25,1994,1069905,526507,543398,4456,4439,17,45,21,19/1/2022 7:23
30/6/2021,Surin,21,295,1377402,685400,692002,10395,10377,18,,,19/1/2022 7:23
30/6/2021,Sukhothai,6,158,586606,284242,302364,7337,7029,308,,,19/1/2022 7:23
30/6/2021,Nong Khai,1,111,517219,256618,260601,12678,12669,9,21,8,19/1/2022 7:23
30/6/2021,Nong Bua Lam Phu,8,112,509323,254117,255206,3248,3248,0,,,19/1/2022 7:23
30/6/2021,Amnat Charoen,3,68,376371,187343,189028,2235,2235,0,,,19/1/2022 7:23
30/6/2021,Udon Thani,16,655,1567321,776506,790815,16592,16582,10,,,19/1/2022 7:23
30/6/2021,Uttaradit,4,161,447366,218091,229275,7129,7129,0,,,19/1/2022 7:23
30/6/2021,Uthai Thani,2,58,325515,159149,166366,2979,2979,0,,,19/1/2022 7:23
30/6/2021,Ubon Ratchathani,22,475,1867065,932291,934774,19665,19665,0,34,17,19/1/2022 7:23
30/6/2021,Ang Thong,16,414,275836,132062,143774,2258,2258,0,,,19/1/2022 7:23
30/6/2021,Chiang Rai,28,1064,1297104,630696,666408,26342,26054,288,36,12,19/1/2022 7:23
30/6/2021,Chiang Mai,4,8479,1786156,863211,922945,80431,79438,993,56,27,19/1/2022 7:23
30/6/2021,Phetchaburi,75,8824,482299,232776,249523,41434,41240,194,,,19/1/2022 7:23
30/6/2021,Phetchabun,15,281,979800,483288,496512,23760,23760,0,,,19/1/2022 7:23
30/6/2021,Loei,8,148,638445,319953,318492,5204,5185,19,28,14,19/1/2022 7:23
30/6/2021,Phrae,0,103,435883,210160,225723,6005,6005,0,40,16,19/1/2022 7:23
30/6/2021,Mae Hong Son,0,54,285642,144738,140904,8603,8391,212,18,4,19/1/2022 7:23
30/6/2021,,0,153,,,,,,,,,19/1/2022 7:23
1/7/2021,Krabi,2,433,478495,237646,240849,1716,1716,0,,,19/1/2022 7:23
1/7/2021,Bangkok,1974,100357,5551744,2605273,2946471,169121,147154,21967,47,26,19/1/2022 7:23
1/7/2021,Kanchanaburi,19,609,893118,447911,445207,26909,26862,47,27,5,19/1/2022 7:23
1/7/2021,Kalasin,10,226,976323,482572,493751,2495,2495,0,,,19/1/2022 7:23
1/7/2021,Kamphaeng Phet,3,352,712903,351973,360930,6317,6317,0,,,19/1/2022 7:23
1/7/2021,Khon Kaen,20,688,1792421,881179,911242,17954,17954,0,59,30,19/1/2022 7:23
1/7/2021,Chanthaburi,12,1528,535998,262065,273933,17139,17083,56,,,19/1/2022 7:23
1/7/2021,Chachoengsao,92,4957,722052,353870,368182,2359,2359,0,51,24,19/1/2022 7:23
1/7/2021,Chon Buri,267,10338,1579473,770979,808494,34619,34021,598,38,27,19/1/2022 7:23
1/7/2021,Chai Nat,3,138,321220,154391,166829,3194,3194,0,,,19/1/2022 7:23
1/7/2021,Chaiyaphum,23,467,1123243,554962,568281,6802,6802,0,,,19/1/2022 7:23
1/7/2021,Chumphon,1,186,509453,251448,258005,1865,1865,0,,,19/1/2022 7:23
1/7/2021,Trang,13,1680,640011,312941,327070,2288,2288,0,,,19/1/2022 7:23
1/7/2021,Trat,2,304,228415,112919,115496,17144,17038,106,,,19/1/2022 7:23
1/7/2021,Tak,22,1381,674330,340958,333372,13933,13933,0,,,19/1/2022 7:23
1/7/2021,Nakhon Nayok,23,581,259525,127999,131526,3515,3515,0,,,19/1/2022 7:23
1/7/2021,Nakhon Pathom,231,4709,922047,442945,479102,4047,4047,0,32,16,19/1/2022 7:23
1/7/2021,Nakhon Phanom,4,188,717065,357305,359760,4473,4473,0,,,19/1/2022 7:23
1/7/2021,Nakhon Ratchasima,26,1290,2633481,1294026,1339455,83136,82593,543,58,27,19/1/2022 7:23
1/7/2021,Nakhon Si Thammarat,13,1530,1549708,764609,785099,8425,8425,0,,,19/1/2022 7:23
1/7/2021,Nakhon Sawan,40,784,1037270,506043,531227,14969,14969,0,34,21,19/1/2022 7:23
1/7/2021,Nonthaburi,224,19946,1284757,597804,686953,2156,2144,12,26,12,19/1/2022 7:23
1/7/2021,Narathiwat,53,2271,808277,399788,408489,474,474,0,33,21,19/1/2022 7:23
1/7/2021,Nan,2,162,475961,238094,237867,9841,9805,36,,,19/1/2022 7:23
1/7/2021,Bueng Kan,3,53,421989,211591,210398,2816,2816,0,,,19/1/2022 7:23
1/7/2021,Buri Ram,15,317,1579847,783934,795913,10752,10721,31,,,19/1/2022 7:23
1/7/2021,Pathum Thani,322,9052,1184541,561189,623352,1116,1103,13,53,16,19/1/2022 7:23
1/7/2021,Prachuap Khiri Khan,53,2749,552465,273938,278527,19918,19850,68,,,19/1/2022 7:23
1/7/2021,Prachin Buri,21,760,494352,243985,250367,3384,3384,0,54,29,19/1/2022 7:23
1/7/2021,Pattani,180,2479,728613,359883,368730,585,585,0,,,19/1/2022 7:23
1/7/2021,Phra Nakhon Si Ayutthaya,56,2625,820077,393953,426124,21529,21302,227,33,30,19/1/2022 7:23
1/7/2021,Phayao,1,192,465591,226581,239010,8278,8278,0,34,16,19/1/2022 7:23
1/7/2021,Phang-nga,2,340,268377,133890,134487,5208,4622,586,,,19/1/2022 7:23
1/7/2021,Phatthalung,8,599,522778,254665,268113,1934,1934,0,,,19/1/2022 7:23
1/7/2021,Phichit,6,189,530608,258695,271913,6355,6355,0,,,19/1/2022 7:23
1/7/2021,Phitsanulok,10,414,847773,415064,432709,26075,25939,136,,,19/1/2022 7:23
1/7/2021,Phuket,7,961,417161,197202,219959,36699,20738,15961,56,25,19/1/2022 7:23
1/7/2021,Maha Sarakham,2,460,950326,465921,484405,2664,2664,0,,,19/1/2022 7:23
1/7/2021,Mukdahan,6,53,351129,175445,175684,5772,5772,0,,,19/1/2022 7:23
1/7/2021,Yala,136,2135,541400,269573,271827,529,529,0,50,20,19/1/2022 7:23
1/7/2021,Yasothon,3,165,533683,266331,267352,1497,1497,0,,,19/1/2022 7:23
1/7/2021,Ranong,12,1422,194637,98230,96407,1633,1633,0,,,19/1/2022 7:23
1/7/2021,Rayong,58,2277,748108,367475,380633,20171,19927,244,61,34,19/1/2022 7:23
1/7/2021,Ratchaburi,48,1511,869206,422658,446548,10667,10667,0,,,19/1/2022 7:23
1/7/2021,Roi Et,11,372,1296773,642509,654264,2573,2573,0,,,19/1/2022 7:23
1/7/2021,Lop Buri,12,491,740037,368792,371245,5956,5927,29,,,19/1/2022 7:23
1/7/2021,Lampang,4,278,726701,354158,372543,6122,5950,172,48,19,19/1/2022 7:23
1/7/2021,Lamphun,0,307,401619,193055,208564,6810,6725,85,,,19/1/2022 7:23
1/7/2021,Si Sa Ket,13,515,1457396,725574,731822,3604,3604,0,,,19/1/2022 7:23
1/7/2021,Sakon Nakhon,9,213,1146784,569879,576905,4796,4796,0,,,19/1/2022 7:23
1/7/2021,Songkhla,286,6054,1429789,696651,733138,1474,1474,0,60,33,19/1/2022 7:23
1/7/2021,Satun,1,148,324467,161491,162976,1839,1820,19,34,27,19/1/2022 7:23
1/7/2021,Samut Prakarn,436,18327,1355644,645919,709725,1526,1481,45,,,19/1/2022 7:23
1/7/2021,Samut Songkhram,21,720,191611,91527,100084,6501,6501,0,24,12,19/1/2022 7:23
1/7/2021,Samut Sakhon,309,25485,586567,282712,303855,861,861,0,54,32,19/1/2022 7:23
1/7/2021,Saraburi,98,1768,643513,316041,327472,7419,7401,18,51,49,19/1/2022 7:23
1/7/2021,Sa kaeo,27,1490,561275,280157,281118,2531,2531,0,34,16,19/1/2022 7:23
1/7/2021,Sing Buri,5,187,205218,97486,107732,2031,2031,0,,,19/1/2022 7:23
1/7/2021,Suphan Buri,38,779,836800,403755,433045,9449,9449,0,,,19/1/2022 7:23
1/7/2021,Surat Thani,37,2031,1070296,526627,543669,3602,3188,414,59,19,19/1/2022 7:23
1/7/2021,Surin,13,308,1377078,685103,691975,7265,7252,13,,,19/1/2022 7:23
1/7/2021,Sukhothai,5,163,586111,283837,302274,5178,5003,175,,,19/1/2022 7:23
1/7/2021,Nong Khai,3,114,517035,256446,260589,8319,8316,3,19,9,19/1/2022 7:23
1/7/2021,Nong Bua Lam Phu,4,116,509092,253938,255154,2269,2269,0,,,19/1/2022 7:23
1/7/2021,Amnat Charoen,0,68,376294,187233,189061,1392,1392,0,,,19/1/2022 7:23
1/7/2021,Udon Thani,34,689,1567167,776285,790882,10132,10127,5,,,19/1/2022 7:23
1/7/2021,Uttaradit,7,168,447361,218107,229254,5713,5713,0,,,19/1/2022 7:23
1/7/2021,Uthai Thani,2,60,325339,159003,166336,2109,2109,0,,,19/1/2022 7:23
1/7/2021,Ubon Ratchathani,18,493,1867197,932136,935061,6431,6431,0,38,23,19/1/2022 7:23
1/7/2021,Ang Thong,9,423,275675,131918,143757,1386,1386,0,,,19/1/2022 7:23
1/7/2021,Chiang Rai,16,1080,1297041,630437,666604,25803,25572,231,30,11,19/1/2022 7:23
1/7/2021,Chiang Mai,4,8483,1786622,863343,923279,69510,68521,989,51,21,19/1/2022 7:23
1/7/2021,Phetchaburi,74,8898,482401,232827,249574,15182,15093,89,,,19/1/2022 7:23
1/7/2021,Phetchabun,4,285,979701,483282,496419,22759,22735,24,,,19/1/2022 7:23
1/7/2021,Loei,5,153,638517,320015,318502,4573,4565,8,26,11,19/1/2022 7:23
1/7/2021,Phrae,0,103,435659,209972,225687,5424,5424,0,37,15,19/1/2022 7:23
1/7/2021,Mae Hong Son,0,54,285729,144754,140975,9411,9186,225,18,3,19/1/2022 7:23
1/7/2021,,0,153,,,,,,,,,19/1/2022 7:23
2/7/2021,Krabi,7,440,478495,237646,240849,1716,1716,0,,,19/1/2022 7:23
2/7/2021,Bangkok,2346,102703,5551744,2605273,2946471,169121,147154,21967,44,25,19/1/2022 7:23
2/7/2021,Kanchanaburi,20,629,893118,447911,445207,26909,26862,47,19,6,19/1/2022 7:23
2/7/2021,Kalasin,13,239,976323,482572,493751,2495,2495,0,,,19/1/2022 7:23
2/7/2021,Kamphaeng Phet,10,362,712903,351973,360930,6317,6317,0,,,19/1/2022 7:23
2/7/2021,Khon Kaen,70,758,1792421,881179,911242,17954,17954,0,59,31,19/1/2022 7:23
2/7/2021,Chanthaburi,9,1537,535998,262065,273933,17139,17083,56,,,19/1/2022 7:23
2/7/2021,Chachoengsao,58,5015,722052,353870,368182,2359,2359,0,33,29,19/1/2022 7:23
2/7/2021,Chon Buri,223,10561,1579473,770979,808494,34619,34021,598,42,21,19/1/2022 7:23
2/7/2021,Chai Nat,6,144,321220,154391,166829,3194,3194,0,,,19/1/2022 7:23
2/7/2021,Chaiyaphum,13,480,1123243,554962,568281,6802,6802,0,,,19/1/2022 7:23
2/7/2021,Chumphon,5,191,509453,251448,258005,1865,1865,0,,,19/1/2022 7:23
2/7/2021,Trang,8,1688,640011,312941,327070,2288,2288,0,,,19/1/2022 7:23
2/7/2021,Trat,8,312,228415,112919,115496,17144,17038,106,,,19/1/2022 7:23
2/7/2021,Tak,37,1418,674330,340958,333372,13933,13933,0,,,19/1/2022 7:23
2/7/2021,Nakhon Nayok,6,587,259525,127999,131526,3515,3515,0,,,19/1/2022 7:23
2/7/2021,Nakhon Pathom,97,4806,922047,442945,479102,4047,4047,0,28,13,19/1/2022 7:23
2/7/2021,Nakhon Phanom,13,201,717065,357305,359760,4473,4473,0,,,19/1/2022 7:23
2/7/2021,Nakhon Ratchasima,22,1312,2633481,1294026,1339455,83136,82593,543,50,27,19/1/2022 7:23
2/7/2021,Nakhon Si Thammarat,19,1549,1549708,764609,785099,8425,8425,0,,,19/1/2022 7:23
2/7/2021,Nakhon Sawan,23,807,1037270,506043,531227,14969,14969,0,34,20,19/1/2022 7:23
2/7/2021,Nonthaburi,327,20273,1284757,597804,686953,2156,2144,12,25,11,19/1/2022 7:23
2/7/2021,Narathiwat,124,2395,808277,399788,408489,474,474,0,48,23,19/1/2022 7:23
2/7/2021,Nan,3,165,475961,238094,237867,9841,9805,36,,,19/1/2022 7:23
2/7/2021,Bueng Kan,4,57,421989,211591,210398,2816,2816,0,,,19/1/2022 7:23
2/7/2021,Buri Ram,24,341,1579847,783934,795913,10752,10721,31,,,19/1/2022 7:23
2/7/2021,Pathum Thani,284,9336,1184541,561189,623352,1116,1103,13,53,15,19/1/2022 7:23
2/7/2021,Prachuap Khiri Khan,19,2768,552465,273938,278527,19918,19850,68,,,19/1/2022 7:23
2/7/2021,Prachin Buri,39,799,494352,243985,250367,3384,3384,0,61,28,19/1/2022 7:23
2/7/2021,Pattani,169,2648,728613,359883,368730,585,585,0,,,19/1/2022 7:23
2/7/2021,Phra Nakhon Si Ayutthaya,103,2728,820077,393953,426124,21529,21302,227,21,35,19/1/2022 7:23
2/7/2021,Phayao,7,199,465591,226581,239010,8278,8278,0,31,18,19/1/2022 7:23
2/7/2021,Phang-nga,0,340,268377,133890,134487,5208,4622,586,,,19/1/2022 7:23
2/7/2021,Phatthalung,10,609,522778,254665,268113,1934,1934,0,,,19/1/2022 7:23
2/7/2021,Phichit,8,197,530608,258695,271913,6355,6355,0,,,19/1/2022 7:23
2/7/2021,Phitsanulok,4,418,847773,415064,432709,26075,25939,136,,,19/1/2022 7:23
2/7/2021,Phuket,4,965,417161,197202,219959,36699,20738,15961,52,20,19/1/2022 7:23
2/7/2021,Maha Sarakham,9,469,950326,465921,484405,2664,2664,0,,,19/1/2022 7:23
2/7/2021,Mukdahan,12,65,351129,175445,175684,5772,5772,0,,,19/1/2022 7:23
2/7/2021,Yala,201,2336,541400,269573,271827,529,529,0,45,22,19/1/2022 7:23
2/7/2021,Yasothon,11,176,533683,266331,267352,1497,1497,0,,,19/1/2022 7:23
2/7/2021,Ranong,24,1446,194637,98230,96407,1633,1633,0,,,19/1/2022 7:23
2/7/2021,Rayong,58,2335,748108,367475,380633,20171,19927,244,62,42,19/1/2022 7:23
2/7/2021,Ratchaburi,40,1551,869206,422658,446548,10667,10667,0,,,19/1/2022 7:23
2/7/2021,Roi Et,26,398,1296773,642509,654264,2573,2573,0,,,19/1/2022 7:23
2/7/2021,Lop Buri,12,503,740037,368792,371245,5956,5927,29,,,19/1/2022 7:23
2/7/2021,Lampang,7,285,726701,354158,372543,6122,5950,172,46,18,19/1/2022 7:23
2/7/2021,Lamphun,0,307,401619,193055,208564,6810,6725,85,,,19/1/2022 7:23
2/7/2021,Si Sa Ket,30,545,1457396,725574,731822,3604,3604,0,,,19/1/2022 7:23
2/7/2021,Sakon Nakhon,10,223,1146784,569879,576905,4796,4796,0,,,19/1/2022 7:23
2/7/2021,Songkhla,167,6221,1429789,696651,733138,1474,1474,0,66,30,19/1/2022 7:23
2/7/2021,Satun,12,160,324467,161491,162976,1839,1820,19,34,20,19/1/2022 7:23
2/7/2021,Samut Prakarn,523,18850,1355644,645919,709725,1526,1481,45,,,19/1/2022 7:23
2/7/2021,Samut Songkhram,27,747,191611,91527,100084,6501,6501,0,27,12,19/1/2022 7:23
2/7/2021,Samut Sakhon,401,25886,586567,282712,303855,861,861,0,62,29,19/1/2022 7:23
2/7/2021,Saraburi,71,1839,643513,316041,327472,7419,7401,18,46,48,19/1/2022 7:23
2/7/2021,Sa kaeo,18,1508,561275,280157,281118,2531,2531,0,30,20,19/1/2022 7:23
2/7/2021,Sing Buri,2,189,205218,97486,107732,2031,2031,0,,,19/1/2022 7:23
2/7/2021,Suphan Buri,21,800,836800,403755,433045,9449,9449,0,,,19/1/2022 7:23
2/7/2021,Surat Thani,27,2058,1070296,526627,543669,3602,3188,414,55,19,19/1/2022 7:23
2/7/2021,Surin,17,325,1377078,685103,691975,7265,7252,13,,,19/1/2022 7:23
2/7/2021,Sukhothai,7,170,586111,283837,302274,5178,5003,175,,,19/1/2022 7:23
2/7/2021,Nong Khai,2,116,517035,256446,260589,8319,8316,3,21,10,19/1/2022 7:23
2/7/2021,Nong Bua Lam Phu,5,121,509092,253938,255154,2269,2269,0,,,19/1/2022 7:23
2/7/2021,Amnat Charoen,3,71,376294,187233,189061,1392,1392,0,,,19/1/2022 7:23
2/7/2021,Udon Thani,37,726,1567167,776285,790882,10132,10127,5,,,19/1/2022 7:23
2/7/2021,Uttaradit,4,172,447361,218107,229254,5713,5713,0,,,19/1/2022 7:23
2/7/2021,Uthai Thani,12,72,325339,159003,166336,2109,2109,0,,,19/1/2022 7:23
2/7/2021,Ubon Ratchathani,31,524,1867197,932136,935061,6431,6431,0,53,30,19/1/2022 7:23
2/7/2021,Ang Thong,5,428,275675,131918,143757,1386,1386,0,,,19/1/2022 7:23
2/7/2021,Chiang Rai,7,1087,1297041,630437,666604,25803,25572,231,30,14,19/1/2022 7:23
2/7/2021,Chiang Mai,6,8489,1786622,863343,923279,69510,68521,989,48,23,19/1/2022 7:23
2/7/2021,Phetchaburi,77,8975,482401,232827,249574,15182,15093,89,,,19/1/2022 7:23
2/7/2021,Phetchabun,12,297,979701,483282,496419,22759,22735,24,,,19/1/2022 7:23
2/7/2021,Loei,9,162,638517,320015,318502,4573,4565,8,18,14,19/1/2022 7:23
2/7/2021,Phrae,2,105,435659,209972,225687,5424,5424,0,34,19,19/1/2022 7:23
2/7/2021,Mae Hong Son,0,54,285729,144754,140975,9411,9186,225,15,7,19/1/2022 7:23
2/7/2021,,0,153,,,,,,,,,19/1/2022 7:23
3/7/2021,Krabi,2,442,478495,237646,240849,1716,1716,0,,,19/1/2022 7:23
3/7/2021,Bangkok,1998,104701,5551744,2605273,2946471,169121,147154,21967,47,19,19/1/2022 7:23
3/7/2021,Kanchanaburi,15,644,893118,447911,445207,26909,26862,47,22,6,19/1/2022 7:23
3/7/2021,Kalasin,32,271,976323,482572,493751,2495,2495,0,,,19/1/2022 7:23
3/7/2021,Kamphaeng Phet,10,372,712903,351973,360930,6317,6317,0,,,19/1/2022 7:23
3/7/2021,Khon Kaen,25,783,1792421,881179,911242,17954,17954,0,59,35,19/1/2022 7:23
3/7/2021,Chanthaburi,20,1557,535998,262065,273933,17139,17083,56,,,19/1/2022 7:23
3/7/2021,Chachoengsao,61,5076,722052,353870,368182,2359,2359,0,45,37,19/1/2022 7:23
3/7/2021,Chon Buri,294,10855,1579473,770979,808494,34619,34021,598,31,20,19/1/2022 7:23
3/7/2021,Chai Nat,0,144,321220,154391,166829,3194,3194,0,,,19/1/2022 7:23
3/7/2021,Chaiyaphum,18,498,1123243,554962,568281,6802,6802,0,,,19/1/2022 7:23
3/7/2021,Chumphon,4,195,509453,251448,258005,1865,1865,0,,,19/1/2022 7:23
3/7/2021,Trang,10,1698,640011,312941,327070,2288,2288,0,,,19/1/2022 7:23
3/7/2021,Trat,8,320,228415,112919,115496,17144,17038,106,,,19/1/2022 7:23
3/7/2021,Tak,39,1457,674330,340958,333372,13933,13933,0,,,19/1/2022 7:23
3/7/2021,Nakhon Nayok,27,614,259525,127999,131526,3515,3515,0,,,19/1/2022 7:23
3/7/2021,Nakhon Pathom,333,5139,922047,442945,479102,4047,4047,0,22,14,19/1/2022 7:23
3/7/2021,Nakhon Phanom,18,219,717065,357305,359760,4473,4473,0,,,19/1/2022 7:23
3/7/2021,Nakhon Ratchasima,38,1350,2633481,1294026,1339455,83136,82593,543,54,33,19/1/2022 7:23
3/7/2021,Nakhon Si Thammarat,33,1582,1549708,764609,785099,8425,8425,0,,,19/1/2022 7:23
3/7/2021,Nakhon Sawan,22,829,1037270,506043,531227,14969,14969,0,36,28,19/1/2022 7:23
3/7/2021,Nonthaburi,257,20530,1284757,597804,686953,2156,2144,12,18,14,19/1/2022 7:23
3/7/2021,Narathiwat,66,2461,808277,399788,408489,474,474,0,53,19,19/1/2022 7:23
3/7/2021,Nan,1,166,475961,238094,237867,9841,9805,36,,,19/1/2022 7:23
3/7/2021,Bueng Kan,0,57,421989,211591,210398,2816,2816,0,,,19/1/2022 7:23
3/7/2021,Buri Ram,27,368,1579847,783934,795913,10752,10721,31,,,19/1/2022 7:23
3/7/2021,Pathum Thani,448,9784,1184541,561189,623352,1116,1103,13,46,18,19/1/2022 7:23
3/7/2021,Prachuap Khiri Khan,21,2789,552465,273938,278527,19918,19850,68,,,19/1/2022 7:23
3/7/2021,Prachin Buri,16,815,494352,243985,250367,3384,3384,0,59,34,19/1/2022 7:23
3/7/2021,Pattani,197,2845,728613,359883,368730,585,585,0,,,19/1/2022 7:23
3/7/2021,Phra Nakhon Si Ayutthaya,88,2816,820077,393953,426124,21529,21302,227,31,42,19/1/2022 7:23
3/7/2021,Phayao,1,200,465591,226581,239010,8278,8278,0,27,20,19/1/2022 7:23
3/7/2021,Phang-nga,0,340,268377,133890,134487,5208,4622,586,,,19/1/2022 7:23
3/7/2021,Phatthalung,16,625,522778,254665,268113,1934,1934,0,,,19/1/2022 7:23
3/7/2021,Phichit,6,203,530608,258695,271913,6355,6355,0,,,19/1/2022 7:23
3/7/2021,Phitsanulok,16,434,847773,415064,432709,26075,25939,136,,,19/1/2022 7:23
3/7/2021,Phuket,7,972,417161,197202,219959,36699,20738,15961,44,22,19/1/2022 7:23
3/7/2021,Maha Sarakham,17,486,950326,465921,484405,2664,2664,0,,,19/1/2022 7:23
3/7/2021,Mukdahan,7,72,351129,175445,175684,5772,5772,0,,,19/1/2022 7:23
3/7/2021,Yala,159,2495,541400,269573,271827,529,529,0,52,17,19/1/2022 7:23
3/7/2021,Yasothon,11,187,533683,266331,267352,1497,1497,0,,,19/1/2022 7:23
3/7/2021,Ranong,22,1468,194637,98230,96407,1633,1633,0,,,19/1/2022 7:23
3/7/2021,Rayong,69,2404,748108,367475,380633,20171,19927,244,65,33,19/1/2022 7:23
3/7/2021,Ratchaburi,98,1649,869206,422658,446548,10667,10667,0,,,19/1/2022 7:23
3/7/2021,Roi Et,27,425,1296773,642509,654264,2573,2573,0,,,19/1/2022 7:23
3/7/2021,Lop Buri,23,526,740037,368792,371245,5956,5927,29,,,19/1/2022 7:23
3/7/2021,Lampang,8,293,726701,354158,372543,6122,5950,172,43,19,19/1/2022 7:23
3/7/2021,Lamphun,1,308,401619,193055,208564,6810,6725,85,,,19/1/2022 7:23
3/7/2021,Si Sa Ket,44,589,1457396,725574,731822,3604,3604,0,,,19/1/2022 7:23
3/7/2021,Sakon Nakhon,22,245,1146784,569879,576905,4796,4796,0,,,19/1/2022 7:23
3/7/2021,Songkhla,234,6455,1429789,696651,733138,1474,1474,0,59,29,19/1/2022 7:23
3/7/2021,Satun,29,189,324467,161491,162976,1839,1820,19,32,20,19/1/2022 7:23
3/7/2021,Samut Prakarn,480,19330,1355644,645919,709725,1526,1481,45,,,19/1/2022 7:23
3/7/2021,Samut Songkhram,15,762,191611,91527,100084,6501,6501,0,23,15,19/1/2022 7:23
3/7/2021,Samut Sakhon,299,26185,586567,282712,303855,861,861,0,56,24,19/1/2022 7:23
3/7/2021,Saraburi,90,1929,643513,316041,327472,7419,7401,18,50,65,19/1/2022 7:23
3/7/2021,Sa kaeo,22,1530,561275,280157,281118,2531,2531,0,38,24,19/1/2022 7:23
3/7/2021,Sing Buri,2,191,205218,97486,107732,2031,2031,0,,,19/1/2022 7:23
3/7/2021,Suphan Buri,68,868,836800,403755,433045,9449,9449,0,,,19/1/2022 7:23
3/7/2021,Surat Thani,14,2072,1070296,526627,543669,3602,3188,414,56,16,19/1/2022 7:23
3/7/2021,Surin,31,356,1377078,685103,691975,7265,7252,13,,,19/1/2022 7:23
3/7/2021,Sukhothai,15,185,586111,283837,302274,5178,5003,175,,,19/1/2022 7:23
3/7/2021,Nong Khai,3,119,517035,256446,260589,8319,8316,3,25,10,19/1/2022 7:23
3/7/2021,Nong Bua Lam Phu,11,132,509092,253938,255154,2269,2269,0,,,19/1/2022 7:23
3/7/2021,Amnat Charoen,7,78,376294,187233,189061,1392,1392,0,,,19/1/2022 7:23
3/7/2021,Udon Thani,25,751,1567167,776285,790882,10132,10127,5,,,19/1/2022 7:23
3/7/2021,Uttaradit,9,181,447361,218107,229254,5713,5713,0,,,19/1/2022 7:23
3/7/2021,Uthai Thani,11,83,325339,159003,166336,2109,2109,0,,,19/1/2022 7:23
3/7/2021,Ubon Ratchathani,31,555,1867197,932136,935061,6431,6431,0,65,33,19/1/2022 7:23
3/7/2021,Ang Thong,4,432,275675,131918,143757,1386,1386,0,,,19/1/2022 7:23
3/7/2021,Chiang Rai,20,1107,1297041,630437,666604,25803,25572,231,38,14,19/1/2022 7:23
3/7/2021,Chiang Mai,5,8494,1786622,863343,923279,69510,68521,989,50,22,19/1/2022 7:23
3/7/2021,Phetchaburi,74,9049,482401,232827,249574,15182,15093,89,,,19/1/2022 7:23
3/7/2021,Phetchabun,37,334,979701,483282,496419,22759,22735,24,,,19/1/2022 7:23
3/7/2021,Loei,11,173,638517,320015,318502,4573,4565,8,28,16,19/1/2022 7:23
3/7/2021,Phrae,1,106,435659,209972,225687,5424,5424,0,43,17,19/1/2022 7:23
3/7/2021,Mae Hong Son,0,54,285729,144754,140975,9411,9186,225,26,7,19/1/2022 7:23
3/7/2021,,0,153,,,,,,,,,19/1/2022 7:23
4/7/2021,Krabi,20,462,478495,237646,240849,1716,1716,0,,,19/1/2022 7:23
4/7/2021,Bangkok,1511,106212,5551744,2605273,2946471,169121,147154,21967,42,25,19/1/2022 7:23
4/7/2021,Kanchanaburi,19,663,893118,447911,445207,26909,26862,47,19,8,19/1/2022 7:23
4/7/2021,Kalasin,26,297,976323,482572,493751,2495,2495,0,,,19/1/2022 7:23
4/7/2021,Kamphaeng Phet,21,393,712903,351973,360930,6317,6317,0,,,19/1/2022 7:23
4/7/2021,Khon Kaen,32,815,1792421,881179,911242,17954,17954,0,62,41,19/1/2022 7:23
4/7/2021,Chanthaburi,25,1582,535998,262065,273933,17139,17083,56,,,19/1/2022 7:23
4/7/2021,Chachoengsao,56,5132,722052,353870,368182,2359,2359,0,65,30,19/1/2022 7:23
4/7/2021,Chon Buri,275,11130,1579473,770979,808494,34619,34021,598,33,28,19/1/2022 7:23
4/7/2021,Chai Nat,2,146,321220,154391,166829,3194,3194,0,,,19/1/2022 7:23
4/7/2021,Chaiyaphum,34,532,1123243,554962,568281,6802,6802,0,,,19/1/2022 7:23
4/7/2021,Chumphon,0,195,509453,251448,258005,1865,1865,0,,,19/1/2022 7:23
4/7/2021,Trang,7,1705,640011,312941,327070,2288,2288,0,,,19/1/2022 7:23
4/7/2021,Trat,4,324,228415,112919,115496,17144,17038,106,,,19/1/2022 7:23
4/7/2021,Tak,181,1638,674330,340958,333372,13933,13933,0,,,19/1/2022 7:23
4/7/2021,Nakhon Nayok,14,628,259525,127999,131526,3515,3515,0,,,19/1/2022 7:23
4/7/2021,Nakhon Pathom,230,5369,922047,442945,479102,4047,4047,0,35,14,19/1/2022 7:23
4/7/2021,Nakhon Phanom,7,226,717065,357305,359760,4473,4473,0,,,19/1/2022 7:23
4/7/2021,Nakhon Ratchasima,44,1394,2633481,1294026,1339455,83136,82593,543,60,27,19/1/2022 7:23
4/7/2021,Nakhon Si Thammarat,22,1604,1549708,764609,785099,8425,8425,0,,,19/1/2022 7:23
4/7/2021,Nakhon Sawan,33,862,1037270,506043,531227,14969,14969,0,56,25,19/1/2022 7:23
4/7/2021,Nonthaburi,269,20799,1284757,597804,686953,2156,2144,12,23,14,19/1/2022 7:23
4/7/2021,Narathiwat,49,2510,808277,399788,408489,474,474,0,36,19,19/1/2022 7:23
4/7/2021,Nan,2,168,475961,238094,237867,9841,9805,36,,,19/1/2022 7:23
4/7/2021,Bueng Kan,2,59,421989,211591,210398,2816,2816,0,,,19/1/2022 7:23
4/7/2021,Buri Ram,21,389,1579847,783934,795913,10752,10721,31,,,19/1/2022 7:23
4/7/2021,Pathum Thani,459,10243,1184541,561189,623352,1116,1103,13,52,18,19/1/2022 7:23
4/7/2021,Prachuap Khiri Khan,27,2816,552465,273938,278527,19918,19850,68,,,19/1/2022 7:23
4/7/2021,Prachin Buri,43,858,494352,243985,250367,3384,3384,0,65,28,19/1/2022 7:23
4/7/2021,Pattani,213,3058,728613,359883,368730,585,585,0,,,19/1/2022 7:23
4/7/2021,Phra Nakhon Si Ayutthaya,65,2881,820077,393953,426124,21529,21302,227,52,40,19/1/2022 7:23
4/7/2021,Phayao,3,203,465591,226581,239010,8278,8278,0,39,26,19/1/2022 7:23
4/7/2021,Phang-nga,4,344,268377,133890,134487,5208,4622,586,,,19/1/2022 7:23
4/7/2021,Phatthalung,6,631,522778,254665,268113,1934,1934,0,,,19/1/2022 7:23
4/7/2021,Phichit,9,212,530608,258695,271913,6355,6355,0,,,19/1/2022 7:23
4/7/2021,Phitsanulok,15,449,847773,415064,432709,26075,25939,136,,,19/1/2022 7:23
4/7/2021,Phuket,2,974,417161,197202,219959,36699,20738,15961,47,21,19/1/2022 7:23
4/7/2021,Maha Sarakham,33,519,950326,465921,484405,2664,2664,0,,,19/1/2022 7:23
4/7/2021,Mukdahan,8,80,351129,175445,175684,5772,5772,0,,,19/1/2022 7:23
4/7/2021,Yala,205,2700,541400,269573,271827,529,529,0,37,18,19/1/2022 7:23
4/7/2021,Yasothon,12,199,533683,266331,267352,1497,1497,0,,,19/1/2022 7:23
4/7/2021,Ranong,7,1475,194637,98230,96407,1633,1633,0,,,19/1/2022 7:23
4/7/2021,Rayong,47,2451,748108,367475,380633,20171,19927,244,50,37,19/1/2022 7:23
4/7/2021,Ratchaburi,92,1741,869206,422658,446548,10667,10667,0,,,19/1/2022 7:23
4/7/2021,Roi Et,44,469,1296773,642509,654264,2573,2573,0,,,19/1/2022 7:23
4/7/2021,Lop Buri,66,592,740037,368792,371245,5956,5927,29,,,19/1/2022 7:23
4/7/2021,Lampang,6,299,726701,354158,372543,6122,5950,172,45,18,19/1/2022 7:23
4/7/2021,Lamphun,0,308,401619,193055,208564,6810,6725,85,,,19/1/2022 7:23
4/7/2021,Si Sa Ket,42,631,1457396,725574,731822,3604,3604,0,,,19/1/2022 7:23
4/7/2021,Sakon Nakhon,20,265,1146784,569879,576905,4796,4796,0,,,19/1/2022 7:23
4/7/2021,Songkhla,247,6702,1429789,696651,733138,1474,1474,0,56,29,19/1/2022 7:23
4/7/2021,Satun,7,196,324467,161491,162976,1839,1820,19,36,18,19/1/2022 7:23
4/7/2021,Samut Prakarn,412,19742,1355644,645919,709725,1526,1481,45,,,19/1/2022 7:23
4/7/2021,Samut Songkhram,24,786,191611,91527,100084,6501,6501,0,33,13,19/1/2022 7:23
4/7/2021,Samut Sakhon,403,26588,586567,282712,303855,861,861,0,51,62,19/1/2022 7:23
4/7/2021,Saraburi,85,2014,643513,316041,327472,7419,7401,18,80,62,19/1/2022 7:23
4/7/2021,Sa kaeo,40,1570,561275,280157,281118,2531,2531,0,50,19,19/1/2022 7:23
4/7/2021,Sing Buri,10,201,205218,97486,107732,2031,2031,0,,,19/1/2022 7:23
4/7/2021,Suphan Buri,44,912,836800,403755,433045,9449,9449,0,,,19/1/2022 7:23
4/7/2021,Surat Thani,11,2083,1070296,526627,543669,3602,3188,414,51,16,19/1/2022 7:23
4/7/2021,Surin,51,407,1377078,685103,691975,7265,7252,13,,,19/1/2022 7:23
4/7/2021,Sukhothai,13,198,586111,283837,302274,5178,5003,175,,,19/1/2022 7:23
4/7/2021,Nong Khai,6,125,517035,256446,260589,8319,8316,3,24,12,19/1/2022 7:23
4/7/2021,Nong Bua Lam Phu,6,138,509092,253938,255154,2269,2269,0,,,19/1/2022 7:23
4/7/2021,Amnat Charoen,6,84,376294,187233,189061,1392,1392,0,,,19/1/2022 7:23
4/7/2021,Udon Thani,32,783,1567167,776285,790882,10132,10127,5,,,19/1/2022 7:23
4/7/2021,Uttaradit,11,192,447361,218107,229254,5713,5713,0,,,19/1/2022 7:23
4/7/2021,Uthai Thani,21,104,325339,159003,166336,2109,2109,0,,,19/1/2022 7:23
4/7/2021,Ubon Ratchathani,35,590,1867197,932136,935061,6431,6431,0,66,39,19/1/2022 7:23
4/7/2021,Ang Thong,0,432,275675,131918,143757,1386,1386,0,,,19/1/2022 7:23
4/7/2021,Chiang Rai,13,1120,1297041,630437,666604,25803,25572,231,42,15,19/1/2022 7:23
4/7/2021,Chiang Mai,5,8499,1786622,863343,923279,69510,68521,989,52,24,19/1/2022 7:23
4/7/2021,Phetchaburi,71,9120,482401,232827,249574,15182,15093,89,,,19/1/2022 7:23
4/7/2021,Phetchabun,10,344,979701,483282,496419,22759,22735,24,,,19/1/2022 7:23
4/7/2021,Loei,15,188,638517,320015,318502,4573,4565,8,33,15,19/1/2022 7:23
4/7/2021,Phrae,4,110,435659,209972,225687,5424,5424,0,45,15,19/1/2022 7:23
4/7/2021,Mae Hong Son,0,54,285729,144754,140975,9411,9186,225,30,8,19/1/2022 7:23
4/7/2021,,0,153,,,,,,,,,19/1/2022 7:23
5/7/2021,Krabi,11,473,478495,237646,240849,1716,1716,0,,,19/1/2022 7:23
5/7/2021,Bangkok,1735,107947,5551744,2605273,2946471,169121,147154,21967,41,39,19/1/2022 7:23
5/7/2021,Kanchanaburi,32,695,893118,447911,445207,26909,26862,47,28,7,19/1/2022 7:23
5/7/2021,Kalasin,8,305,976323,482572,493751,2495,2495,0,,,19/1/2022 7:23
5/7/2021,Kamphaeng Phet,27,420,712903,351973,360930,6317,6317,0,,,19/1/2022 7:23
5/7/2021,Khon Kaen,29,844,1792421,881179,911242,17954,17954,0,74,33,19/1/2022 7:23
5/7/2021,Chanthaburi,13,1595,535998,262065,273933,17139,17083,56,,,19/1/2022 7:23
5/7/2021,Chachoengsao,119,5251,722052,353870,368182,2359,2359,0,58,28,19/1/2022 7:23
5/7/2021,Chon Buri,279,11409,1579473,770979,808494,34619,34021,598,44,25,19/1/2022 7:23
5/7/2021,Chai Nat,3,149,321220,154391,166829,3194,3194,0,,,19/1/2022 7:23
5/7/2021,Chaiyaphum,20,552,1123243,554962,568281,6802,6802,0,,,19/1/2022 7:23
5/7/2021,Chumphon,4,199,509453,251448,258005,1865,1865,0,,,19/1/2022 7:23
5/7/2021,Trang,1,1706,640011,312941,327070,2288,2288,0,,,19/1/2022 7:23
5/7/2021,Trat,6,330,228415,112919,115496,17144,17038,106,,,19/1/2022 7:23
5/7/2021,Tak,112,1750,674330,340958,333372,13933,13933,0,,,19/1/2022 7:23
5/7/2021,Nakhon Nayok,33,661,259525,127999,131526,3515,3515,0,,,19/1/2022 7:23
5/7/2021,Nakhon Pathom,143,5512,922047,442945,479102,4047,4047,0,27,14,19/1/2022 7:23
5/7/2021,Nakhon Phanom,23,249,717065,357305,359760,4473,4473,0,,,19/1/2022 7:23
5/7/2021,Nakhon Ratchasima,74,1468,2633481,1294026,1339455,83136,82593,543,58,25,19/1/2022 7:23
5/7/2021,Nakhon Si Thammarat,21,1625,1549708,764609,785099,8425,8425,0,,,19/1/2022 7:23
5/7/2021,Nakhon Sawan,25,887,1037270,506043,531227,14969,14969,0,47,34,19/1/2022 7:23
5/7/2021,Nonthaburi,270,21069,1284757,597804,686953,2156,2144,12,27,14,19/1/2022 7:23
5/7/2021,Narathiwat,52,2562,808277,399788,408489,474,474,0,43,19,19/1/2022 7:23
5/7/2021,Nan,2,170,475961,238094,237867,9841,9805,36,,,19/1/2022 7:23
5/7/2021,Bueng Kan,7,66,421989,211591,210398,2816,2816,0,,,19/1/2022 7:23
5/7/2021,Buri Ram,45,434,1579847,783934,795913,10752,10721,31,,,19/1/2022 7:23
5/7/2021,Pathum Thani,352,10595,1184541,561189,623352,1116,1103,13,49,22,19/1/2022 7:23
5/7/2021,Prachuap Khiri Khan,26,2842,552465,273938,278527,19918,19850,68,,,19/1/2022 7:23
5/7/2021,Prachin Buri,27,885,494352,243985,250367,3384,3384,0,59,27,19/1/2022 7:23
5/7/2021,Pattani,133,3191,728613,359883,368730,585,585,0,,,19/1/2022 7:23
5/7/2021,Phra Nakhon Si Ayutthaya,212,3093,820077,393953,426124,21529,21302,227,40,36,19/1/2022 7:23
5/7/2021,Phayao,2,205,465591,226581,239010,8278,8278,0,54,17,19/1/2022 7:23
5/7/2021,Phang-nga,0,344,268377,133890,134487,5208,4622,586,,,19/1/2022 7:23
5/7/2021,Phatthalung,3,634,522778,254665,268113,1934,1934,0,,,19/1/2022 7:23
5/7/2021,Phichit,10,222,530608,258695,271913,6355,6355,0,,,19/1/2022 7:23
5/7/2021,Phitsanulok,13,462,847773,415064,432709,26075,25939,136,,,19/1/2022 7:23
5/7/2021,Phuket,2,976,417161,197202,219959,36699,20738,15961,46,25,19/1/2022 7:23
5/7/2021,Maha Sarakham,36,555,950326,465921,484405,2664,2664,0,,,19/1/2022 7:23
5/7/2021,Mukdahan,15,95,351129,175445,175684,5772,5772,0,,,19/1/2022 7:23
5/7/2021,Yala,92,2792,541400,269573,271827,529,529,0,44,16,19/1/2022 7:23
5/7/2021,Yasothon,15,214,533683,266331,267352,1497,1497,0,,,19/1/2022 7:23
5/7/2021,Ranong,7,1482,194637,98230,96407,1633,1633,0,,,19/1/2022 7:23
5/7/2021,Rayong,78,2529,748108,367475,380633,20171,19927,244,67,27,19/1/2022 7:23
5/7/2021,Ratchaburi,68,1809,869206,422658,446548,10667,10667,0,,,19/1/2022 7:23
5/7/2021,Roi Et,34,503,1296773,642509,654264,2573,2573,0,,,19/1/2022 7:23
5/7/2021,Lop Buri,29,621,740037,368792,371245,5956,5927,29,,,19/1/2022 7:23
5/7/2021,Lampang,6,305,726701,354158,372543,6122,5950,172,47,19,19/1/2022 7:23
5/7/2021,Lamphun,2,310,401619,193055,208564,6810,6725,85,,,19/1/2022 7:23
5/7/2021,Si Sa Ket,40,671,1457396,725574,731822,3604,3604,0,,,19/1/2022 7:23
5/7/2021,Sakon Nakhon,19,284,1146784,569879,576905,4796,4796,0,,,19/1/2022 7:23
5/7/2021,Songkhla,374,7076,1429789,696651,733138,1474,1474,0,54,32,19/1/2022 7:23
5/7/2021,Satun,8,204,324467,161491,162976,1839,1820,19,32,14,19/1/2022 7:23
5/7/2021,Samut Prakarn,429,20171,1355644,645919,709725,1526,1481,45,,,19/1/2022 7:23
5/7/2021,Samut Songkhram,32,818,191611,91527,100084,6501,6501,0,21,14,19/1/2022 7:23
5/7/2021,Samut Sakhon,393,26981,586567,282712,303855,861,861,0,45,35,19/1/2022 7:23
5/7/2021,Saraburi,89,2103,643513,316041,327472,7419,7401,18,67,43,19/1/2022 7:23
5/7/2021,Sa kaeo,12,1582,561275,280157,281118,2531,2531,0,44,17,19/1/2022 7:23
5/7/2021,Sing Buri,6,207,205218,97486,107732,2031,2031,0,,,19/1/2022 7:23
5/7/2021,Suphan Buri,71,983,836800,403755,433045,9449,9449,0,,,19/1/2022 7:23
5/7/2021,Surat Thani,18,2101,1070296,526627,543669,3602,3188,414,38,18,19/1/2022 7:23
5/7/2021,Surin,51,458,1377078,685103,691975,7265,7252,13,,,19/1/2022 7:23
5/7/2021,Sukhothai,25,223,586111,283837,302274,5178,5003,175,,,19/1/2022 7:23
5/7/2021,Nong Khai,3,128,517035,256446,260589,8319,8316,3,30,9,19/1/2022 7:23
5/7/2021,Nong Bua Lam Phu,16,154,509092,253938,255154,2269,2269,0,,,19/1/2022 7:23
5/7/2021,Amnat Charoen,15,99,376294,187233,189061,1392,1392,0,,,19/1/2022 7:23
5/7/2021,Udon Thani,33,816,1567167,776285,790882,10132,10127,5,,,19/1/2022 7:23
5/7/2021,Uttaradit,3,195,447361,218107,229254,5713,5713,0,,,19/1/2022 7:23
5/7/2021,Uthai Thani,16,120,325339,159003,166336,2109,2109,0,,,19/1/2022 7:23
5/7/2021,Ubon Ratchathani,68,658,1867197,932136,935061,6431,6431,0,70,22,19/1/2022 7:23
5/7/2021,Ang Thong,55,487,275675,131918,143757,1386,1386,0,,,19/1/2022 7:23
5/7/2021,Chiang Rai,9,1129,1297041,630437,666604,25803,25572,231,40,12,19/1/2022 7:23
5/7/2021,Chiang Mai,7,8506,1786622,863343,923279,69510,68521,989,52,22,19/1/2022 7:23
5/7/2021,Phetchaburi,56,9176,482401,232827,249574,15182,15093,89,,,19/1/2022 7:23
5/7/2021,Phetchabun,32,376,979701,483282,496419,22759,22735,24,,,19/1/2022 7:23
5/7/2021,Loei,20,208,638517,320015,318502,4573,4565,8,30,13,19/1/2022 7:23
5/7/2021,Phrae,10,120,435659,209972,225687,5424,5424,0,40,16,19/1/2022 7:23
5/7/2021,Mae Hong Son,0,54,285729,144754,140975,9411,9186,225,30,13,19/1/2022 7:23
5/7/2021,,0,153,,,,,,,,,19/1/2022 7:23
6/7/2021,Krabi,4,477,478495,237646,240849,1716,1716,0,,,19/1/2022 7:23
6/7/2021,Bangkok,1506,109453,5551744,2605273,2946471,169121,147154,21967,43,40,19/1/2022 7:23
6/7/2021,Kanchanaburi,20,715,893118,447911,445207,26909,26862,47,23,7,19/1/2022 7:23
6/7/2021,Kalasin,18,323,976323,482572,493751,2495,2495,0,,,19/1/2022 7:23
6/7/2021,Kamphaeng Phet,24,444,712903,351973,360930,6317,6317,0,,,19/1/2022 7:23
6/7/2021,Khon Kaen,21,865,1792421,881179,911242,17954,17954,0,63,29,19/1/2022 7:23
6/7/2021,Chanthaburi,11,1606,535998,262065,273933,17139,17083,56,,,19/1/2022 7:23
6/7/2021,Chachoengsao,85,5336,722052,353870,368182,2359,2359,0,54,25,19/1/2022 7:23
6/7/2021,Chon Buri,266,11675,1579473,770979,808494,34619,34021,598,42,26,19/1/2022 7:23
6/7/2021,Chai Nat,9,158,321220,154391,166829,3194,3194,0,,,19/1/2022 7:23
6/7/2021,Chaiyaphum,25,577,1123243,554962,568281,6802,6802,0,,,19/1/2022 7:23
6/7/2021,Chumphon,10,209,509453,251448,258005,1865,1865,0,,,19/1/2022 7:23
6/7/2021,Trang,5,1711,640011,312941,327070,2288,2288,0,,,19/1/2022 7:23
6/7/2021,Trat,6,336,228415,112919,115496,17144,17038,106,,,19/1/2022 7:23
6/7/2021,Tak,76,1826,674330,340958,333372,13933,13933,0,,,19/1/2022 7:23
6/7/2021,Nakhon Nayok,26,687,259525,127999,131526,3515,3515,0,,,19/1/2022 7:23
6/7/2021,Nakhon Pathom,206,5718,922047,442945,479102,4047,4047,0,34,11,19/1/2022 7:23
6/7/2021,Nakhon Phanom,30,279,717065,357305,359760,4473,4473,0,,,19/1/2022 7:23
6/7/2021,Nakhon Ratchasima,55,1523,2633481,1294026,1339455,83136,82593,543,62,24,19/1/2022 7:23
6/7/2021,Nakhon Si Thammarat,9,1634,1549708,764609,785099,8425,8425,0,,,19/1/2022 7:23
6/7/2021,Nakhon Sawan,23,910,1037270,506043,531227,14969,14969,0,68,28,19/1/2022 7:23
6/7/2021,Nonthaburi,243,21312,1284757,597804,686953,2156,2144,12,28,12,19/1/2022 7:23
6/7/2021,Narathiwat,109,2671,808277,399788,408489,474,474,0,40,24,19/1/2022 7:23
6/7/2021,Nan,1,171,475961,238094,237867,9841,9805,36,,,19/1/2022 7:23
6/7/2021,Bueng Kan,1,67,421989,211591,210398,2816,2816,0,,,19/1/2022 7:23
6/7/2021,Buri Ram,44,478,1579847,783934,795913,10752,10721,31,,,19/1/2022 7:23
6/7/2021,Pathum Thani,208,10803,1184541,561189,623352,1116,1103,13,53,16,19/1/2022 7:23
6/7/2021,Prachuap Khiri Khan,33,2875,552465,273938,278527,19918,19850,68,,,19/1/2022 7:23
6/7/2021,Prachin Buri,39,924,494352,243985,250367,3384,3384,0,57,22,19/1/2022 7:23
6/7/2021,Pattani,262,3453,728613,359883,368730,585,585,0,,,19/1/2022 7:23
6/7/2021,Phra Nakhon Si Ayutthaya,57,3150,820077,393953,426124,21529,21302,227,49,32,19/1/2022 7:23
6/7/2021,Phayao,0,205,465591,226581,239010,8278,8278,0,32,13,19/1/2022 7:23
6/7/2021,Phang-nga,2,346,268377,133890,134487,5208,4622,586,,,19/1/2022 7:23
6/7/2021,Phatthalung,0,634,522778,254665,268113,1934,1934,0,,,19/1/2022 7:23
6/7/2021,Phichit,11,233,530608,258695,271913,6355,6355,0,,,19/1/2022 7:23
6/7/2021,Phitsanulok,11,473,847773,415064,432709,26075,25939,136,,,19/1/2022 7:23
6/7/2021,Phuket,3,979,417161,197202,219959,36699,20738,15961,51,30,19/1/2022 7:23
6/7/2021,Maha Sarakham,36,591,950326,465921,484405,2664,2664,0,,,19/1/2022 7:23
6/7/2021,Mukdahan,6,101,351129,175445,175684,5772,5772,0,,,19/1/2022 7:23
6/7/2021,Yala,135,2927,541400,269573,271827,529,529,0,39,27,19/1/2022 7:23
6/7/2021,Yasothon,37,251,533683,266331,267352,1497,1497,0,,,19/1/2022 7:23
6/7/2021,Ranong,14,1496,194637,98230,96407,1633,1633,0,,,19/1/2022 7:23
6/7/2021,Rayong,75,2604,748108,367475,380633,20171,19927,244,34,25,19/1/2022 7:23
6/7/2021,Ratchaburi,63,1872,869206,422658,446548,10667,10667,0,,,19/1/2022 7:23
6/7/2021,Roi Et,55,558,1296773,642509,654264,2573,2573,0,,,19/1/2022 7:23
6/7/2021,Lop Buri,39,660,740037,368792,371245,5956,5927,29,,,19/1/2022 7:23
6/7/2021,Lampang,11,316,726701,354158,372543,6122,5950,172,44,17,19/1/2022 7:23
6/7/2021,Lamphun,1,311,401619,193055,208564,6810,6725,85,,,19/1/2022 7:23
6/7/2021,Si Sa Ket,33,704,1457396,725574,731822,3604,3604,0,,,19/1/2022 7:23
6/7/2021,Sakon Nakhon,22,306,1146784,569879,576905,4796,4796,0,,,19/1/2022 7:23
6/7/2021,Songkhla,152,7228,1429789,696651,733138,1474,1474,0,58,29,19/1/2022 7:23
6/7/2021,Satun,10,214,324467,161491,162976,1839,1820,19,28,22,19/1/2022 7:23
6/7/2021,Samut Prakarn,321,20492,1355644,645919,709725,1526,1481,45,,,19/1/2022 7:23
6/7/2021,Samut Songkhram,11,829,191611,91527,100084,6501,6501,0,29,10,19/1/2022 7:23
6/7/2021,Samut Sakhon,399,27380,586567,282712,303855,861,861,0,67,30,19/1/2022 7:23
6/7/2021,Saraburi,95,2198,643513,316041,327472,7419,7401,18,59,51,19/1/2022 7:23
6/7/2021,Sa kaeo,36,1618,561275,280157,281118,2531,2531,0,33,15,19/1/2022 7:23
6/7/2021,Sing Buri,15,222,205218,97486,107732,2031,2031,0,,,19/1/2022 7:23
6/7/2021,Suphan Buri,28,1011,836800,403755,433045,9449,9449,0,,,19/1/2022 7:23
6/7/2021,Surat Thani,5,2106,1070296,526627,543669,3602,3188,414,40,18,19/1/2022 7:23
6/7/2021,Surin,48,506,1377078,685103,691975,7265,7252,13,,,19/1/2022 7:23
6/7/2021,Sukhothai,26,249,586111,283837,302274,5178,5003,175,,,19/1/2022 7:23
6/7/2021,Nong Khai,0,128,517035,256446,260589,8319,8316,3,22,9,19/1/2022 7:23
6/7/2021,Nong Bua Lam Phu,5,159,509092,253938,255154,2269,2269,0,,,19/1/2022 7:23
6/7/2021,Amnat Charoen,21,120,376294,187233,189061,1392,1392,0,,,19/1/2022 7:23
6/7/2021,Udon Thani,20,836,1567167,776285,790882,10132,10127,5,,,19/1/2022 7:23
6/7/2021,Uttaradit,5,200,447361,218107,229254,5713,5713,0,,,19/1/2022 7:23
6/7/2021,Uthai Thani,22,142,325339,159003,166336,2109,2109,0,,,19/1/2022 7:23
6/7/2021,Ubon Ratchathani,54,712,1867197,932136,935061,6431,6431,0,50,18,19/1/2022 7:23
6/7/2021,Ang Thong,35,522,275675,131918,143757,1386,1386,0,,,19/1/2022 7:23
6/7/2021,Chiang Rai,8,1137,1297041,630437,666604,25803,25572,231,36,11,19/1/2022 7:23
6/7/2021,Chiang Mai,17,8523,1786622,863343,923279,69510,68521,989,50,18,19/1/2022 7:23
6/7/2021,Phetchaburi,44,9220,482401,232827,249574,15182,15093,89,,,19/1/2022 7:23
6/7/2021,Phetchabun,25,401,979701,483282,496419,22759,22735,24,,,19/1/2022 7:23
6/7/2021,Loei,18,226,638517,320015,318502,4573,4565,8,30,15,19/1/2022 7:23
6/7/2021,Phrae,14,134,435659,209972,225687,5424,5424,0,43,11,19/1/2022 7:23
6/7/2021,Mae Hong Son,0,54,285729,144754,140975,9411,9186,225,51,6,19/1/2022 7:23
6/7/2021,,0,153,,,,,,,,,19/1/2022 7:23
7/7/2021,Krabi,90,567,478495,237646,240849,1716,1716,0,,,19/1/2022 7:23
7/7/2021,Bangkok,1558,111011,5551744,2605273,2946471,169121,147154,21967,42,46,19/1/2022 7:23
7/7/2021,Kanchanaburi,20,735,893118,447911,445207,26909,26862,47,19,5,19/1/2022 7:23
7/7/2021,Kalasin,24,347,976323,482572,493751,2495,2495,0,,,19/1/2022 7:23
7/7/2021,Kamphaeng Phet,16,460,712903,351973,360930,6317,6317,0,,,19/1/2022 7:23
7/7/2021,Khon Kaen,27,892,1792421,881179,911242,17954,17954,0,60,24,19/1/2022 7:23
7/7/2021,Chanthaburi,9,1615,535998,262065,273933,17139,17083,56,,,19/1/2022 7:23
7/7/2021,Chachoengsao,252,5588,722052,353870,368182,2359,2359,0,44,28,19/1/2022 7:23
7/7/2021,Chon Buri,262,11937,1579473,770979,808494,34619,34021,598,43,23,19/1/2022 7:23
7/7/2021,Chai Nat,20,178,321220,154391,166829,3194,3194,0,,,19/1/2022 7:23
7/7/2021,Chaiyaphum,27,604,1123243,554962,568281,6802,6802,0,,,19/1/2022 7:23
7/7/2021,Chumphon,5,214,509453,251448,258005,1865,1865,0,,,19/1/2022 7:23
7/7/2021,Trang,3,1714,640011,312941,327070,2288,2288,0,,,19/1/2022 7:23
7/7/2021,Trat,35,371,228415,112919,115496,17144,17038,106,,,19/1/2022 7:23
7/7/2021,Tak,66,1892,674330,340958,333372,13933,13933,0,,,19/1/2022 7:23
7/7/2021,Nakhon Nayok,19,706,259525,127999,131526,3515,3515,0,,,19/1/2022 7:23
7/7/2021,Nakhon Pathom,266,5984,922047,442945,479102,4047,4047,0,22,12,19/1/2022 7:23
7/7/2021,Nakhon Phanom,13,292,717065,357305,359760,4473,4473,0,,,19/1/2022 7:23
7/7/2021,Nakhon Ratchasima,63,1586,2633481,1294026,1339455,83136,82593,543,55,17,19/1/2022 7:23
7/7/2021,Nakhon Si Thammarat,13,1647,1549708,764609,785099,8425,8425,0,,,19/1/2022 7:23
7/7/2021,Nakhon Sawan,51,961,1037270,506043,531227,14969,14969,0,56,23,19/1/2022 7:23
7/7/2021,Nonthaburi,238,21550,1284757,597804,686953,2156,2144,12,18,11,19/1/2022 7:23
7/7/2021,Narathiwat,58,2729,808277,399788,408489,474,474,0,50,27,19/1/2022 7:23
7/7/2021,Nan,2,173,475961,238094,237867,9841,9805,36,,,19/1/2022 7:23
7/7/2021,Bueng Kan,0,67,421989,211591,210398,2816,2816,0,,,19/1/2022 7:23
7/7/2021,Buri Ram,43,521,1579847,783934,795913,10752,10721,31,,,19/1/2022 7:23
7/7/2021,Pathum Thani,212,11015,1184541,561189,623352,1116,1103,13,48,15,19/1/2022 7:23
7/7/2021,Prachuap Khiri Khan,241,3116,552465,273938,278527,19918,19850,68,,,19/1/2022 7:23
7/7/2021,Prachin Buri,77,1001,494352,243985,250367,3384,3384,0,54,22,19/1/2022 7:23
7/7/2021,Pattani,190,3643,728613,359883,368730,585,585,0,,,19/1/2022 7:23
7/7/2021,Phra Nakhon Si Ayutthaya,43,3193,820077,393953,426124,21529,21302,227,32,29,19/1/2022 7:23
7/7/2021,Phayao,0,205,465591,226581,239010,8278,8278,0,24,13,19/1/2022 7:23
7/7/2021,Phang-nga,4,350,268377,133890,134487,5208,4622,586,,,19/1/2022 7:23
7/7/2021,Phatthalung,15,649,522778,254665,268113,1934,1934,0,,,19/1/2022 7:23
7/7/2021,Phichit,31,264,530608,258695,271913,6355,6355,0,,,19/1/2022 7:23
7/7/2021,Phitsanulok,41,514,847773,415064,432709,26075,25939,136,,,19/1/2022 7:23
7/7/2021,Phuket,2,981,417161,197202,219959,36699,20738,15961,53,26,19/1/2022 7:23
7/7/2021,Maha Sarakham,53,644,950326,465921,484405,2664,2664,0,,,19/1/2022 7:23
7/7/2021,Mukdahan,13,114,351129,175445,175684,5772,5772,0,,,19/1/2022 7:23
7/7/2021,Yala,160,3087,541400,269573,271827,529,529,0,52,30,19/1/2022 7:23
7/7/2021,Yasothon,21,272,533683,266331,267352,1497,1497,0,,,19/1/2022 7:23
7/7/2021,Ranong,14,1510,194637,98230,96407,1633,1633,0,,,19/1/2022 7:23
7/7/2021,Rayong,90,2694,748108,367475,380633,20171,19927,244,41,22,19/1/2022 7:23
7/7/2021,Ratchaburi,72,1944,869206,422658,446548,10667,10667,0,,,19/1/2022 7:23
7/7/2021,Roi Et,35,593,1296773,642509,654264,2573,2573,0,,,19/1/2022 7:23
7/7/2021,Lop Buri,109,769,740037,368792,371245,5956,5927,29,,,19/1/2022 7:23
7/7/2021,Lampang,10,326,726701,354158,372543,6122,5950,172,40,17,19/1/2022 7:23
7/7/2021,Lamphun,6,317,401619,193055,208564,6810,6725,85,,,19/1/2022 7:23
7/7/2021,Si Sa Ket,29,733,1457396,725574,731822,3604,3604,0,,,19/1/2022 7:23
7/7/2021,Sakon Nakhon,31,337,1146784,569879,576905,4796,4796,0,,,19/1/2022 7:23
7/7/2021,Songkhla,178,7406,1429789,696651,733138,1474,1474,0,54,35,19/1/2022 7:23
7/7/2021,Satun,3,217,324467,161491,162976,1839,1820,19,30,21,19/1/2022 7:23
7/7/2021,Samut Prakarn,549,21041,1355644,645919,709725,1526,1481,45,,,19/1/2022 7:23
7/7/2021,Samut Songkhram,20,849,191611,91527,100084,6501,6501,0,19,8,19/1/2022 7:23
7/7/2021,Samut Sakhon,461,27841,586567,282712,303855,861,861,0,55,27,19/1/2022 7:23
7/7/2021,Saraburi,51,2249,643513,316041,327472,7419,7401,18,54,57,19/1/2022 7:23
7/7/2021,Sa kaeo,12,1630,561275,280157,281118,2531,2531,0,25,16,19/1/2022 7:23
7/7/2021,Sing Buri,7,229,205218,97486,107732,2031,2031,0,,,19/1/2022 7:23
7/7/2021,Suphan Buri,61,1072,836800,403755,433045,9449,9449,0,,,19/1/2022 7:23
7/7/2021,Surat Thani,54,2160,1070296,526627,543669,3602,3188,414,49,18,19/1/2022 7:23
7/7/2021,Surin,71,577,1377078,685103,691975,7265,7252,13,,,19/1/2022 7:23
7/7/2021,Sukhothai,14,263,586111,283837,302274,5178,5003,175,,,19/1/2022 7:23
7/7/2021,Nong Khai,9,137,517035,256446,260589,8319,8316,3,21,11,19/1/2022 7:23
7/7/2021,Nong Bua Lam Phu,14,173,509092,253938,255154,2269,2269,0,,,19/1/2022 7:23
7/7/2021,Amnat Charoen,9,129,376294,187233,189061,1392,1392,0,,,19/1/2022 7:23
7/7/2021,Udon Thani,33,869,1567167,776285,790882,10132,10127,5,,,19/1/2022 7:23
7/7/2021,Uttaradit,4,204,447361,218107,229254,5713,5713,0,,,19/1/2022 7:23
7/7/2021,Uthai Thani,17,159,325339,159003,166336,2109,2109,0,,,19/1/2022 7:23
7/7/2021,Ubon Ratchathani,39,751,1867197,932136,935061,6431,6431,0,44,15,19/1/2022 7:23
7/7/2021,Ang Thong,45,567,275675,131918,143757,1386,1386,0,,,19/1/2022 7:23
7/7/2021,Chiang Rai,13,1150,1297041,630437,666604,25803,25572,231,24,11,19/1/2022 7:23
7/7/2021,Chiang Mai,26,8549,1786622,863343,923279,69510,68521,989,46,23,19/1/2022 7:23
7/7/2021,Phetchaburi,99,9319,482401,232827,249574,15182,15093,89,,,19/1/2022 7:23
7/7/2021,Phetchabun,19,420,979701,483282,496419,22759,22735,24,,,19/1/2022 7:23
7/7/2021,Loei,17,243,638517,320015,318502,4573,4565,8,28,9,19/1/2022 7:23
7/7/2021,Phrae,12,146,435659,209972,225687,5424,5424,0,28,11,19/1/2022 7:23
7/7/2021,Mae Hong Son,3,57,285729,144754,140975,9411,9186,225,27,6,19/1/2022 7:23
7/7/2021,,0,153,,,,,,,,,19/1/2022 7:23
8/7/2021,Krabi,87,654,478495,237646,240849,1716,1716,0,,,19/1/2022 7:23
8/7/2021,Bangkok,2233,113244,5551744,2605273,2946471,169121,147154,21967,51,28,19/1/2022 7:23
8/7/2021,Kanchanaburi,31,766,893118,447911,445207,26909,26862,47,20,6,19/1/2022 7:23
8/7/2021,Kalasin,27,374,976323,482572,493751,2495,2495,0,,,19/1/2022 7:23
8/7/2021,Kamphaeng Phet,36,496,712903,351973,360930,6317,6317,0,,,19/1/2022 7:23
8/7/2021,Khon Kaen,46,938,1792421,881179,911242,17954,17954,0,52,26,19/1/2022 7:23
8/7/2021,Chanthaburi,20,1635,535998,262065,273933,17139,17083,56,,,19/1/2022 7:23
8/7/2021,Chachoengsao,79,5667,722052,353870,368182,2359,2359,0,48,25,19/1/2022 7:23
8/7/2021,Chon Buri,291,12228,1579473,770979,808494,34619,34021,598,36,25,19/1/2022 7:23
8/7/2021,Chai Nat,11,189,321220,154391,166829,3194,3194,0,,,19/1/2022 7:23
8/7/2021,Chaiyaphum,66,670,1123243,554962,568281,6802,6802,0,,,19/1/2022 7:23
8/7/2021,Chumphon,16,230,509453,251448,258005,1865,1865,0,,,19/1/2022 7:23
8/7/2021,Trang,6,1720,640011,312941,327070,2288,2288,0,,,19/1/2022 7:23
8/7/2021,Trat,8,379,228415,112919,115496,17144,17038,106,,,19/1/2022 7:23
8/7/2021,Tak,48,1940,674330,340958,333372,13933,13933,0,,,19/1/2022 7:23
8/7/2021,Nakhon Nayok,25,731,259525,127999,131526,3515,3515,0,,,19/1/2022 7:23
8/7/2021,Nakhon Pathom,118,6102,922047,442945,479102,4047,4047,0,33,15,19/1/2022 7:23
8/7/2021,Nakhon Phanom,42,334,717065,357305,359760,4473,4473,0,,,19/1/2022 7:23
8/7/2021,Nakhon Ratchasima,49,1635,2633481,1294026,1339455,83136,82593,543,46,21,19/1/2022 7:23
8/7/2021,Nakhon Si Thammarat,25,1672,1549708,764609,785099,8425,8425,0,,,19/1/2022 7:23
8/7/2021,Nakhon Sawan,42,1003,1037270,506043,531227,14969,14969,0,48,31,19/1/2022 7:23
8/7/2021,Nonthaburi,180,21730,1284757,597804,686953,2156,2144,12,21,16,19/1/2022 7:23
8/7/2021,Narathiwat,53,2782,808277,399788,408489,474,474,0,56,19,19/1/2022 7:23
8/7/2021,Nan,7,180,475961,238094,237867,9841,9805,36,,,19/1/2022 7:23
8/7/2021,Bueng Kan,6,73,421989,211591,210398,2816,2816,0,,,19/1/2022 7:23
8/7/2021,Buri Ram,45,566,1579847,783934,795913,10752,10721,31,,,19/1/2022 7:23
8/7/2021,Pathum Thani,230,11245,1184541,561189,623352,1116,1103,13,53,25,19/1/2022 7:23
8/7/2021,Prachuap Khiri Khan,150,3266,552465,273938,278527,19918,19850,68,,,19/1/2022 7:23
8/7/2021,Prachin Buri,81,1082,494352,243985,250367,3384,3384,0,52,11,19/1/2022 7:23
8/7/2021,Pattani,179,3822,728613,359883,368730,585,585,0,,,19/1/2022 7:23
8/7/2021,Phra Nakhon Si Ayutthaya,63,3256,820077,393953,426124,21529,21302,227,23,31,19/1/2022 7:23
8/7/2021,Phayao,25,230,465591,226581,239010,8278,8278,0,31,11,19/1/2022 7:23
8/7/2021,Phang-nga,1,351,268377,133890,134487,5208,4622,586,,,19/1/2022 7:23
8/7/2021,Phatthalung,1,650,522778,254665,268113,1934,1934,0,,,19/1/2022 7:23
8/7/2021,Phichit,17,281,530608,258695,271913,6355,6355,0,,,19/1/2022 7:23
8/7/2021,Phitsanulok,18,532,847773,415064,432709,26075,25939,136,,,19/1/2022 7:23
8/7/2021,Phuket,4,985,417161,197202,219959,36699,20738,15961,55,24,19/1/2022 7:23
8/7/2021,Maha Sarakham,42,686,950326,465921,484405,2664,2664,0,,,19/1/2022 7:23
8/7/2021,Mukdahan,9,123,351129,175445,175684,5772,5772,0,,,19/1/2022 7:23
8/7/2021,Yala,146,3233,541400,269573,271827,529,529,0,62,25,19/1/2022 7:23
8/7/2021,Yasothon,30,302,533683,266331,267352,1497,1497,0,,,19/1/2022 7:23
8/7/2021,Ranong,8,1518,194637,98230,96407,1633,1633,0,,,19/1/2022 7:23
8/7/2021,Rayong,52,2746,748108,367475,380633,20171,19927,244,44,26,19/1/2022 7:23
8/7/2021,Ratchaburi,55,1999,869206,422658,446548,10667,10667,0,,,19/1/2022 7:23
8/7/2021,Roi Et,42,635,1296773,642509,654264,2573,2573,0,,,19/1/2022 7:23
8/7/2021,Lop Buri,55,824,740037,368792,371245,5956,5927,29,,,19/1/2022 7:23
8/7/2021,Lampang,16,342,726701,354158,372543,6122,5950,172,40,16,19/1/2022 7:23
8/7/2021,Lamphun,7,324,401619,193055,208564,6810,6725,85,,,19/1/2022 7:23
8/7/2021,Si Sa Ket,65,798,1457396,725574,731822,3604,3604,0,,,19/1/2022 7:23
8/7/2021,Sakon Nakhon,32,369,1146784,569879,576905,4796,4796,0,,,19/1/2022 7:23
8/7/2021,Songkhla,213,7619,1429789,696651,733138,1474,1474,0,63,29,19/1/2022 7:23
8/7/2021,Satun,5,222,324467,161491,162976,1839,1820,19,34,21,19/1/2022 7:23
8/7/2021,Samut Prakarn,574,21615,1355644,645919,709725,1526,1481,45,,,19/1/2022 7:23
8/7/2021,Samut Songkhram,18,867,191611,91527,100084,6501,6501,0,16,13,19/1/2022 7:23
8/7/2021,Samut Sakhon,540,28381,586567,282712,303855,861,861,0,62,28,19/1/2022 7:23
8/7/2021,Saraburi,68,2317,643513,316041,327472,7419,7401,18,55,67,19/1/2022 7:23
8/7/2021,Sa kaeo,22,1652,561275,280157,281118,2531,2531,0,35,16,19/1/2022 7:23
8/7/2021,Sing Buri,9,238,205218,97486,107732,2031,2031,0,,,19/1/2022 7:23
8/7/2021,Suphan Buri,75,1147,836800,403755,433045,9449,9449,0,,,19/1/2022 7:23
8/7/2021,Surat Thani,18,2178,1070296,526627,543669,3602,3188,414,51,18,19/1/2022 7:23
8/7/2021,Surin,68,645,1377078,685103,691975,7265,7252,13,,,19/1/2022 7:23
8/7/2021,Sukhothai,43,306,586111,283837,302274,5178,5003,175,,,19/1/2022 7:23
8/7/2021,Nong Khai,19,156,517035,256446,260589,8319,8316,3,27,12,19/1/2022 7:23
8/7/2021,Nong Bua Lam Phu,20,193,509092,253938,255154,2269,2269,0,,,19/1/2022 7:23
8/7/2021,Amnat Charoen,19,148,376294,187233,189061,1392,1392,0,,,19/1/2022 7:23
8/7/2021,Udon Thani,65,934,1567167,776285,790882,10132,10127,5,,,19/1/2022 7:23
8/7/2021,Uttaradit,14,218,447361,218107,229254,5713,5713,0,,,19/1/2022 7:23
8/7/2021,Uthai Thani,17,176,325339,159003,166336,2109,2109,0,,,19/1/2022 7:23
8/7/2021,Ubon Ratchathani,78,829,1867197,932136,935061,6431,6431,0,31,13,19/1/2022 7:23
8/7/2021,Ang Thong,36,603,275675,131918,143757,1386,1386,0,,,19/1/2022 7:23
8/7/2021,Chiang Rai,18,1168,1297041,630437,666604,25803,25572,231,32,9,19/1/2022 7:23
8/7/2021,Chiang Mai,29,8578,1786622,863343,923279,69510,68521,989,53,20,19/1/2022 7:23
8/7/2021,Phetchaburi,95,9414,482401,232827,249574,15182,15093,89,,,19/1/2022 7:23
8/7/2021,Phetchabun,39,459,979701,483282,496419,22759,22735,24,,,19/1/2022 7:23
8/7/2021,Loei,25,268,638517,320015,318502,4573,4565,8,16,11,19/1/2022 7:23
8/7/2021,Phrae,3,149,435659,209972,225687,5424,5424,0,36,10,19/1/2022 7:23
8/7/2021,Mae Hong Son,3,60,285729,144754,140975,9411,9186,225,24,5,19/1/2022 7:23
8/7/2021,,0,153,,,,,,,,,19/1/2022 7:23
9/7/2021,Krabi,40,694,478495,237646,240849,1716,1716,0,,,19/1/2022 7:23
9/7/2021,Bangkok,3149,116393,5551744,2605273,2946471,169121,147154,21967,48,20,19/1/2022 7:23
9/7/2021,Kanchanaburi,37,803,893118,447911,445207,26909,26862,47,22,9,19/1/2022 7:23
9/7/2021,Kalasin,26,400,976323,482572,493751,2495,2495,0,,,19/1/2022 7:23
9/7/2021,Kamphaeng Phet,38,534,712903,351973,360930,6317,6317,0,,,19/1/2022 7:23
9/7/2021,Khon Kaen,44,982,1792421,881179,911242,17954,17954,0,57,26,19/1/2022 7:23
9/7/2021,Chanthaburi,24,1659,535998,262065,273933,17139,17083,56,,,19/1/2022 7:23
9/7/2021,Chachoengsao,243,5910,722052,353870,368182,2359,2359,0,37,26,19/1/2022 7:23
9/7/2021,Chon Buri,317,12545,1579473,770979,808494,34619,34021,598,41,24,19/1/2022 7:23
9/7/2021,Chai Nat,5,194,321220,154391,166829,3194,3194,0,,,19/1/2022 7:23
9/7/2021,Chaiyaphum,61,731,1123243,554962,568281,6802,6802,0,,,19/1/2022 7:23
9/7/2021,Chumphon,15,245,509453,251448,258005,1865,1865,0,,,19/1/2022 7:23
9/7/2021,Trang,8,1728,640011,312941,327070,2288,2288,0,,,19/1/2022 7:23
9/7/2021,Trat,22,401,228415,112919,115496,17144,17038,106,,,19/1/2022 7:23
9/7/2021,Tak,53,1993,674330,340958,333372,13933,13933,0,,,19/1/2022 7:23
9/7/2021,Nakhon Nayok,46,777,259525,127999,131526,3515,3515,0,,,19/1/2022 7:23
9/7/2021,Nakhon Pathom,372,6474,922047,442945,479102,4047,4047,0,35,16,19/1/2022 7:23
9/7/2021,Nakhon Phanom,21,355,717065,357305,359760,4473,4473,0,,,19/1/2022 7:23
9/7/2021,Nakhon Ratchasima,108,1743,2633481,1294026,1339455,83136,82593,543,54,16,19/1/2022 7:23
9/7/2021,Nakhon Si Thammarat,32,1704,1549708,764609,785099,8425,8425,0,,,19/1/2022 7:23
9/7/2021,Nakhon Sawan,55,1058,1037270,506043,531227,14969,14969,0,61,23,19/1/2022 7:23
9/7/2021,Nonthaburi,236,21966,1284757,597804,686953,2156,2144,12,30,18,19/1/2022 7:23
9/7/2021,Narathiwat,79,2861,808277,399788,408489,474,474,0,37,14,19/1/2022 7:23
9/7/2021,Nan,4,184,475961,238094,237867,9841,9805,36,,,19/1/2022 7:23
9/7/2021,Bueng Kan,7,80,421989,211591,210398,2816,2816,0,,,19/1/2022 7:23
9/7/2021,Buri Ram,44,610,1579847,783934,795913,10752,10721,31,,,19/1/2022 7:23
9/7/2021,Pathum Thani,210,11455,1184541,561189,623352,1116,1103,13,58,32,19/1/2022 7:23
9/7/2021,Prachuap Khiri Khan,102,3368,552465,273938,278527,19918,19850,68,,,19/1/2022 7:23
9/7/2021,Prachin Buri,114,1196,494352,243985,250367,3384,3384,0,40,13,19/1/2022 7:23
9/7/2021,Pattani,214,4036,728613,359883,368730,585,585,0,,,19/1/2022 7:23
9/7/2021,Phra Nakhon Si Ayutthaya,265,3521,820077,393953,426124,21529,21302,227,30,31,19/1/2022 7:23
9/7/2021,Phayao,12,242,465591,226581,239010,8278,8278,0,21,12,19/1/2022 7:23
9/7/2021,Phang-nga,0,351,268377,133890,134487,5208,4622,586,,,19/1/2022 7:23
9/7/2021,Phatthalung,22,672,522778,254665,268113,1934,1934,0,,,19/1/2022 7:23
9/7/2021,Phichit,24,305,530608,258695,271913,6355,6355,0,,,19/1/2022 7:23
9/7/2021,Phitsanulok,38,570,847773,415064,432709,26075,25939,136,,,19/1/2022 7:23
9/7/2021,Phuket,7,992,417161,197202,219959,36699,20738,15961,49,20,19/1/2022 7:23
9/7/2021,Maha Sarakham,51,737,950326,465921,484405,2664,2664,0,,,19/1/2022 7:23
9/7/2021,Mukdahan,11,134,351129,175445,175684,5772,5772,0,,,19/1/2022 7:23
9/7/2021,Yala,154,3387,541400,269573,271827,529,529,0,54,18,19/1/2022 7:23
9/7/2021,Yasothon,25,327,533683,266331,267352,1497,1497,0,,,19/1/2022 7:23
9/7/2021,Ranong,13,1531,194637,98230,96407,1633,1633,0,,,19/1/2022 7:23
9/7/2021,Rayong,86,2832,748108,367475,380633,20171,19927,244,27,20,19/1/2022 7:23
9/7/2021,Ratchaburi,97,2096,869206,422658,446548,10667,10667,0,,,19/1/2022 7:23
9/7/2021,Roi Et,63,698,1296773,642509,654264,2573,2573,0,,,19/1/2022 7:23
9/7/2021,Lop Buri,341,1165,740037,368792,371245,5956,5927,29,,,19/1/2022 7:23
9/7/2021,Lampang,63,405,726701,354158,372543,6122,5950,172,36,18,19/1/2022 7:23
9/7/2021,Lamphun,1,325,401619,193055,208564,6810,6725,85,,,19/1/2022 7:23
9/7/2021,Si Sa Ket,43,841,1457396,725574,731822,3604,3604,0,,,19/1/2022 7:23
9/7/2021,Sakon Nakhon,21,390,1146784,569879,576905,4796,4796,0,,,19/1/2022 7:23
9/7/2021,Songkhla,216,7835,1429789,696651,733138,1474,1474,0,59,21,19/1/2022 7:23
9/7/2021,Satun,22,244,324467,161491,162976,1839,1820,19,32,17,19/1/2022 7:23
9/7/2021,Samut Prakarn,437,22052,1355644,645919,709725,1526,1481,45,,,19/1/2022 7:23
9/7/2021,Samut Songkhram,24,891,191611,91527,100084,6501,6501,0,23,10,19/1/2022 7:23
9/7/2021,Samut Sakhon,576,28957,586567,282712,303855,861,861,0,58,16,19/1/2022 7:23
9/7/2021,Saraburi,133,2450,643513,316041,327472,7419,7401,18,61,74,19/1/2022 7:23
9/7/2021,Sa kaeo,42,1694,561275,280157,281118,2531,2531,0,32,12,19/1/2022 7:23
9/7/2021,Sing Buri,23,261,205218,97486,107732,2031,2031,0,,,19/1/2022 7:23
9/7/2021,Suphan Buri,81,1228,836800,403755,433045,9449,9449,0,,,19/1/2022 7:23
9/7/2021,Surat Thani,7,2185,1070296,526627,543669,3602,3188,414,50,16,19/1/2022 7:23
9/7/2021,Surin,79,724,1377078,685103,691975,7265,7252,13,,,19/1/2022 7:23
9/7/2021,Sukhothai,42,348,586111,283837,302274,5178,5003,175,,,19/1/2022 7:23
9/7/2021,Nong Khai,21,177,517035,256446,260589,8319,8316,3,29,13,19/1/2022 7:23
9/7/2021,Nong Bua Lam Phu,31,224,509092,253938,255154,2269,2269,0,,,19/1/2022 7:23
9/7/2021,Amnat Charoen,15,163,376294,187233,189061,1392,1392,0,,,19/1/2022 7:23
9/7/2021,Udon Thani,59,993,1567167,776285,790882,10132,10127,5,,,19/1/2022 7:23
9/7/2021,Uttaradit,8,226,447361,218107,229254,5713,5713,0,,,19/1/2022 7:23
9/7/2021,Uthai Thani,17,193,325339,159003,166336,2109,2109,0,,,19/1/2022 7:23
9/7/2021,Ubon Ratchathani,65,894,1867197,932136,935061,6431,6431,0,28,16,19/1/2022 7:23
9/7/2021,Ang Thong,103,706,275675,131918,143757,1386,1386,0,,,19/1/2022 7:23
9/7/2021,Chiang Rai,19,1187,1297041,630437,666604,25803,25572,231,20,10,19/1/2022 7:23
9/7/2021,Chiang Mai,31,8609,1786622,863343,923279,69510,68521,989,48,26,19/1/2022 7:23
9/7/2021,Phetchaburi,98,9512,482401,232827,249574,15182,15093,89,,,19/1/2022 7:23
9/7/2021,Phetchabun,30,489,979701,483282,496419,22759,22735,24,,,19/1/2022 7:23
9/7/2021,Loei,25,293,638517,320015,318502,4573,4565,8,16,13,19/1/2022 7:23
9/7/2021,Phrae,7,156,435659,209972,225687,5424,5424,0,30,11,19/1/2022 7:23
9/7/2021,Mae Hong Son,2,62,285729,144754,140975,9411,9186,225,23,6,19/1/2022 7:23
9/7/2021,,0,153,,,,,,,,,19/1/2022 7:23
10/7/2021,Krabi,24,718,478495,237646,240849,1716,1716,0,,,19/1/2022 7:23
10/7/2021,Bangkok,3226,119619,5551744,2605273,2946471,169121,147154,21967,47,15,19/1/2022 7:23
10/7/2021,Kanchanaburi,31,834,893118,447911,445207,26909,26862,47,24,10,19/1/2022 7:23
10/7/2021,Kalasin,45,445,976323,482572,493751,2495,2495,0,,,19/1/2022 7:23
10/7/2021,Kamphaeng Phet,35,569,712903,351973,360930,6317,6317,0,,,19/1/2022 7:23
10/7/2021,Khon Kaen,50,1032,1792421,881179,911242,17954,17954,0,55,27,19/1/2022 7:23
10/7/2021,Chanthaburi,37,1696,535998,262065,273933,17139,17083,56,,,19/1/2022 7:23
10/7/2021,Chachoengsao,173,6083,722052,353870,368182,2359,2359,0,43,22,19/1/2022 7:23
10/7/2021,Chon Buri,361,12906,1579473,770979,808494,34619,34021,598,41,18,19/1/2022 7:23
10/7/2021,Chai Nat,22,216,321220,154391,166829,3194,3194,0,,,19/1/2022 7:23
10/7/2021,Chaiyaphum,53,784,1123243,554962,568281,6802,6802,0,,,19/1/2022 7:23
10/7/2021,Chumphon,6,251,509453,251448,258005,1865,1865,0,,,19/1/2022 7:23
10/7/2021,Trang,9,1737,640011,312941,327070,2288,2288,0,,,19/1/2022 7:23
10/7/2021,Trat,35,436,228415,112919,115496,17144,17038,106,,,19/1/2022 7:23
10/7/2021,Tak,41,2034,674330,340958,333372,13933,13933,0,,,19/1/2022 7:23
10/7/2021,Nakhon Nayok,54,831,259525,127999,131526,3515,3515,0,,,19/1/2022 7:23
10/7/2021,Nakhon Pathom,167,6641,922047,442945,479102,4047,4047,0,40,11,19/1/2022 7:23
10/7/2021,Nakhon Phanom,23,378,717065,357305,359760,4473,4473,0,,,19/1/2022 7:23
10/7/2021,Nakhon Ratchasima,81,1824,2633481,1294026,1339455,83136,82593,543,41,16,19/1/2022 7:23
10/7/2021,Nakhon Si Thammarat,25,1729,1549708,764609,785099,8425,8425,0,,,19/1/2022 7:23
10/7/2021,Nakhon Sawan,25,1083,1037270,506043,531227,14969,14969,0,48,18,19/1/2022 7:23
10/7/2021,Nonthaburi,334,22300,1284757,597804,686953,2156,2144,12,34,12,19/1/2022 7:23
10/7/2021,Narathiwat,90,2951,808277,399788,408489,474,474,0,24,17,19/1/2022 7:23
10/7/2021,Nan,9,193,475961,238094,237867,9841,9805,36,,,19/1/2022 7:23
10/7/2021,Bueng Kan,5,85,421989,211591,210398,2816,2816,0,,,19/1/2022 7:23
10/7/2021,Buri Ram,71,681,1579847,783934,795913,10752,10721,31,,,19/1/2022 7:23
10/7/2021,Pathum Thani,673,12128,1184541,561189,623352,1116,1103,13,56,26,19/1/2022 7:23
10/7/2021,Prachuap Khiri Khan,30,3398,552465,273938,278527,19918,19850,68,,,19/1/2022 7:23
10/7/2021,Prachin Buri,57,1253,494352,243985,250367,3384,3384,0,38,12,19/1/2022 7:23
10/7/2021,Pattani,173,4209,728613,359883,368730,585,585,0,,,19/1/2022 7:23
10/7/2021,Phra Nakhon Si Ayutthaya,52,3573,820077,393953,426124,21529,21302,227,30,25,19/1/2022 7:23
10/7/2021,Phayao,8,250,465591,226581,239010,8278,8278,0,24,13,19/1/2022 7:23
10/7/2021,Phang-nga,1,352,268377,133890,134487,5208,4622,586,,,19/1/2022 7:23
10/7/2021,Phatthalung,2,674,522778,254665,268113,1934,1934,0,,,19/1/2022 7:23
10/7/2021,Phichit,13,318,530608,258695,271913,6355,6355,0,,,19/1/2022 7:23
10/7/2021,Phitsanulok,38,608,847773,415064,432709,26075,25939,136,,,19/1/2022 7:23
10/7/2021,Phuket,10,1002,417161,197202,219959,36699,20738,15961,43,23,19/1/2022 7:23
10/7/2021,Maha Sarakham,56,793,950326,465921,484405,2664,2664,0,,,19/1/2022 7:23
10/7/2021,Mukdahan,25,159,351129,175445,175684,5772,5772,0,,,19/1/2022 7:23
10/7/2021,Yala,158,3545,541400,269573,271827,529,529,0,38,14,19/1/2022 7:23
10/7/2021,Yasothon,28,355,533683,266331,267352,1497,1497,0,,,19/1/2022 7:23
10/7/2021,Ranong,12,1543,194637,98230,96407,1633,1633,0,,,19/1/2022 7:23
10/7/2021,Rayong,74,2906,748108,367475,380633,20171,19927,244,22,23,19/1/2022 7:23
10/7/2021,Ratchaburi,123,2219,869206,422658,446548,10667,10667,0,,,19/1/2022 7:23
10/7/2021,Roi Et,52,750,1296773,642509,654264,2573,2573,0,,,19/1/2022 7:23
10/7/2021,Lop Buri,207,1372,740037,368792,371245,5956,5927,29,,,19/1/2022 7:23
10/7/2021,Lampang,46,451,726701,354158,372543,6122,5950,172,49,17,19/1/2022 7:23
10/7/2021,Lamphun,7,332,401619,193055,208564,6810,6725,85,,,19/1/2022 7:23
10/7/2021,Si Sa Ket,38,879,1457396,725574,731822,3604,3604,0,,,19/1/2022 7:23
10/7/2021,Sakon Nakhon,65,455,1146784,569879,576905,4796,4796,0,,,19/1/2022 7:23
10/7/2021,Songkhla,225,8060,1429789,696651,733138,1474,1474,0,39,21,19/1/2022 7:23
10/7/2021,Satun,4,248,324467,161491,162976,1839,1820,19,27,20,19/1/2022 7:23
10/7/2021,Samut Prakarn,695,22747,1355644,645919,709725,1526,1481,45,,,19/1/2022 7:23
10/7/2021,Samut Songkhram,24,915,191611,91527,100084,6501,6501,0,22,7,19/1/2022 7:23
10/7/2021,Samut Sakhon,574,29531,586567,282712,303855,861,861,0,37,18,19/1/2022 7:23
10/7/2021,Saraburi,175,2625,643513,316041,327472,7419,7401,18,67,44,19/1/2022 7:23
10/7/2021,Sa kaeo,16,1710,561275,280157,281118,2531,2531,0,20,12,19/1/2022 7:23
10/7/2021,Sing Buri,24,285,205218,97486,107732,2031,2031,0,,,19/1/2022 7:23
10/7/2021,Suphan Buri,94,1322,836800,403755,433045,9449,9449,0,,,19/1/2022 7:23
10/7/2021,Surat Thani,20,2205,1070296,526627,543669,3602,3188,414,44,18,19/1/2022 7:23
10/7/2021,Surin,61,785,1377078,685103,691975,7265,7252,13,,,19/1/2022 7:23
10/7/2021,Sukhothai,16,364,586111,283837,302274,5178,5003,175,,,19/1/2022 7:23
10/7/2021,Nong Khai,15,192,517035,256446,260589,8319,8316,3,32,12,19/1/2022 7:23
10/7/2021,Nong Bua Lam Phu,22,246,509092,253938,255154,2269,2269,0,,,19/1/2022 7:23
10/7/2021,Amnat Charoen,25,188,376294,187233,189061,1392,1392,0,,,19/1/2022 7:23
10/7/2021,Udon Thani,50,1043,1567167,776285,790882,10132,10127,5,,,19/1/2022 7:23
10/7/2021,Uttaradit,8,234,447361,218107,229254,5713,5713,0,,,19/1/2022 7:23
10/7/2021,Uthai Thani,20,213,325339,159003,166336,2109,2109,0,,,19/1/2022 7:23
10/7/2021,Ubon Ratchathani,56,950,1867197,932136,935061,6431,6431,0,38,25,19/1/2022 7:23
10/7/2021,Ang Thong,38,744,275675,131918,143757,1386,1386,0,,,19/1/2022 7:23
10/7/2021,Chiang Rai,19,1206,1297041,630437,666604,25803,25572,231,21,12,19/1/2022 7:23
10/7/2021,Chiang Mai,30,8639,1786622,863343,923279,69510,68521,989,47,19,19/1/2022 7:23
10/7/2021,Phetchaburi,91,9603,482401,232827,249574,15182,15093,89,,,19/1/2022 7:23
10/7/2021,Phetchabun,21,510,979701,483282,496419,22759,22735,24,,,19/1/2022 7:23
10/7/2021,Loei,14,307,638517,320015,318502,4573,4565,8,20,13,19/1/2022 7:23
10/7/2021,Phrae,8,164,435659,209972,225687,5424,5424,0,30,12,19/1/2022 7:23
10/7/2021,Mae Hong Son,1,63,285729,144754,140975,9411,9186,225,26,4,19/1/2022 7:23
10/7/2021,,0,153,,,,,,,,,19/1/2022 7:23
11/7/2021,Krabi,42,760,478495,237646,240849,1716,1716,0,,,19/1/2022 7:23
11/7/2021,Bangkok,2751,122370,5551744,2605273,2946471,169121,147154,21967,34,17,19/1/2022 7:23
11/7/2021,Kanchanaburi,52,886,893118,447911,445207,26909,26862,47,24,16,19/1/2022 7:23
11/7/2021,Kalasin,65,510,976323,482572,493751,2495,2495,0,,,19/1/2022 7:23
11/7/2021,Kamphaeng Phet,58,627,712903,351973,360930,6317,6317,0,,,19/1/2022 7:23
11/7/2021,Khon Kaen,52,1084,1792421,881179,911242,17954,17954,0,56,31,19/1/2022 7:23
11/7/2021,Chanthaburi,40,1736,535998,262065,273933,17139,17083,56,,,19/1/2022 7:23
11/7/2021,Chachoengsao,170,6253,722052,353870,368182,2359,2359,0,20,29,19/1/2022 7:23
11/7/2021,Chon Buri,381,13287,1579473,770979,808494,34619,34021,598,35,31,19/1/2022 7:23
11/7/2021,Chai Nat,15,231,321220,154391,166829,3194,3194,0,,,19/1/2022 7:23
11/7/2021,Chaiyaphum,42,826,1123243,554962,568281,6802,6802,0,,,19/1/2022 7:23
11/7/2021,Chumphon,13,264,509453,251448,258005,1865,1865,0,,,19/1/2022 7:23
11/7/2021,Trang,6,1743,640011,312941,327070,2288,2288,0,,,19/1/2022 7:23
11/7/2021,Trat,21,457,228415,112919,115496,17144,17038,106,,,19/1/2022 7:23
11/7/2021,Tak,46,2080,674330,340958,333372,13933,13933,0,,,19/1/2022 7:23
11/7/2021,Nakhon Nayok,44,875,259525,127999,131526,3515,3515,0,,,19/1/2022 7:23
11/7/2021,Nakhon Pathom,150,6791,922047,442945,479102,4047,4047,0,23,13,19/1/2022 7:23
11/7/2021,Nakhon Phanom,36,414,717065,357305,359760,4473,4473,0,,,19/1/2022 7:23
11/7/2021,Nakhon Ratchasima,52,1876,2633481,1294026,1339455,83136,82593,543,39,24,19/1/2022 7:23
11/7/2021,Nakhon Si Thammarat,36,1765,1549708,764609,785099,8425,8425,0,,,19/1/2022 7:23
11/7/2021,Nakhon Sawan,33,1116,1037270,506043,531227,14969,14969,0,35,27,19/1/2022 7:23
11/7/2021,Nonthaburi,338,22638,1284757,597804,686953,2156,2144,12,17,11,19/1/2022 7:23
11/7/2021,Narathiwat,91,3042,808277,399788,408489,474,474,0,31,20,19/1/2022 7:23
11/7/2021,Nan,20,213,475961,238094,237867,9841,9805,36,,,19/1/2022 7:23
11/7/2021,Bueng Kan,2,87,421989,211591,210398,2816,2816,0,,,19/1/2022 7:23
11/7/2021,Buri Ram,58,739,1579847,783934,795913,10752,10721,31,,,19/1/2022 7:23
11/7/2021,Pathum Thani,1111,13239,1184541,561189,623352,1116,1103,13,41,19,19/1/2022 7:23
11/7/2021,Prachuap Khiri Khan,35,3433,552465,273938,278527,19918,19850,68,,,19/1/2022 7:23
11/7/2021,Prachin Buri,42,1295,494352,243985,250367,3384,3384,0,36,23,19/1/2022 7:23
11/7/2021,Pattani,216,4425,728613,359883,368730,585,585,0,,,19/1/2022 7:23
11/7/2021,Phra Nakhon Si Ayutthaya,101,3674,820077,393953,426124,21529,21302,227,18,34,19/1/2022 7:23
11/7/2021,Phayao,9,259,465591,226581,239010,8278,8278,0,24,16,19/1/2022 7:23
11/7/2021,Phang-nga,5,357,268377,133890,134487,5208,4622,586,,,19/1/2022 7:23
11/7/2021,Phatthalung,10,684,522778,254665,268113,1934,1934,0,,,19/1/2022 7:23
11/7/2021,Phichit,14,332,530608,258695,271913,6355,6355,0,,,19/1/2022 7:23
11/7/2021,Phitsanulok,31,639,847773,415064,432709,26075,25939,136,,,19/1/2022 7:23
11/7/2021,Phuket,9,1011,417161,197202,219959,36699,20738,15961,49,31,19/1/2022 7:23
11/7/2021,Maha Sarakham,52,845,950326,465921,484405,2664,2664,0,,,19/1/2022 7:23
11/7/2021,Mukdahan,23,182,351129,175445,175684,5772,5772,0,,,19/1/2022 7:23
11/7/2021,Yala,157,3702,541400,269573,271827,529,529,0,33,23,19/1/2022 7:23
11/7/2021,Yasothon,29,384,533683,266331,267352,1497,1497,0,,,19/1/2022 7:23
11/7/2021,Ranong,12,1555,194637,98230,96407,1633,1633,0,,,19/1/2022 7:23
11/7/2021,Rayong,67,2973,748108,367475,380633,20171,19927,244,26,27,19/1/2022 7:23
11/7/2021,Ratchaburi,112,2331,869206,422658,446548,10667,10667,0,,,19/1/2022 7:23
11/7/2021,Roi Et,59,809,1296773,642509,654264,2573,2573,0,,,19/1/2022 7:23
11/7/2021,Lop Buri,123,1495,740037,368792,371245,5956,5927,29,,,19/1/2022 7:23
11/7/2021,Lampang,38,489,726701,354158,372543,6122,5950,172,44,18,19/1/2022 7:23
11/7/2021,Lamphun,2,334,401619,193055,208564,6810,6725,85,,,19/1/2022 7:23
11/7/2021,Si Sa Ket,90,969,1457396,725574,731822,3604,3604,0,,,19/1/2022 7:23
11/7/2021,Sakon Nakhon,35,490,1146784,569879,576905,4796,4796,0,,,19/1/2022 7:23
11/7/2021,Songkhla,253,8313,1429789,696651,733138,1474,1474,0,41,32,19/1/2022 7:23
11/7/2021,Satun,5,253,324467,161491,162976,1839,1820,19,39,28,19/1/2022 7:23
11/7/2021,Samut Prakarn,664,23411,1355644,645919,709725,1526,1481,45,,,19/1/2022 7:23
11/7/2021,Samut Songkhram,24,939,191611,91527,100084,6501,6501,0,13,12,19/1/2022 7:23
11/7/2021,Samut Sakhon,603,30134,586567,282712,303855,861,861,0,30,24,19/1/2022 7:23
11/7/2021,Saraburi,178,2803,643513,316041,327472,7419,7401,18,39,52,19/1/2022 7:23
11/7/2021,Sa kaeo,46,1756,561275,280157,281118,2531,2531,0,24,14,19/1/2022 7:23
11/7/2021,Sing Buri,8,293,205218,97486,107732,2031,2031,0,,,19/1/2022 7:23
11/7/2021,Suphan Buri,86,1408,836800,403755,433045,9449,9449,0,,,19/1/2022 7:23
11/7/2021,Surat Thani,31,2236,1070296,526627,543669,3602,3188,414,43,21,19/1/2022 7:23
11/7/2021,Surin,162,947,1377078,685103,691975,7265,7252,13,,,19/1/2022 7:23
11/7/2021,Sukhothai,42,406,586111,283837,302274,5178,5003,175,,,19/1/2022 7:23
11/7/2021,Nong Khai,15,207,517035,256446,260589,8319,8316,3,30,12,19/1/2022 7:23
11/7/2021,Nong Bua Lam Phu,35,281,509092,253938,255154,2269,2269,0,,,19/1/2022 7:23
11/7/2021,Amnat Charoen,9,197,376294,187233,189061,1392,1392,0,,,19/1/2022 7:23
11/7/2021,Udon Thani,53,1096,1567167,776285,790882,10132,10127,5,,,19/1/2022 7:23
11/7/2021,Uttaradit,16,250,447361,218107,229254,5713,5713,0,,,19/1/2022 7:23
11/7/2021,Uthai Thani,18,231,325339,159003,166336,2109,2109,0,,,19/1/2022 7:23
11/7/2021,Ubon Ratchathani,81,1031,1867197,932136,935061,6431,6431,0,58,21,19/1/2022 7:23
11/7/2021,Ang Thong,37,781,275675,131918,143757,1386,1386,0,,,19/1/2022 7:23
11/7/2021,Chiang Rai,18,1224,1297041,630437,666604,25803,25572,231,24,11,19/1/2022 7:23
11/7/2021,Chiang Mai,31,8670,1786622,863343,923279,69510,68521,989,42,19,19/1/2022 7:23
11/7/2021,Phetchaburi,52,9655,482401,232827,249574,15182,15093,89,,,19/1/2022 7:23
11/7/2021,Phetchabun,48,558,979701,483282,496419,22759,22735,24,,,19/1/2022 7:23
11/7/2021,Loei,18,325,638517,320015,318502,4573,4565,8,25,14,19/1/2022 7:23
11/7/2021,Phrae,8,172,435659,209972,225687,5424,5424,0,27,17,19/1/2022 7:23
11/7/2021,Mae Hong Son,2,65,285729,144754,140975,9411,9186,225,17,5,19/1/2022 7:23
11/7/2021,,0,153,,,,,,,,,19/1/2022 7:23
12/7/2021,Krabi,27,787,478495,237646,240849,1716,1716,0,,,19/1/2022 7:23
12/7/2021,Bangkok,2401,124771,5551744,2605273,2946471,169121,147154,21967,33,25,19/1/2022 7:23
12/7/2021,Kanchanaburi,62,948,893118,447911,445207,26909,26862,47,22,10,19/1/2022 7:23
12/7/2021,Kalasin,40,550,976323,482572,493751,2495,2495,0,,,19/1/2022 7:23
12/7/2021,Kamphaeng Phet,52,679,712903,351973,360930,6317,6317,0,,,19/1/2022 7:23
12/7/2021,Khon Kaen,74,1158,1792421,881179,911242,17954,17954,0,60,69,19/1/2022 7:23
12/7/2021,Chanthaburi,13,1749,535998,262065,273933,17139,17083,56,,,19/1/2022 7:23
12/7/2021,Chachoengsao,129,6382,722052,353870,368182,2359,2359,0,40,32,19/1/2022 7:23
12/7/2021,Chon Buri,399,13686,1579473,770979,808494,34619,34021,598,43,37,19/1/2022 7:23
12/7/2021,Chai Nat,13,244,321220,154391,166829,3194,3194,0,,,19/1/2022 7:23
12/7/2021,Chaiyaphum,77,903,1123243,554962,568281,6802,6802,0,,,19/1/2022 7:23
12/7/2021,Chumphon,10,274,509453,251448,258005,1865,1865,0,,,19/1/2022 7:23
12/7/2021,Trang,11,1754,640011,312941,327070,2288,2288,0,,,19/1/2022 7:23
12/7/2021,Trat,25,482,228415,112919,115496,17144,17038,106,,,19/1/2022 7:23
12/7/2021,Tak,25,2105,674330,340958,333372,13933,13933,0,,,19/1/2022 7:23
12/7/2021,Nakhon Nayok,68,943,259525,127999,131526,3515,3515,0,,,19/1/2022 7:23
12/7/2021,Nakhon Pathom,315,7106,922047,442945,479102,4047,4047,0,33,16,19/1/2022 7:23
12/7/2021,Nakhon Phanom,63,477,717065,357305,359760,4473,4473,0,,,19/1/2022 7:23
12/7/2021,Nakhon Ratchasima,123,1999,2633481,1294026,1339455,83136,82593,543,53,26,19/1/2022 7:23
12/7/2021,Nakhon Si Thammarat,21,1786,1549708,764609,785099,8425,8425,0,,,19/1/2022 7:23
12/7/2021,Nakhon Sawan,77,1193,1037270,506043,531227,14969,14969,0,55,28,19/1/2022 7:23
12/7/2021,Nonthaburi,313,22951,1284757,597804,686953,2156,2144,12,17,15,19/1/2022 7:23
12/7/2021,Narathiwat,85,3127,808277,399788,408489,474,474,0,34,24,19/1/2022 7:23
12/7/2021,Nan,38,251,475961,238094,237867,9841,9805,36,,,19/1/2022 7:23
12/7/2021,Bueng Kan,8,95,421989,211591,210398,2816,2816,0,,,19/1/2022 7:23
12/7/2021,Buri Ram,87,826,1579847,783934,795913,10752,10721,31,,,19/1/2022 7:23
12/7/2021,Pathum Thani,398,13637,1184541,561189,623352,1116,1103,13,30,22,19/1/2022 7:23
12/7/2021,Prachuap Khiri Khan,79,3512,552465,273938,278527,19918,19850,68,,,19/1/2022 7:23
12/7/2021,Prachin Buri,82,1377,494352,243985,250367,3384,3384,0,53,30,19/1/2022 7:23
12/7/2021,Pattani,219,4644,728613,359883,368730,585,585,0,,,19/1/2022 7:23
12/7/2021,Phra Nakhon Si Ayutthaya,98,3772,820077,393953,426124,21529,21302,227,30,37,19/1/2022 7:23
12/7/2021,Phayao,17,276,465591,226581,239010,8278,8278,0,26,16,19/1/2022 7:23
12/7/2021,Phang-nga,7,364,268377,133890,134487,5208,4622,586,,,19/1/2022 7:23
12/7/2021,Phatthalung,13,697,522778,254665,268113,1934,1934,0,,,19/1/2022 7:23
12/7/2021,Phichit,30,362,530608,258695,271913,6355,6355,0,,,19/1/2022 7:23
12/7/2021,Phitsanulok,17,656,847773,415064,432709,26075,25939,136,,,19/1/2022 7:23
12/7/2021,Phuket,8,1019,417161,197202,219959,36699,20738,15961,54,37,19/1/2022 7:23
12/7/2021,Maha Sarakham,50,895,950326,465921,484405,2664,2664,0,,,19/1/2022 7:23
12/7/2021,Mukdahan,11,193,351129,175445,175684,5772,5772,0,,,19/1/2022 7:23
12/7/2021,Yala,201,3903,541400,269573,271827,529,529,0,44,28,19/1/2022 7:23
12/7/2021,Yasothon,36,420,533683,266331,267352,1497,1497,0,,,19/1/2022 7:23
12/7/2021,Ranong,11,1566,194637,98230,96407,1633,1633,0,,,19/1/2022 7:23
12/7/2021,Rayong,88,3061,748108,367475,380633,20171,19927,244,34,37,19/1/2022 7:23
12/7/2021,Ratchaburi,158,2489,869206,422658,446548,10667,10667,0,,,19/1/2022 7:23
12/7/2021,Roi Et,63,872,1296773,642509,654264,2573,2573,0,,,19/1/2022 7:23
12/7/2021,Lop Buri,87,1582,740037,368792,371245,5956,5927,29,,,19/1/2022 7:23
12/7/2021,Lampang,21,510,726701,354158,372543,6122,5950,172,48,19,19/1/2022 7:23
12/7/2021,Lamphun,4,338,401619,193055,208564,6810,6725,85,,,19/1/2022 7:23
12/7/2021,Si Sa Ket,104,1073,1457396,725574,731822,3604,3604,0,,,19/1/2022 7:23
12/7/2021,Sakon Nakhon,48,538,1146784,569879,576905,4796,4796,0,,,19/1/2022 7:23
12/7/2021,Songkhla,194,8507,1429789,696651,733138,1474,1474,0,60,29,19/1/2022 7:23
12/7/2021,Satun,9,262,324467,161491,162976,1839,1820,19,49,35,19/1/2022 7:23
12/7/2021,Samut Prakarn,434,23845,1355644,645919,709725,1526,1481,45,,,19/1/2022 7:23
12/7/2021,Samut Songkhram,29,968,191611,91527,100084,6501,6501,0,23,14,19/1/2022 7:23
12/7/2021,Samut Sakhon,625,30759,586567,282712,303855,861,861,0,38,37,19/1/2022 7:23
12/7/2021,Saraburi,115,2918,643513,316041,327472,7419,7401,18,57,58,19/1/2022 7:23
12/7/2021,Sa kaeo,46,1802,561275,280157,281118,2531,2531,0,23,16,19/1/2022 7:23
12/7/2021,Sing Buri,16,309,205218,97486,107732,2031,2031,0,,,19/1/2022 7:23
12/7/2021,Suphan Buri,69,1477,836800,403755,433045,9449,9449,0,,,19/1/2022 7:23
12/7/2021,Surat Thani,27,2263,1070296,526627,543669,3602,3188,414,47,29,19/1/2022 7:23
12/7/2021,Surin,115,1062,1377078,685103,691975,7265,7252,13,,,19/1/2022 7:23
12/7/2021,Sukhothai,18,424,586111,283837,302274,5178,5003,175,,,19/1/2022 7:23
12/7/2021,Nong Khai,3,210,517035,256446,260589,8319,8316,3,29,13,19/1/2022 7:23
12/7/2021,Nong Bua Lam Phu,31,312,509092,253938,255154,2269,2269,0,,,19/1/2022 7:23
12/7/2021,Amnat Charoen,13,210,376294,187233,189061,1392,1392,0,,,19/1/2022 7:23
12/7/2021,Udon Thani,105,1201,1567167,776285,790882,10132,10127,5,,,19/1/2022 7:23
12/7/2021,Uttaradit,26,276,447361,218107,229254,5713,5713,0,,,19/1/2022 7:23
12/7/2021,Uthai Thani,23,254,325339,159003,166336,2109,2109,0,,,19/1/2022 7:23
12/7/2021,Ubon Ratchathani,63,1094,1867197,932136,935061,6431,6431,0,49,20,19/1/2022 7:23
12/7/2021,Ang Thong,75,856,275675,131918,143757,1386,1386,0,,,19/1/2022 7:23
12/7/2021,Chiang Rai,20,1244,1297041,630437,666604,25803,25572,231,23,6,19/1/2022 7:23
12/7/2021,Chiang Mai,31,8701,1786622,863343,923279,69510,68521,989,44,21,19/1/2022 7:23
12/7/2021,Phetchaburi,91,9746,482401,232827,249574,15182,15093,89,,,19/1/2022 7:23
12/7/2021,Phetchabun,31,589,979701,483282,496419,22759,22735,24,,,19/1/2022 7:23
12/7/2021,Loei,19,344,638517,320015,318502,4573,4565,8,24,14,19/1/2022 7:23
12/7/2021,Phrae,18,190,435659,209972,225687,5424,5424,0,36,17,19/1/2022 7:23
12/7/2021,Mae Hong Son,4,69,285729,144754,140975,9411,9186,225,20,5,19/1/2022 7:23
12/7/2021,,0,153,,,,,,,,,19/1/2022 7:23
13/7/2021,Krabi,75,862,478495,237646,240849,1716,1716,0,,,19/1/2022 7:23
13/7/2021,Bangkok,2643,127414,5551744,2605273,2946471,169121,147154,21967,54,33,19/1/2022 7:23
13/7/2021,Kanchanaburi,48,996,893118,447911,445207,26909,26862,47,21,14,19/1/2022 7:23
13/7/2021,Kalasin,62,612,976323,482572,493751,2495,2495,0,,,19/1/2022 7:23
13/7/2021,Kamphaeng Phet,38,717,712903,351973,360930,6317,6317,0,,,19/1/2022 7:23
13/7/2021,Khon Kaen,78,1236,1792421,881179,911242,17954,17954,0,98,33,19/1/2022 7:23
13/7/2021,Chanthaburi,22,1771,535998,262065,273933,17139,17083,56,,,19/1/2022 7:23
13/7/2021,Chachoengsao,93,6475,722052,353870,368182,2359,2359,0,55,32,19/1/2022 7:23
13/7/2021,Chon Buri,460,14146,1579473,770979,808494,34619,34021,598,59,35,19/1/2022 7:23
13/7/2021,Chai Nat,21,265,321220,154391,166829,3194,3194,0,,,19/1/2022 7:23
13/7/2021,Chaiyaphum,54,957,1123243,554962,568281,6802,6802,0,,,19/1/2022 7:23
13/7/2021,Chumphon,13,287,509453,251448,258005,1865,1865,0,,,19/1/2022 7:23
13/7/2021,Trang,10,1764,640011,312941,327070,2288,2288,0,,,19/1/2022 7:23
13/7/2021,Trat,15,497,228415,112919,115496,17144,17038,106,,,19/1/2022 7:23
13/7/2021,Tak,68,2173,674330,340958,333372,13933,13933,0,,,19/1/2022 7:23
13/7/2021,Nakhon Nayok,75,1018,259525,127999,131526,3515,3515,0,,,19/1/2022 7:23
13/7/2021,Nakhon Pathom,177,7283,922047,442945,479102,4047,4047,0,43,19,19/1/2022 7:23
13/7/2021,Nakhon Phanom,51,528,717065,357305,359760,4473,4473,0,,,19/1/2022 7:23
13/7/2021,Nakhon Ratchasima,101,2100,2633481,1294026,1339455,83136,82593,543,59,25,19/1/2022 7:23
13/7/2021,Nakhon Si Thammarat,67,1853,1549708,764609,785099,8425,8425,0,,,19/1/2022 7:23
13/7/2021,Nakhon Sawan,58,1251,1037270,506043,531227,14969,14969,0,55,30,19/1/2022 7:23
13/7/2021,Nonthaburi,537,23488,1284757,597804,686953,2156,2144,12,30,25,19/1/2022 7:23
13/7/2021,Narathiwat,178,3305,808277,399788,408489,474,474,0,51,23,19/1/2022 7:23
13/7/2021,Nan,25,276,475961,238094,237867,9841,9805,36,,,19/1/2022 7:23
13/7/2021,Bueng Kan,21,116,421989,211591,210398,2816,2816,0,,,19/1/2022 7:23
13/7/2021,Buri Ram,109,935,1579847,783934,795913,10752,10721,31,,,19/1/2022 7:23
13/7/2021,Pathum Thani,189,13826,1184541,561189,623352,1116,1103,13,41,38,19/1/2022 7:23
13/7/2021,Prachuap Khiri Khan,99,3611,552465,273938,278527,19918,19850,68,,,19/1/2022 7:23
13/7/2021,Prachin Buri,71,1448,494352,243985,250367,3384,3384,0,68,28,19/1/2022 7:23
13/7/2021,Pattani,95,4739,728613,359883,368730,585,585,0,,,19/1/2022 7:23
13/7/2021,Phra Nakhon Si Ayutthaya,73,3845,820077,393953,426124,21529,21302,227,42,40,19/1/2022 7:23
13/7/2021,Phayao,10,286,465591,226581,239010,8278,8278,0,38,20,19/1/2022 7:23
13/7/2021,Phang-nga,23,387,268377,133890,134487,5208,4622,586,,,19/1/2022 7:23
13/7/2021,Phatthalung,4,701,522778,254665,268113,1934,1934,0,,,19/1/2022 7:23
13/7/2021,Phichit,15,377,530608,258695,271913,6355,6355,0,,,19/1/2022 7:23
13/7/2021,Phitsanulok,27,683,847773,415064,432709,26075,25939,136,,,19/1/2022 7:23
13/7/2021,Phuket,1,1020,417161,197202,219959,36699,20738,15961,65,29,19/1/2022 7:23
13/7/2021,Maha Sarakham,53,948,950326,465921,484405,2664,2664,0,,,19/1/2022 7:23
13/7/2021,Mukdahan,12,205,351129,175445,175684,5772,5772,0,,,19/1/2022 7:23
13/7/2021,Yala,112,4015,541400,269573,271827,529,529,0,59,25,19/1/2022 7:23
13/7/2021,Yasothon,16,436,533683,266331,267352,1497,1497,0,,,19/1/2022 7:23
13/7/2021,Ranong,11,1577,194637,98230,96407,1633,1633,0,,,19/1/2022 7:23
13/7/2021,Rayong,96,3157,748108,367475,380633,20171,19927,244,47,29,19/1/2022 7:23
13/7/2021,Ratchaburi,88,2577,869206,422658,446548,10667,10667,0,,,19/1/2022 7:23
13/7/2021,Roi Et,72,944,1296773,642509,654264,2573,2573,0,,,19/1/2022 7:23
13/7/2021,Lop Buri,50,1632,740037,368792,371245,5956,5927,29,,,19/1/2022 7:23
13/7/2021,Lampang,13,523,726701,354158,372543,6122,5950,172,43,22,19/1/2022 7:23
13/7/2021,Lamphun,3,341,401619,193055,208564,6810,6725,85,,,19/1/2022 7:23
13/7/2021,Si Sa Ket,87,1160,1457396,725574,731822,3604,3604,0,,,19/1/2022 7:23
13/7/2021,Sakon Nakhon,48,586,1146784,569879,576905,4796,4796,0,,,19/1/2022 7:23
13/7/2021,Songkhla,151,8658,1429789,696651,733138,1474,1474,0,56,34,19/1/2022 7:23
13/7/2021,Satun,20,282,324467,161491,162976,1839,1820,19,67,24,19/1/2022 7:23
13/7/2021,Samut Prakarn,529,24374,1355644,645919,709725,1526,1481,45,,,19/1/2022 7:23
13/7/2021,Samut Songkhram,24,992,191611,91527,100084,6501,6501,0,27,19,19/1/2022 7:23
13/7/2021,Samut Sakhon,574,31333,586567,282712,303855,861,861,0,69,38,19/1/2022 7:23
13/7/2021,Saraburi,51,2969,643513,316041,327472,7419,7401,18,72,57,19/1/2022 7:23
13/7/2021,Sa kaeo,51,1853,561275,280157,281118,2531,2531,0,34,17,19/1/2022 7:23
13/7/2021,Sing Buri,16,325,205218,97486,107732,2031,2031,0,,,19/1/2022 7:23
13/7/2021,Suphan Buri,168,1645,836800,403755,433045,9449,9449,0,,,19/1/2022 7:23
13/7/2021,Surat Thani,27,2290,1070296,526627,543669,3602,3188,414,52,32,19/1/2022 7:23
13/7/2021,Surin,118,1180,1377078,685103,691975,7265,7252,13,,,19/1/2022 7:23
13/7/2021,Sukhothai,24,448,586111,283837,302274,5178,5003,175,,,19/1/2022 7:23
13/7/2021,Nong Khai,15,225,517035,256446,260589,8319,8316,3,32,11,19/1/2022 7:23
13/7/2021,Nong Bua Lam Phu,16,328,509092,253938,255154,2269,2269,0,,,19/1/2022 7:23
13/7/2021,Amnat Charoen,21,231,376294,187233,189061,1392,1392,0,,,19/1/2022 7:23
13/7/2021,Udon Thani,126,1327,1567167,776285,790882,10132,10127,5,,,19/1/2022 7:23
13/7/2021,Uttaradit,28,304,447361,218107,229254,5713,5713,0,,,19/1/2022 7:23
13/7/2021,Uthai Thani,9,263,325339,159003,166336,2109,2109,0,,,19/1/2022 7:23
13/7/2021,Ubon Ratchathani,82,1176,1867197,932136,935061,6431,6431,0,47,15,19/1/2022 7:23
13/7/2021,Ang Thong,51,907,275675,131918,143757,1386,1386,0,,,19/1/2022 7:23
13/7/2021,Chiang Rai,18,1262,1297041,630437,666604,25803,25572,231,19,4,19/1/2022 7:23
13/7/2021,Chiang Mai,19,8720,1786622,863343,923279,69510,68521,989,43,20,19/1/2022 7:23
13/7/2021,Phetchaburi,82,9828,482401,232827,249574,15182,15093,89,,,19/1/2022 7:23
13/7/2021,Phetchabun,48,637,979701,483282,496419,22759,22735,24,,,19/1/2022 7:23
13/7/2021,Loei,32,376,638517,320015,318502,4573,4565,8,24,17,19/1/2022 7:23
13/7/2021,Phrae,17,207,435659,209972,225687,5424,5424,0,41,19,19/1/2022 7:23
13/7/2021,Mae Hong Son,1,70,285729,144754,140975,9411,9186,225,24,3,19/1/2022 7:23
13/7/2021,,0,153,,,,,,,,,19/1/2022 7:23
14/7/2021,Krabi,33,895,478495,237646,240849,1716,1716,0,,,19/1/2022 7:23
14/7/2021,Bangkok,2338,129752,5551744,2605273,2946471,169121,147154,21967,67,24,19/1/2022 7:23
14/7/2021,Kanchanaburi,39,1035,893118,447911,445207,26909,26862,47,27,10,19/1/2022 7:23
14/7/2021,Kalasin,66,678,976323,482572,493751,2495,2495,0,,,19/1/2022 7:23
14/7/2021,Kamphaeng Phet,54,771,712903,351973,360930,6317,6317,0,,,19/1/2022 7:23
14/7/2021,Khon Kaen,83,1319,1792421,881179,911242,17954,17954,0,60,28,19/1/2022 7:23
14/7/2021,Chanthaburi,26,1797,535998,262065,273933,17139,17083,56,,,19/1/2022 7:23
14/7/2021,Chachoengsao,339,6814,722052,353870,368182,2359,2359,0,53,34,19/1/2022 7:23
14/7/2021,Chon Buri,514,14660,1579473,770979,808494,34619,34021,598,59,35,19/1/2022 7:23
14/7/2021,Chai Nat,10,275,321220,154391,166829,3194,3194,0,,,19/1/2022 7:23
14/7/2021,Chaiyaphum,49,1006,1123243,554962,568281,6802,6802,0,,,19/1/2022 7:23
14/7/2021,Chumphon,12,299,509453,251448,258005,1865,1865,0,,,19/1/2022 7:23
14/7/2021,Trang,8,1772,640011,312941,327070,2288,2288,0,,,19/1/2022 7:23
14/7/2021,Trat,34,531,228415,112919,115496,17144,17038,106,,,19/1/2022 7:23
14/7/2021,Tak,57,2230,674330,340958,333372,13933,13933,0,,,19/1/2022 7:23
14/7/2021,Nakhon Nayok,61,1079,259525,127999,131526,3515,3515,0,,,19/1/2022 7:23
14/7/2021,Nakhon Pathom,202,7485,922047,442945,479102,4047,4047,0,46,11,19/1/2022 7:23
14/7/2021,Nakhon Phanom,43,571,717065,357305,359760,4473,4473,0,,,19/1/2022 7:23
14/7/2021,Nakhon Ratchasima,138,2238,2633481,1294026,1339455,83136,82593,543,58,31,19/1/2022 7:23
14/7/2021,Nakhon Si Thammarat,13,1866,1549708,764609,785099,8425,8425,0,,,19/1/2022 7:23
14/7/2021,Nakhon Sawan,57,1308,1037270,506043,531227,14969,14969,0,58,29,19/1/2022 7:23
14/7/2021,Nonthaburi,347,23835,1284757,597804,686953,2156,2144,12,49,16,19/1/2022 7:23
14/7/2021,Narathiwat,191,3496,808277,399788,408489,474,474,0,43,32,19/1/2022 7:23
14/7/2021,Nan,30,306,475961,238094,237867,9841,9805,36,,,19/1/2022 7:23
14/7/2021,Bueng Kan,5,121,421989,211591,210398,2816,2816,0,,,19/1/2022 7:23
14/7/2021,Buri Ram,77,1012,1579847,783934,795913,10752,10721,31,,,19/1/2022 7:23
14/7/2021,Pathum Thani,420,14246,1184541,561189,623352,1116,1103,13,65,23,19/1/2022 7:23
14/7/2021,Prachuap Khiri Khan,71,3682,552465,273938,278527,19918,19850,68,,,19/1/2022 7:23
14/7/2021,Prachin Buri,86,1534,494352,243985,250367,3384,3384,0,64,29,19/1/2022 7:23
14/7/2021,Pattani,195,4934,728613,359883,368730,585,585,0,,,19/1/2022 7:23
14/7/2021,Phra Nakhon Si Ayutthaya,94,3939,820077,393953,426124,21529,21302,227,40,39,19/1/2022 7:23
14/7/2021,Phayao,10,296,465591,226581,239010,8278,8278,0,41,19,19/1/2022 7:23
14/7/2021,Phang-nga,8,395,268377,133890,134487,5208,4622,586,,,19/1/2022 7:23
14/7/2021,Phatthalung,13,714,522778,254665,268113,1934,1934,0,,,19/1/2022 7:23
14/7/2021,Phichit,37,414,530608,258695,271913,6355,6355,0,,,19/1/2022 7:23
14/7/2021,Phitsanulok,63,746,847773,415064,432709,26075,25939,136,,,19/1/2022 7:23
14/7/2021,Phuket,2,1022,417161,197202,219959,36699,20738,15961,57,22,19/1/2022 7:23
14/7/2021,Maha Sarakham,110,1058,950326,465921,484405,2664,2664,0,,,19/1/2022 7:23
14/7/2021,Mukdahan,48,253,351129,175445,175684,5772,5772,0,,,19/1/2022 7:23
14/7/2021,Yala,158,4173,541400,269573,271827,529,529,0,53,25,19/1/2022 7:23
14/7/2021,Yasothon,33,469,533683,266331,267352,1497,1497,0,,,19/1/2022 7:23
14/7/2021,Ranong,16,1593,194637,98230,96407,1633,1633,0,,,19/1/2022 7:23
14/7/2021,Rayong,55,3212,748108,367475,380633,20171,19927,244,54,31,19/1/2022 7:23
14/7/2021,Ratchaburi,103,2680,869206,422658,446548,10667,10667,0,,,19/1/2022 7:23
14/7/2021,Roi Et,64,1008,1296773,642509,654264,2573,2573,0,,,19/1/2022 7:23
14/7/2021,Lop Buri,52,1684,740037,368792,371245,5956,5927,29,,,19/1/2022 7:23
14/7/2021,Lampang,35,558,726701,354158,372543,6122,5950,172,54,25,19/1/2022 7:23
14/7/2021,Lamphun,9,350,401619,193055,208564,6810,6725,85,,,19/1/2022 7:23
14/7/2021,Si Sa Ket,107,1267,1457396,725574,731822,3604,3604,0,,,19/1/2022 7:23
14/7/2021,Sakon Nakhon,58,644,1146784,569879,576905,4796,4796,0,,,19/1/2022 7:23
14/7/2021,Songkhla,112,8770,1429789,696651,733138,1474,1474,0,65,33,19/1/2022 7:23
14/7/2021,Satun,14,296,324467,161491,162976,1839,1820,19,58,32,19/1/2022 7:23
14/7/2021,Samut Prakarn,1017,25391,1355644,645919,709725,1526,1481,45,,,19/1/2022 7:23
14/7/2021,Samut Songkhram,27,1019,191611,91527,100084,6501,6501,0,36,11,19/1/2022 7:23
14/7/2021,Samut Sakhon,577,31910,586567,282712,303855,861,861,0,75,30,19/1/2022 7:23
14/7/2021,Saraburi,65,3034,643513,316041,327472,7419,7401,18,73,54,19/1/2022 7:23
14/7/2021,Sa kaeo,35,1888,561275,280157,281118,2531,2531,0,38,16,19/1/2022 7:23
14/7/2021,Sing Buri,9,334,205218,97486,107732,2031,2031,0,,,19/1/2022 7:23
14/7/2021,Suphan Buri,149,1794,836800,403755,433045,9449,9449,0,,,19/1/2022 7:23
14/7/2021,Surat Thani,25,2315,1070296,526627,543669,3602,3188,414,63,24,19/1/2022 7:23
14/7/2021,Surin,80,1260,1377078,685103,691975,7265,7252,13,,,19/1/2022 7:23
14/7/2021,Sukhothai,61,509,586111,283837,302274,5178,5003,175,,,19/1/2022 7:23
14/7/2021,Nong Khai,17,242,517035,256446,260589,8319,8316,3,29,13,19/1/2022 7:23
14/7/2021,Nong Bua Lam Phu,42,370,509092,253938,255154,2269,2269,0,,,19/1/2022 7:23
14/7/2021,Amnat Charoen,8,239,376294,187233,189061,1392,1392,0,,,19/1/2022 7:23
14/7/2021,Udon Thani,50,1377,1567167,776285,790882,10132,10127,5,,,19/1/2022 7:23
14/7/2021,Uttaradit,18,322,447361,218107,229254,5713,5713,0,,,19/1/2022 7:23
14/7/2021,Uthai Thani,29,292,325339,159003,166336,2109,2109,0,,,19/1/2022 7:23
14/7/2021,Ubon Ratchathani,79,1255,1867197,932136,935061,6431,6431,0,34,13,19/1/2022 7:23
14/7/2021,Ang Thong,33,940,275675,131918,143757,1386,1386,0,,,19/1/2022 7:23
14/7/2021,Chiang Rai,23,1285,1297041,630437,666604,25803,25572,231,16,7,19/1/2022 7:23
14/7/2021,Chiang Mai,30,8750,1786622,863343,923279,69510,68521,989,41,24,19/1/2022 7:23
14/7/2021,Phetchaburi,75,9903,482401,232827,249574,15182,15093,89,,,19/1/2022 7:23
14/7/2021,Phetchabun,33,670,979701,483282,496419,22759,22735,24,,,19/1/2022 7:23
14/7/2021,Loei,16,392,638517,320015,318502,4573,4565,8,28,13,19/1/2022 7:23
14/7/2021,Phrae,19,226,435659,209972,225687,5424,5424,0,48,22,19/1/2022 7:23
14/7/2021,Mae Hong Son,1,71,285729,144754,140975,9411,9186,225,16,3,19/1/2022 7:23
14/7/2021,,0,153,,,,,,,,,19/1/2022 7:23
15/7/2021,Krabi,10,905,478495,237646,240849,1716,1716,0,,,19/1/2022 7:23
15/7/2021,Bangkok,2251,132003,5551744,2605273,2946471,169121,147154,21967,53,24,19/1/2022 7:23
15/7/2021,Kanchanaburi,96,1131,893118,447911,445207,26909,26862,47,22,9,19/1/2022 7:23
15/7/2021,Kalasin,59,737,976323,482572,493751,2495,2495,0,,,19/1/2022 7:23
15/7/2021,Kamphaeng Phet,80,851,712903,351973,360930,6317,6317,0,,,19/1/2022 7:23
15/7/2021,Khon Kaen,50,1369,1792421,881179,911242,17954,17954,0,58,32,19/1/2022 7:23
15/7/2021,Chanthaburi,23,1820,535998,262065,273933,17139,17083,56,,,19/1/2022 7:23
15/7/2021,Chachoengsao,188,7002,722052,353870,368182,2359,2359,0,63,31,19/1/2022 7:23
15/7/2021,Chon Buri,524,15184,1579473,770979,808494,34619,34021,598,48,29,19/1/2022 7:23
15/7/2021,Chai Nat,19,294,321220,154391,166829,3194,3194,0,,,19/1/2022 7:23
15/7/2021,Chaiyaphum,52,1058,1123243,554962,568281,6802,6802,0,,,19/1/2022 7:23
15/7/2021,Chumphon,16,315,509453,251448,258005,1865,1865,0,,,19/1/2022 7:23
15/7/2021,Trang,34,1806,640011,312941,327070,2288,2288,0,,,19/1/2022 7:23
15/7/2021,Trat,19,550,228415,112919,115496,17144,17038,106,,,19/1/2022 7:23
15/7/2021,Tak,42,2272,674330,340958,333372,13933,13933,0,,,19/1/2022 7:23
15/7/2021,Nakhon Nayok,48,1127,259525,127999,131526,3515,3515,0,,,19/1/2022 7:23
15/7/2021,Nakhon Pathom,291,7776,922047,442945,479102,4047,4047,0,27,16,19/1/2022 7:23
15/7/2021,Nakhon Phanom,59,630,717065,357305,359760,4473,4473,0,,,19/1/2022 7:23
15/7/2021,Nakhon Ratchasima,76,2314,2633481,1294026,1339455,83136,82593,543,66,23,19/1/2022 7:23
15/7/2021,Nakhon Si Thammarat,51,1917,1549708,764609,785099,8425,8425,0,,,19/1/2022 7:23
15/7/2021,Nakhon Sawan,79,1387,1037270,506043,531227,14969,14969,0,56,20,19/1/2022 7:23
15/7/2021,Nonthaburi,355,24190,1284757,597804,686953,2156,2144,12,36,15,19/1/2022 7:23
15/7/2021,Narathiwat,172,3668,808277,399788,408489,474,474,0,67,24,19/1/2022 7:23
15/7/2021,Nan,23,329,475961,238094,237867,9841,9805,36,,,19/1/2022 7:23
15/7/2021,Bueng Kan,11,132,421989,211591,210398,2816,2816,0,,,19/1/2022 7:23
15/7/2021,Buri Ram,104,1116,1579847,783934,795913,10752,10721,31,,,19/1/2022 7:23
15/7/2021,Pathum Thani,235,14481,1184541,561189,623352,1116,1103,13,45,24,19/1/2022 7:23
15/7/2021,Prachuap Khiri Khan,59,3741,552465,273938,278527,19918,19850,68,,,19/1/2022 7:23
15/7/2021,Prachin Buri,61,1595,494352,243985,250367,3384,3384,0,69,25,19/1/2022 7:23
15/7/2021,Pattani,269,5203,728613,359883,368730,585,585,0,,,19/1/2022 7:23
15/7/2021,Phra Nakhon Si Ayutthaya,67,4006,820077,393953,426124,21529,21302,227,42,34,19/1/2022 7:23
15/7/2021,Phayao,24,320,465591,226581,239010,8278,8278,0,44,17,19/1/2022 7:23
15/7/2021,Phang-nga,3,398,268377,133890,134487,5208,4622,586,,,19/1/2022 7:23
15/7/2021,Phatthalung,7,721,522778,254665,268113,1934,1934,0,,,19/1/2022 7:23
15/7/2021,Phichit,28,442,530608,258695,271913,6355,6355,0,,,19/1/2022 7:23
15/7/2021,Phitsanulok,46,792,847773,415064,432709,26075,25939,136,,,19/1/2022 7:23
15/7/2021,Phuket,10,1032,417161,197202,219959,36699,20738,15961,54,24,19/1/2022 7:23
15/7/2021,Maha Sarakham,66,1124,950326,465921,484405,2664,2664,0,,,19/1/2022 7:23
15/7/2021,Mukdahan,17,270,351129,175445,175684,5772,5772,0,,,19/1/2022 7:23
15/7/2021,Yala,160,4333,541400,269573,271827,529,529,0,55,25,19/1/2022 7:23
15/7/2021,Yasothon,46,515,533683,266331,267352,1497,1497,0,,,19/1/2022 7:23
15/7/2021,Ranong,15,1608,194637,98230,96407,1633,1633,0,,,19/1/2022 7:23
15/7/2021,Rayong,118,3330,748108,367475,380633,20171,19927,244,42,37,19/1/2022 7:23
15/7/2021,Ratchaburi,117,2797,869206,422658,446548,10667,10667,0,,,19/1/2022 7:23
15/7/2021,Roi Et,97,1105,1296773,642509,654264,2573,2573,0,,,19/1/2022 7:23
15/7/2021,Lop Buri,53,1737,740037,368792,371245,5956,5927,29,,,19/1/2022 7:23
15/7/2021,Lampang,42,600,726701,354158,372543,6122,5950,172,62,20,19/1/2022 7:23
15/7/2021,Lamphun,9,359,401619,193055,208564,6810,6725,85,,,19/1/2022 7:23
15/7/2021,Si Sa Ket,101,1368,1457396,725574,731822,3604,3604,0,,,19/1/2022 7:23
15/7/2021,Sakon Nakhon,41,685,1146784,569879,576905,4796,4796,0,,,19/1/2022 7:23
15/7/2021,Songkhla,184,8954,1429789,696651,733138,1474,1474,0,62,28,19/1/2022 7:23
15/7/2021,Satun,35,331,324467,161491,162976,1839,1820,19,65,31,19/1/2022 7:23
15/7/2021,Samut Prakarn,865,26256,1355644,645919,709725,1526,1481,45,,,19/1/2022 7:23
15/7/2021,Samut Songkhram,20,1039,191611,91527,100084,6501,6501,0,20,12,19/1/2022 7:23
15/7/2021,Samut Sakhon,644,32554,586567,282712,303855,861,861,0,60,34,19/1/2022 7:23
15/7/2021,Saraburi,65,3099,643513,316041,327472,7419,7401,18,54,40,19/1/2022 7:23
15/7/2021,Sa kaeo,67,1955,561275,280157,281118,2531,2531,0,35,17,19/1/2022 7:23
15/7/2021,Sing Buri,11,345,205218,97486,107732,2031,2031,0,,,19/1/2022 7:23
15/7/2021,Suphan Buri,102,1896,836800,403755,433045,9449,9449,0,,,19/1/2022 7:23
15/7/2021,Surat Thani,26,2341,1070296,526627,543669,3602,3188,414,51,24,19/1/2022 7:23
15/7/2021,Surin,108,1368,1377078,685103,691975,7265,7252,13,,,19/1/2022 7:23
15/7/2021,Sukhothai,71,580,586111,283837,302274,5178,5003,175,,,19/1/2022 7:23
15/7/2021,Nong Khai,29,271,517035,256446,260589,8319,8316,3,32,13,19/1/2022 7:23
15/7/2021,Nong Bua Lam Phu,30,400,509092,253938,255154,2269,2269,0,,,19/1/2022 7:23
15/7/2021,Amnat Charoen,3,242,376294,187233,189061,1392,1392,0,,,19/1/2022 7:23
15/7/2021,Udon Thani,27,1404,1567167,776285,790882,10132,10127,5,,,19/1/2022 7:23
15/7/2021,Uttaradit,46,368,447361,218107,229254,5713,5713,0,,,19/1/2022 7:23
15/7/2021,Uthai Thani,28,320,325339,159003,166336,2109,2109,0,,,19/1/2022 7:23
15/7/2021,Ubon Ratchathani,85,1340,1867197,932136,935061,6431,6431,0,26,18,19/1/2022 7:23
15/7/2021,Ang Thong,45,985,275675,131918,143757,1386,1386,0,,,19/1/2022 7:23
15/7/2021,Chiang Rai,24,1309,1297041,630437,666604,25803,25572,231,25,6,19/1/2022 7:23
15/7/2021,Chiang Mai,48,8798,1786622,863343,923279,69510,68521,989,52,20,19/1/2022 7:23
15/7/2021,Phetchaburi,98,10001,482401,232827,249574,15182,15093,89,,,19/1/2022 7:23
15/7/2021,Phetchabun,59,729,979701,483282,496419,22759,22735,24,,,19/1/2022 7:23
15/7/2021,Loei,23,415,638517,320015,318502,4573,4565,8,22,17,19/1/2022 7:23
15/7/2021,Phrae,16,242,435659,209972,225687,5424,5424,0,60,12,19/1/2022 7:23
15/7/2021,Mae Hong Son,4,75,285729,144754,140975,9411,9186,225,16,4,19/1/2022 7:23
15/7/2021,,0,153,,,,,,,,,19/1/2022 7:23
16/7/2021,Krabi,5,910,478495,237646,240849,1716,1716,0,,,19/1/2022 7:23
16/7/2021,Bangkok,2266,134269,5551744,2605273,2946471,169121,147154,21967,50,23,19/1/2022 7:23
16/7/2021,Kanchanaburi,57,1188,893118,447911,445207,26909,26862,47,20,8,19/1/2022 7:23
16/7/2021,Kalasin,77,814,976323,482572,493751,2495,2495,0,,,19/1/2022 7:23
16/7/2021,Kamphaeng Phet,37,888,712903,351973,360930,6317,6317,0,,,19/1/2022 7:23
16/7/2021,Khon Kaen,90,1459,1792421,881179,911242,17954,17954,0,60,32,19/1/2022 7:23
16/7/2021,Chanthaburi,33,1853,535998,262065,273933,17139,17083,56,,,19/1/2022 7:23
16/7/2021,Chachoengsao,374,7376,722052,353870,368182,2359,2359,0,49,25,19/1/2022 7:23
16/7/2021,Chon Buri,532,15716,1579473,770979,808494,34619,34021,598,36,31,19/1/2022 7:23
16/7/2021,Chai Nat,23,317,321220,154391,166829,3194,3194,0,,,19/1/2022 7:23
16/7/2021,Chaiyaphum,76,1134,1123243,554962,568281,6802,6802,0,,,19/1/2022 7:23
16/7/2021,Chumphon,36,351,509453,251448,258005,1865,1865,0,,,19/1/2022 7:23
16/7/2021,Trang,7,1813,640011,312941,327070,2288,2288,0,,,19/1/2022 7:23
16/7/2021,Trat,24,574,228415,112919,115496,17144,17038,106,,,19/1/2022 7:23
16/7/2021,Tak,43,2315,674330,340958,333372,13933,13933,0,,,19/1/2022 7:23
16/7/2021,Nakhon Nayok,54,1181,259525,127999,131526,3515,3515,0,,,19/1/2022 7:23
16/7/2021,Nakhon Pathom,335,8111,922047,442945,479102,4047,4047,0,39,15,19/1/2022 7:23
16/7/2021,Nakhon Phanom,29,659,717065,357305,359760,4473,4473,0,,,19/1/2022 7:23
16/7/2021,Nakhon Ratchasima,98,2412,2633481,1294026,1339455,83136,82593,543,53,22,19/1/2022 7:23
16/7/2021,Nakhon Si Thammarat,45,1962,1549708,764609,785099,8425,8425,0,,,19/1/2022 7:23
16/7/2021,Nakhon Sawan,81,1468,1037270,506043,531227,14969,14969,0,39,18,19/1/2022 7:23
16/7/2021,Nonthaburi,456,24646,1284757,597804,686953,2156,2144,12,36,14,19/1/2022 7:23
16/7/2021,Narathiwat,140,3808,808277,399788,408489,474,474,0,47,30,19/1/2022 7:23
16/7/2021,Nan,14,343,475961,238094,237867,9841,9805,36,,,19/1/2022 7:23
16/7/2021,Bueng Kan,4,136,421989,211591,210398,2816,2816,0,,,19/1/2022 7:23
16/7/2021,Buri Ram,92,1208,1579847,783934,795913,10752,10721,31,,,19/1/2022 7:23
16/7/2021,Pathum Thani,244,14725,1184541,561189,623352,1116,1103,13,45,25,19/1/2022 7:23
16/7/2021,Prachuap Khiri Khan,48,3789,552465,273938,278527,19918,19850,68,,,19/1/2022 7:23
16/7/2021,Prachin Buri,63,1658,494352,243985,250367,3384,3384,0,58,23,19/1/2022 7:23
16/7/2021,Pattani,191,5394,728613,359883,368730,585,585,0,,,19/1/2022 7:23
16/7/2021,Phra Nakhon Si Ayutthaya,68,4074,820077,393953,426124,21529,21302,227,33,33,19/1/2022 7:23
16/7/2021,Phayao,8,328,465591,226581,239010,8278,8278,0,38,15,19/1/2022 7:23
16/7/2021,Phang-nga,10,408,268377,133890,134487,5208,4622,586,,,19/1/2022 7:23
16/7/2021,Phatthalung,13,734,522778,254665,268113,1934,1934,0,,,19/1/2022 7:23
16/7/2021,Phichit,47,489,530608,258695,271913,6355,6355,0,,,19/1/2022 7:23
16/7/2021,Phitsanulok,31,823,847773,415064,432709,26075,25939,136,,,19/1/2022 7:23
16/7/2021,Phuket,12,1044,417161,197202,219959,36699,20738,15961,48,32,19/1/2022 7:23
16/7/2021,Maha Sarakham,65,1189,950326,465921,484405,2664,2664,0,,,19/1/2022 7:23
16/7/2021,Mukdahan,18,288,351129,175445,175684,5772,5772,0,,,19/1/2022 7:23
16/7/2021,Yala,264,4597,541400,269573,271827,529,529,0,54,35,19/1/2022 7:23
16/7/2021,Yasothon,64,579,533683,266331,267352,1497,1497,0,,,19/1/2022 7:23
16/7/2021,Ranong,12,1620,194637,98230,96407,1633,1633,0,,,19/1/2022 7:23
16/7/2021,Rayong,137,3467,748108,367475,380633,20171,19927,244,33,25,19/1/2022 7:23
16/7/2021,Ratchaburi,128,2925,869206,422658,446548,10667,10667,0,,,19/1/2022 7:23
16/7/2021,Roi Et,62,1167,1296773,642509,654264,2573,2573,0,,,19/1/2022 7:23
16/7/2021,Lop Buri,60,1797,740037,368792,371245,5956,5927,29,,,19/1/2022 7:23
16/7/2021,Lampang,29,629,726701,354158,372543,6122,5950,172,33,18,19/1/2022 7:23
16/7/2021,Lamphun,8,367,401619,193055,208564,6810,6725,85,,,19/1/2022 7:23
16/7/2021,Si Sa Ket,72,1440,1457396,725574,731822,3604,3604,0,,,19/1/2022 7:23
16/7/2021,Sakon Nakhon,59,744,1146784,569879,576905,4796,4796,0,,,19/1/2022 7:23
16/7/2021,Songkhla,179,9133,1429789,696651,733138,1474,1474,0,57,40,19/1/2022 7:23
16/7/2021,Satun,8,339,324467,161491,162976,1839,1820,19,69,42,19/1/2022 7:23
16/7/2021,Samut Prakarn,733,26989,1355644,645919,709725,1526,1481,45,,,19/1/2022 7:23
16/7/2021,Samut Songkhram,34,1073,191611,91527,100084,6501,6501,0,21,13,19/1/2022 7:23
16/7/2021,Samut Sakhon,690,33244,586567,282712,303855,861,861,0,61,33,19/1/2022 7:23
16/7/2021,Saraburi,68,3167,643513,316041,327472,7419,7401,18,42,32,19/1/2022 7:23
16/7/2021,Sa kaeo,37,1992,561275,280157,281118,2531,2531,0,33,15,19/1/2022 7:23
16/7/2021,Sing Buri,19,364,205218,97486,107732,2031,2031,0,,,19/1/2022 7:23
16/7/2021,Suphan Buri,317,2213,836800,403755,433045,9449,9449,0,,,19/1/2022 7:23
16/7/2021,Surat Thani,26,2367,1070296,526627,543669,3602,3188,414,52,28,19/1/2022 7:23
16/7/2021,Surin,116,1484,1377078,685103,691975,7265,7252,13,,,19/1/2022 7:23
16/7/2021,Sukhothai,43,623,586111,283837,302274,5178,5003,175,,,19/1/2022 7:23
16/7/2021,Nong Khai,16,287,517035,256446,260589,8319,8316,3,31,13,19/1/2022 7:23
16/7/2021,Nong Bua Lam Phu,13,413,509092,253938,255154,2269,2269,0,,,19/1/2022 7:23
16/7/2021,Amnat Charoen,36,278,376294,187233,189061,1392,1392,0,,,19/1/2022 7:23
16/7/2021,Udon Thani,121,1525,1567167,776285,790882,10132,10127,5,,,19/1/2022 7:23
16/7/2021,Uttaradit,25,393,447361,218107,229254,5713,5713,0,,,19/1/2022 7:23
16/7/2021,Uthai Thani,28,348,325339,159003,166336,2109,2109,0,,,19/1/2022 7:23
16/7/2021,Ubon Ratchathani,102,1442,1867197,932136,935061,6431,6431,0,43,23,19/1/2022 7:23
16/7/2021,Ang Thong,53,1038,275675,131918,143757,1386,1386,0,,,19/1/2022 7:23
16/7/2021,Chiang Rai,23,1332,1297041,630437,666604,25803,25572,231,21,8,19/1/2022 7:23
16/7/2021,Chiang Mai,66,8864,1786622,863343,923279,69510,68521,989,51,21,19/1/2022 7:23
16/7/2021,Phetchaburi,89,10090,482401,232827,249574,15182,15093,89,,,19/1/2022 7:23
16/7/2021,Phetchabun,69,798,979701,483282,496419,22759,22735,24,,,19/1/2022 7:23
16/7/2021,Loei,21,436,638517,320015,318502,4573,4565,8,30,14,19/1/2022 7:23
16/7/2021,Phrae,16,258,435659,209972,225687,5424,5424,0,29,14,19/1/2022 7:23
16/7/2021,Mae Hong Son,3,78,285729,144754,140975,9411,9186,225,17,3,19/1/2022 7:23
16/7/2021,,0,153,,,,,,,,,19/1/2022 7:23
17/7/2021,Krabi,8,918,478495,237646,240849,1716,1716,0,,,19/1/2022 7:23
17/7/2021,Bangkok,2376,136645,5551744,2605273,2946471,169121,147154,21967,54,20,19/1/2022 7:23
17/7/2021,Kanchanaburi,143,1331,893118,447911,445207,26909,26862,47,21,9,19/1/2022 7:23
17/7/2021,Kalasin,92,906,976323,482572,493751,2495,2495,0,,,19/1/2022 7:23
17/7/2021,Kamphaeng Phet,52,940,712903,351973,360930,6317,6317,0,,,19/1/2022 7:23
17/7/2021,Khon Kaen,44,1503,1792421,881179,911242,17954,17954,0,60,26,19/1/2022 7:23
17/7/2021,Chanthaburi,37,1890,535998,262065,273933,17139,17083,56,,,19/1/2022 7:23
17/7/2021,Chachoengsao,246,7622,722052,353870,368182,2359,2359,0,40,26,19/1/2022 7:23
17/7/2021,Chon Buri,659,16375,1579473,770979,808494,34619,34021,598,37,27,19/1/2022 7:23
17/7/2021,Chai Nat,22,339,321220,154391,166829,3194,3194,0,,,19/1/2022 7:23
17/7/2021,Chaiyaphum,61,1195,1123243,554962,568281,6802,6802,0,,,19/1/2022 7:23
17/7/2021,Chumphon,44,395,509453,251448,258005,1865,1865,0,,,19/1/2022 7:23
17/7/2021,Trang,25,1838,640011,312941,327070,2288,2288,0,,,19/1/2022 7:23
17/7/2021,Trat,22,596,228415,112919,115496,17144,17038,106,,,19/1/2022 7:23
17/7/2021,Tak,61,2376,674330,340958,333372,13933,13933,0,,,19/1/2022 7:23
17/7/2021,Nakhon Nayok,90,1271,259525,127999,131526,3515,3515,0,,,19/1/2022 7:23
17/7/2021,Nakhon Pathom,288,8399,922047,442945,479102,4047,4047,0,37,11,19/1/2022 7:23
17/7/2021,Nakhon Phanom,70,729,717065,357305,359760,4473,4473,0,,,19/1/2022 7:23
17/7/2021,Nakhon Ratchasima,94,2506,2633481,1294026,1339455,83136,82593,543,46,21,19/1/2022 7:23
17/7/2021,Nakhon Si Thammarat,41,2003,1549708,764609,785099,8425,8425,0,,,19/1/2022 7:23
17/7/2021,Nakhon Sawan,67,1535,1037270,506043,531227,14969,14969,0,30,15,19/1/2022 7:23
17/7/2021,Nonthaburi,471,25117,1284757,597804,686953,2156,2144,12,31,11,19/1/2022 7:23
17/7/2021,Narathiwat,148,3956,808277,399788,408489,474,474,0,62,38,19/1/2022 7:23
17/7/2021,Nan,17,360,475961,238094,237867,9841,9805,36,,,19/1/2022 7:23
17/7/2021,Bueng Kan,10,146,421989,211591,210398,2816,2816,0,,,19/1/2022 7:23
17/7/2021,Buri Ram,93,1301,1579847,783934,795913,10752,10721,31,,,19/1/2022 7:23
17/7/2021,Pathum Thani,253,14978,1184541,561189,623352,1116,1103,13,42,17,19/1/2022 7:23
17/7/2021,Prachuap Khiri Khan,63,3852,552465,273938,278527,19918,19850,68,,,19/1/2022 7:23
17/7/2021,Prachin Buri,92,1750,494352,243985,250367,3384,3384,0,53,24,19/1/2022 7:23
17/7/2021,Pattani,194,5588,728613,359883,368730,585,585,0,,,19/1/2022 7:23
17/7/2021,Phra Nakhon Si Ayutthaya,75,4149,820077,393953,426124,21529,21302,227,27,32,19/1/2022 7:23
17/7/2021,Phayao,26,354,465591,226581,239010,8278,8278,0,28,15,19/1/2022 7:23
17/7/2021,Phang-nga,9,417,268377,133890,134487,5208,4622,586,,,19/1/2022 7:23
17/7/2021,Phatthalung,21,755,522778,254665,268113,1934,1934,0,,,19/1/2022 7:23
17/7/2021,Phichit,63,552,530608,258695,271913,6355,6355,0,,,19/1/2022 7:23
17/7/2021,Phitsanulok,37,860,847773,415064,432709,26075,25939,136,,,19/1/2022 7:23
17/7/2021,Phuket,9,1053,417161,197202,219959,36699,20738,15961,64,37,19/1/2022 7:23
17/7/2021,Maha Sarakham,91,1280,950326,465921,484405,2664,2664,0,,,19/1/2022 7:23
17/7/2021,Mukdahan,20,308,351129,175445,175684,5772,5772,0,,,19/1/2022 7:23
17/7/2021,Yala,196,4793,541400,269573,271827,529,529,0,69,43,19/1/2022 7:23
17/7/2021,Yasothon,50,629,533683,266331,267352,1497,1497,0,,,19/1/2022 7:23
17/7/2021,Ranong,6,1626,194637,98230,96407,1633,1633,0,,,19/1/2022 7:23
17/7/2021,Rayong,90,3557,748108,367475,380633,20171,19927,244,24,28,19/1/2022 7:23
17/7/2021,Ratchaburi,149,3074,869206,422658,446548,10667,10667,0,,,19/1/2022 7:23
17/7/2021,Roi Et,92,1259,1296773,642509,654264,2573,2573,0,,,19/1/2022 7:23
17/7/2021,Lop Buri,62,1859,740037,368792,371245,5956,5927,29,,,19/1/2022 7:23
17/7/2021,Lampang,22,651,726701,354158,372543,6122,5950,172,35,16,19/1/2022 7:23
17/7/2021,Lamphun,16,383,401619,193055,208564,6810,6725,85,,,19/1/2022 7:23
17/7/2021,Si Sa Ket,66,1506,1457396,725574,731822,3604,3604,0,,,19/1/2022 7:23
17/7/2021,Sakon Nakhon,20,764,1146784,569879,576905,4796,4796,0,,,19/1/2022 7:23
17/7/2021,Songkhla,286,9419,1429789,696651,733138,1474,1474,0,74,48,19/1/2022 7:23
17/7/2021,Satun,46,385,324467,161491,162976,1839,1820,19,86,41,19/1/2022 7:23
17/7/2021,Samut Prakarn,849,27838,1355644,645919,709725,1526,1481,45,,,19/1/2022 7:23
17/7/2021,Samut Songkhram,47,1120,191611,91527,100084,6501,6501,0,24,13,19/1/2022 7:23
17/7/2021,Samut Sakhon,687,33931,586567,282712,303855,861,861,0,58,27,19/1/2022 7:23
17/7/2021,Saraburi,65,3232,643513,316041,327472,7419,7401,18,36,34,19/1/2022 7:23
17/7/2021,Sa kaeo,73,2065,561275,280157,281118,2531,2531,0,26,12,19/1/2022 7:23
17/7/2021,Sing Buri,18,382,205218,97486,107732,2031,2031,0,,,19/1/2022 7:23
17/7/2021,Suphan Buri,131,2344,836800,403755,433045,9449,9449,0,,,19/1/2022 7:23
17/7/2021,Surat Thani,60,2427,1070296,526627,543669,3602,3188,414,59,33,19/1/2022 7:23
17/7/2021,Surin,139,1623,1377078,685103,691975,7265,7252,13,,,19/1/2022 7:23
17/7/2021,Sukhothai,85,708,586111,283837,302274,5178,5003,175,,,19/1/2022 7:23
17/7/2021,Nong Khai,42,329,517035,256446,260589,8319,8316,3,32,12,19/1/2022 7:23
17/7/2021,Nong Bua Lam Phu,29,442,509092,253938,255154,2269,2269,0,,,19/1/2022 7:23
17/7/2021,Amnat Charoen,6,284,376294,187233,189061,1392,1392,0,,,19/1/2022 7:23
17/7/2021,Udon Thani,21,1546,1567167,776285,790882,10132,10127,5,,,19/1/2022 7:23
17/7/2021,Uttaradit,26,419,447361,218107,229254,5713,5713,0,,,19/1/2022 7:23
17/7/2021,Uthai Thani,14,362,325339,159003,166336,2109,2109,0,,,19/1/2022 7:23
17/7/2021,Ubon Ratchathani,116,1558,1867197,932136,935061,6431,6431,0,55,16,19/1/2022 7:23
17/7/2021,Ang Thong,54,1092,275675,131918,143757,1386,1386,0,,,19/1/2022 7:23
17/7/2021,Chiang Rai,39,1371,1297041,630437,666604,25803,25572,231,29,4,19/1/2022 7:23
17/7/2021,Chiang Mai,76,8940,1786622,863343,923279,69510,68521,989,50,21,19/1/2022 7:23
17/7/2021,Phetchaburi,75,10165,482401,232827,249574,15182,15093,89,,,19/1/2022 7:23
17/7/2021,Phetchabun,50,848,979701,483282,496419,22759,22735,24,,,19/1/2022 7:23
17/7/2021,Loei,15,451,638517,320015,318502,4573,4565,8,26,16,19/1/2022 7:23
17/7/2021,Phrae,26,284,435659,209972,225687,5424,5424,0,30,14,19/1/2022 7:23
17/7/2021,Mae Hong Son,4,82,285729,144754,140975,9411,9186,225,14,5,19/1/2022 7:23
17/7/2021,,0,153,,,,,,,,,19/1/2022 7:23
18/7/2021,Krabi,9,927,478495,237646,240849,1716,1716,0,,,19/1/2022 7:23
18/7/2021,Bangkok,2309,138954,5551744,2605273,2946471,169121,147154,21967,43,17,19/1/2022 7:23
18/7/2021,Kanchanaburi,64,1395,893118,447911,445207,26909,26862,47,22,7,19/1/2022 7:23
18/7/2021,Kalasin,104,1010,976323,482572,493751,2495,2495,0,,,19/1/2022 7:23
18/7/2021,Kamphaeng Phet,53,993,712903,351973,360930,6317,6317,0,,,19/1/2022 7:23
18/7/2021,Khon Kaen,104,1607,1792421,881179,911242,17954,17954,0,49,23,19/1/2022 7:23
18/7/2021,Chanthaburi,58,1948,535998,262065,273933,17139,17083,56,,,19/1/2022 7:23
18/7/2021,Chachoengsao,242,7864,722052,353870,368182,2359,2359,0,33,27,19/1/2022 7:23
18/7/2021,Chon Buri,662,17037,1579473,770979,808494,34619,34021,598,34,39,19/1/2022 7:23
18/7/2021,Chai Nat,20,359,321220,154391,166829,3194,3194,0,,,19/1/2022 7:23
18/7/2021,Chaiyaphum,71,1266,1123243,554962,568281,6802,6802,0,,,19/1/2022 7:23
18/7/2021,Chumphon,34,429,509453,251448,258005,1865,1865,0,,,19/1/2022 7:23
18/7/2021,Trang,14,1852,640011,312941,327070,2288,2288,0,,,19/1/2022 7:23
18/7/2021,Trat,33,629,228415,112919,115496,17144,17038,106,,,19/1/2022 7:23
18/7/2021,Tak,108,2484,674330,340958,333372,13933,13933,0,,,19/1/2022 7:23
18/7/2021,Nakhon Nayok,85,1356,259525,127999,131526,3515,3515,0,,,19/1/2022 7:23
18/7/2021,Nakhon Pathom,240,8639,922047,442945,479102,4047,4047,0,22,10,19/1/2022 7:23
18/7/2021,Nakhon Phanom,60,789,717065,357305,359760,4473,4473,0,,,19/1/2022 7:23
18/7/2021,Nakhon Ratchasima,170,2676,2633481,1294026,1339455,83136,82593,543,41,20,19/1/2022 7:23
18/7/2021,Nakhon Si Thammarat,65,2068,1549708,764609,785099,8425,8425,0,,,19/1/2022 7:23
18/7/2021,Nakhon Sawan,95,1630,1037270,506043,531227,14969,14969,0,23,18,19/1/2022 7:23
18/7/2021,Nonthaburi,337,25454,1284757,597804,686953,2156,2144,12,19,8,19/1/2022 7:23
18/7/2021,Narathiwat,87,4043,808277,399788,408489,474,474,0,80,38,19/1/2022 7:23
18/7/2021,Nan,25,385,475961,238094,237867,9841,9805,36,,,19/1/2022 7:23
18/7/2021,Bueng Kan,15,161,421989,211591,210398,2816,2816,0,,,19/1/2022 7:23
18/7/2021,Buri Ram,49,1350,1579847,783934,795913,10752,10721,31,,,19/1/2022 7:23
18/7/2021,Pathum Thani,686,15664,1184541,561189,623352,1116,1103,13,21,13,19/1/2022 7:23
18/7/2021,Prachuap Khiri Khan,48,3900,552465,273938,278527,19918,19850,68,,,19/1/2022 7:23
18/7/2021,Prachin Buri,71,1821,494352,243985,250367,3384,3384,0,54,22,19/1/2022 7:23
18/7/2021,Pattani,219,5807,728613,359883,368730,585,585,0,,,19/1/2022 7:23
18/7/2021,Phra Nakhon Si Ayutthaya,392,4541,820077,393953,426124,21529,21302,227,27,30,19/1/2022 7:23
18/7/2021,Phayao,24,378,465591,226581,239010,8278,8278,0,29,12,19/1/2022 7:23
18/7/2021,Phang-nga,6,423,268377,133890,134487,5208,4622,586,,,19/1/2022 7:23
18/7/2021,Phatthalung,17,772,522778,254665,268113,1934,1934,0,,,19/1/2022 7:23
18/7/2021,Phichit,47,599,530608,258695,271913,6355,6355,0,,,19/1/2022 7:23
18/7/2021,Phitsanulok,65,925,847773,415064,432709,26075,25939,136,,,19/1/2022 7:23
18/7/2021,Phuket,15,1068,417161,197202,219959,36699,20738,15961,67,35,19/1/2022 7:23
18/7/2021,Maha Sarakham,131,1411,950326,465921,484405,2664,2664,0,,,19/1/2022 7:23
18/7/2021,Mukdahan,23,331,351129,175445,175684,5772,5772,0,,,19/1/2022 7:23
18/7/2021,Yala,190,4983,541400,269573,271827,529,529,0,78,39,19/1/2022 7:23
18/7/2021,Yasothon,44,673,533683,266331,267352,1497,1497,0,,,19/1/2022 7:23
18/7/2021,Ranong,32,1658,194637,98230,96407,1633,1633,0,,,19/1/2022 7:23
18/7/2021,Rayong,228,3785,748108,367475,380633,20171,19927,244,38,26,19/1/2022 7:23
18/7/2021,Ratchaburi,160,3234,869206,422658,446548,10667,10667,0,,,19/1/2022 7:23
18/7/2021,Roi Et,115,1374,1296773,642509,654264,2573,2573,0,,,19/1/2022 7:23
18/7/2021,Lop Buri,297,2156,740037,368792,371245,5956,5927,29,,,19/1/2022 7:23
18/7/2021,Lampang,30,681,726701,354158,372543,6122,5950,172,19,16,19/1/2022 7:23
18/7/2021,Lamphun,10,393,401619,193055,208564,6810,6725,85,,,19/1/2022 7:23
18/7/2021,Si Sa Ket,124,1630,1457396,725574,731822,3604,3604,0,,,19/1/2022 7:23
18/7/2021,Sakon Nakhon,81,845,1146784,569879,576905,4796,4796,0,,,19/1/2022 7:23
18/7/2021,Songkhla,203,9622,1429789,696651,733138,1474,1474,0,91,48,19/1/2022 7:23
18/7/2021,Satun,16,401,324467,161491,162976,1839,1820,19,87,41,19/1/2022 7:23
18/7/2021,Samut Prakarn,660,28498,1355644,645919,709725,1526,1481,45,,,19/1/2022 7:23
18/7/2021,Samut Songkhram,36,1156,191611,91527,100084,6501,6501,0,21,10,19/1/2022 7:23
18/7/2021,Samut Sakhon,741,34672,586567,282712,303855,861,861,0,49,24,19/1/2022 7:23
18/7/2021,Saraburi,346,3578,643513,316041,327472,7419,7401,18,37,29,19/1/2022 7:23
18/7/2021,Sa kaeo,46,2111,561275,280157,281118,2531,2531,0,22,19,19/1/2022 7:23
18/7/2021,Sing Buri,13,395,205218,97486,107732,2031,2031,0,,,19/1/2022 7:23
18/7/2021,Suphan Buri,158,2502,836800,403755,433045,9449,9449,0,,,19/1/2022 7:23
18/7/2021,Surat Thani,34,2461,1070296,526627,543669,3602,3188,414,67,32,19/1/2022 7:23
18/7/2021,Surin,165,1788,1377078,685103,691975,7265,7252,13,,,19/1/2022 7:23
18/7/2021,Sukhothai,0,708,586111,283837,302274,5178,5003,175,,,19/1/2022 7:23
18/7/2021,Nong Khai,28,357,517035,256446,260589,8319,8316,3,30,11,19/1/2022 7:23
18/7/2021,Nong Bua Lam Phu,32,474,509092,253938,255154,2269,2269,0,,,19/1/2022 7:23
18/7/2021,Amnat Charoen,30,314,376294,187233,189061,1392,1392,0,,,19/1/2022 7:23
18/7/2021,Udon Thani,142,1688,1567167,776285,790882,10132,10127,5,,,19/1/2022 7:23
18/7/2021,Uttaradit,39,458,447361,218107,229254,5713,5713,0,,,19/1/2022 7:23
18/7/2021,Uthai Thani,25,387,325339,159003,166336,2109,2109,0,,,19/1/2022 7:23
18/7/2021,Ubon Ratchathani,106,1664,1867197,932136,935061,6431,6431,0,37,14,19/1/2022 7:23
18/7/2021,Ang Thong,94,1186,275675,131918,143757,1386,1386,0,,,19/1/2022 7:23
18/7/2021,Chiang Rai,25,1396,1297041,630437,666604,25803,25572,231,17,6,19/1/2022 7:23
18/7/2021,Chiang Mai,52,8992,1786622,863343,923279,69510,68521,989,47,22,19/1/2022 7:23
18/7/2021,Phetchaburi,98,10263,482401,232827,249574,15182,15093,89,,,19/1/2022 7:23
18/7/2021,Phetchabun,76,924,979701,483282,496419,22759,22735,24,,,19/1/2022 7:23
18/7/2021,Loei,33,484,638517,320015,318502,4573,4565,8,30,11,19/1/2022 7:23
18/7/2021,Phrae,27,311,435659,209972,225687,5424,5424,0,32,16,19/1/2022 7:23
18/7/2021,Mae Hong Son,4,86,285729,144754,140975,9411,9186,225,20,3,19/1/2022 7:23
18/7/2021,,0,153,,,,,,,,,19/1/2022 7:23
19/7/2021,Krabi,6,933,478495,237646,240849,1716,1716,0,,,19/1/2022 7:23
19/7/2021,Bangkok,2174,141128,5551744,2605273,2946471,169121,147154,21967,31,17,19/1/2022 7:23
19/7/2021,Kanchanaburi,107,1502,893118,447911,445207,26909,26862,47,14,10,19/1/2022 7:23
19/7/2021,Kalasin,78,1088,976323,482572,493751,2495,2495,0,,,19/1/2022 7:23
19/7/2021,Kamphaeng Phet,75,1068,712903,351973,360930,6317,6317,0,,,19/1/2022 7:23
19/7/2021,Khon Kaen,84,1691,1792421,881179,911242,17954,17954,0,44,26,19/1/2022 7:23
19/7/2021,Chanthaburi,41,1989,535998,262065,273933,17139,17083,56,,,19/1/2022 7:23
19/7/2021,Chachoengsao,253,8117,722052,353870,368182,2359,2359,0,24,26,19/1/2022 7:23
19/7/2021,Chon Buri,616,17653,1579473,770979,808494,34619,34021,598,47,43,19/1/2022 7:23
19/7/2021,Chai Nat,16,375,321220,154391,166829,3194,3194,0,,,19/1/2022 7:23
19/7/2021,Chaiyaphum,101,1367,1123243,554962,568281,6802,6802,0,,,19/1/2022 7:23
19/7/2021,Chumphon,41,470,509453,251448,258005,1865,1865,0,,,19/1/2022 7:23
19/7/2021,Trang,19,1871,640011,312941,327070,2288,2288,0,,,19/1/2022 7:23
19/7/2021,Trat,13,642,228415,112919,115496,17144,17038,106,,,19/1/2022 7:23
19/7/2021,Tak,273,2757,674330,340958,333372,13933,13933,0,,,19/1/2022 7:23
19/7/2021,Nakhon Nayok,75,1431,259525,127999,131526,3515,3515,0,,,19/1/2022 7:23
19/7/2021,Nakhon Pathom,239,8878,922047,442945,479102,4047,4047,0,22,10,19/1/2022 7:23
19/7/2021,Nakhon Phanom,75,864,717065,357305,359760,4473,4473,0,,,19/1/2022 7:23
19/7/2021,Nakhon Ratchasima,138,2814,2633481,1294026,1339455,83136,82593,543,41,19,19/1/2022 7:23
19/7/2021,Nakhon Si Thammarat,92,2160,1549708,764609,785099,8425,8425,0,,,19/1/2022 7:23
19/7/2021,Nakhon Sawan,83,1713,1037270,506043,531227,14969,14969,0,30,23,19/1/2022 7:23
19/7/2021,Nonthaburi,381,25835,1284757,597804,686953,2156,2144,12,13,10,19/1/2022 7:23
19/7/2021,Narathiwat,200,4243,808277,399788,408489,474,474,0,78,36,19/1/2022 7:23
19/7/2021,Nan,24,409,475961,238094,237867,9841,9805,36,,,19/1/2022 7:23
19/7/2021,Bueng Kan,18,179,421989,211591,210398,2816,2816,0,,,19/1/2022 7:23
19/7/2021,Buri Ram,173,1523,1579847,783934,795913,10752,10721,31,,,19/1/2022 7:23
19/7/2021,Pathum Thani,485,16149,1184541,561189,623352,1116,1103,13,16,16,19/1/2022 7:23
19/7/2021,Prachuap Khiri Khan,50,3950,552465,273938,278527,19918,19850,68,,,19/1/2022 7:23
19/7/2021,Prachin Buri,64,1885,494352,243985,250367,3384,3384,0,48,20,19/1/2022 7:23
19/7/2021,Pattani,296,6103,728613,359883,368730,585,585,0,,,19/1/2022 7:23
19/7/2021,Phra Nakhon Si Ayutthaya,484,5025,820077,393953,426124,21529,21302,227,22,33,19/1/2022 7:23
19/7/2021,Phayao,19,397,465591,226581,239010,8278,8278,0,20,12,19/1/2022 7:23
19/7/2021,Phang-nga,2,425,268377,133890,134487,5208,4622,586,,,19/1/2022 7:23
19/7/2021,Phatthalung,69,841,522778,254665,268113,1934,1934,0,,,19/1/2022 7:23
19/7/2021,Phichit,41,640,530608,258695,271913,6355,6355,0,,,19/1/2022 7:23
19/7/2021,Phitsanulok,30,955,847773,415064,432709,26075,25939,136,,,19/1/2022 7:23
19/7/2021,Phuket,2,1070,417161,197202,219959,36699,20738,15961,66,36,19/1/2022 7:23
19/7/2021,Maha Sarakham,119,1530,950326,465921,484405,2664,2664,0,,,19/1/2022 7:23
19/7/2021,Mukdahan,9,340,351129,175445,175684,5772,5772,0,,,19/1/2022 7:23
19/7/2021,Yala,219,5202,541400,269573,271827,529,529,0,74,40,19/1/2022 7:23
19/7/2021,Yasothon,44,717,533683,266331,267352,1497,1497,0,,,19/1/2022 7:23
19/7/2021,Ranong,31,1689,194637,98230,96407,1633,1633,0,,,19/1/2022 7:23
19/7/2021,Rayong,140,3925,748108,367475,380633,20171,19927,244,30,29,19/1/2022 7:23
19/7/2021,Ratchaburi,153,3387,869206,422658,446548,10667,10667,0,,,19/1/2022 7:23
19/7/2021,Roi Et,129,1503,1296773,642509,654264,2573,2573,0,,,19/1/2022 7:23
19/7/2021,Lop Buri,196,2352,740037,368792,371245,5956,5927,29,,,19/1/2022 7:23
19/7/2021,Lampang,43,724,726701,354158,372543,6122,5950,172,42,17,19/1/2022 7:23
19/7/2021,Lamphun,13,406,401619,193055,208564,6810,6725,85,,,19/1/2022 7:23
19/7/2021,Si Sa Ket,125,1755,1457396,725574,731822,3604,3604,0,,,19/1/2022 7:23
19/7/2021,Sakon Nakhon,47,892,1146784,569879,576905,4796,4796,0,,,19/1/2022 7:23
19/7/2021,Songkhla,180,9802,1429789,696651,733138,1474,1474,0,90,43,19/1/2022 7:23
19/7/2021,Satun,13,414,324467,161491,162976,1839,1820,19,83,37,19/1/2022 7:23
19/7/2021,Samut Prakarn,483,28981,1355644,645919,709725,1526,1481,45,,,19/1/2022 7:23
19/7/2021,Samut Songkhram,30,1186,191611,91527,100084,6501,6501,0,18,10,19/1/2022 7:23
19/7/2021,Samut Sakhon,779,35451,586567,282712,303855,861,861,0,39,27,19/1/2022 7:23
19/7/2021,Saraburi,494,4072,643513,316041,327472,7419,7401,18,30,30,19/1/2022 7:23
19/7/2021,Sa kaeo,126,2237,561275,280157,281118,2531,2531,0,32,17,19/1/2022 7:23
19/7/2021,Sing Buri,8,403,205218,97486,107732,2031,2031,0,,,19/1/2022 7:23
19/7/2021,Suphan Buri,119,2621,836800,403755,433045,9449,9449,0,,,19/1/2022 7:23
19/7/2021,Surat Thani,69,2530,1070296,526627,543669,3602,3188,414,63,33,19/1/2022 7:23
19/7/2021,Surin,104,1892,1377078,685103,691975,7265,7252,13,,,19/1/2022 7:23
19/7/2021,Sukhothai,126,834,586111,283837,302274,5178,5003,175,,,19/1/2022 7:23
19/7/2021,Nong Khai,11,368,517035,256446,260589,8319,8316,3,28,10,19/1/2022 7:23
19/7/2021,Nong Bua Lam Phu,41,515,509092,253938,255154,2269,2269,0,,,19/1/2022 7:23
19/7/2021,Amnat Charoen,3,317,376294,187233,189061,1392,1392,0,,,19/1/2022 7:23
19/7/2021,Udon Thani,154,1842,1567167,776285,790882,10132,10127,5,,,19/1/2022 7:23
19/7/2021,Uttaradit,60,518,447361,218107,229254,5713,5713,0,,,19/1/2022 7:23
19/7/2021,Uthai Thani,26,413,325339,159003,166336,2109,2109,0,,,19/1/2022 7:23
19/7/2021,Ubon Ratchathani,222,1886,1867197,932136,935061,6431,6431,0,28,16,19/1/2022 7:23
19/7/2021,Ang Thong,146,1332,275675,131918,143757,1386,1386,0,,,19/1/2022 7:23
19/7/2021,Chiang Rai,35,1431,1297041,630437,666604,25803,25572,231,21,5,19/1/2022 7:23
19/7/2021,Chiang Mai,66,9058,1786622,863343,923279,69510,68521,989,48,18,19/1/2022 7:23
19/7/2021,Phetchaburi,163,10426,482401,232827,249574,15182,15093,89,,,19/1/2022 7:23
19/7/2021,Phetchabun,60,984,979701,483282,496419,22759,22735,24,,,19/1/2022 7:23
19/7/2021,Loei,38,522,638517,320015,318502,4573,4565,8,15,11,19/1/2022 7:23
19/7/2021,Phrae,22,333,435659,209972,225687,5424,5424,0,29,13,19/1/2022 7:23
19/7/2021,Mae Hong Son,1,87,285729,144754,140975,9411,9186,225,14,2,19/1/2022 7:23
19/7/2021,,0,153,,,,,,,,,19/1/2022 7:23
20/7/2021,Krabi,3,936,478495,237646,240849,1716,1716,0,,,19/1/2022 7:23
20/7/2021,Bangkok,3048,144176,5551744,2605273,2946471,169121,147154,21967,35,18,19/1/2022 7:23
20/7/2021,Kanchanaburi,53,1555,893118,447911,445207,26909,26862,47,21,13,19/1/2022 7:23
20/7/2021,Kalasin,72,1160,976323,482572,493751,2495,2495,0,,,19/1/2022 7:23
20/7/2021,Kamphaeng Phet,85,1153,712903,351973,360930,6317,6317,0,,,19/1/2022 7:23
20/7/2021,Khon Kaen,87,1778,1792421,881179,911242,17954,17954,0,53,28,19/1/2022 7:23
20/7/2021,Chanthaburi,35,2024,535998,262065,273933,17139,17083,56,,,19/1/2022 7:23
20/7/2021,Chachoengsao,185,8302,722052,353870,368182,2359,2359,0,25,28,19/1/2022 7:23
20/7/2021,Chon Buri,538,18191,1579473,770979,808494,34619,34021,598,43,38,19/1/2022 7:23
20/7/2021,Chai Nat,20,395,321220,154391,166829,3194,3194,0,,,19/1/2022 7:23
20/7/2021,Chaiyaphum,64,1431,1123243,554962,568281,6802,6802,0,,,19/1/2022 7:23
20/7/2021,Chumphon,18,488,509453,251448,258005,1865,1865,0,,,19/1/2022 7:23
20/7/2021,Trang,43,1914,640011,312941,327070,2288,2288,0,,,19/1/2022 7:23
20/7/2021,Trat,18,660,228415,112919,115496,17144,17038,106,,,19/1/2022 7:23
20/7/2021,Tak,187,2944,674330,340958,333372,13933,13933,0,,,19/1/2022 7:23
20/7/2021,Nakhon Nayok,81,1512,259525,127999,131526,3515,3515,0,,,19/1/2022 7:23
20/7/2021,Nakhon Pathom,484,9362,922047,442945,479102,4047,4047,0,25,14,19/1/2022 7:23
20/7/2021,Nakhon Phanom,40,904,717065,357305,359760,4473,4473,0,,,19/1/2022 7:23
20/7/2021,Nakhon Ratchasima,114,2928,2633481,1294026,1339455,83136,82593,543,41,21,19/1/2022 7:23
20/7/2021,Nakhon Si Thammarat,95,2255,1549708,764609,785099,8425,8425,0,,,19/1/2022 7:23
20/7/2021,Nakhon Sawan,98,1811,1037270,506043,531227,14969,14969,0,41,24,19/1/2022 7:23
20/7/2021,Nonthaburi,386,26221,1284757,597804,686953,2156,2144,12,19,9,19/1/2022 7:23
20/7/2021,Narathiwat,142,4385,808277,399788,408489,474,474,0,74,36,19/1/2022 7:23
20/7/2021,Nan,20,429,475961,238094,237867,9841,9805,36,,,19/1/2022 7:23
20/7/2021,Bueng Kan,11,190,421989,211591,210398,2816,2816,0,,,19/1/2022 7:23
20/7/2021,Buri Ram,121,1644,1579847,783934,795913,10752,10721,31,,,19/1/2022 7:23
20/7/2021,Pathum Thani,517,16666,1184541,561189,623352,1116,1103,13,34,15,19/1/2022 7:23
20/7/2021,Prachuap Khiri Khan,44,3994,552465,273938,278527,19918,19850,68,,,19/1/2022 7:23
20/7/2021,Prachin Buri,110,1995,494352,243985,250367,3384,3384,0,51,23,19/1/2022 7:23
20/7/2021,Pattani,264,6367,728613,359883,368730,585,585,0,,,19/1/2022 7:23
20/7/2021,Phra Nakhon Si Ayutthaya,198,5223,820077,393953,426124,21529,21302,227,26,35,19/1/2022 7:23
20/7/2021,Phayao,17,414,465591,226581,239010,8278,8278,0,25,15,19/1/2022 7:23
20/7/2021,Phang-nga,7,432,268377,133890,134487,5208,4622,586,,,19/1/2022 7:23
20/7/2021,Phatthalung,67,908,522778,254665,268113,1934,1934,0,,,19/1/2022 7:23
20/7/2021,Phichit,14,654,530608,258695,271913,6355,6355,0,,,19/1/2022 7:23
20/7/2021,Phitsanulok,55,1010,847773,415064,432709,26075,25939,136,,,19/1/2022 7:23
20/7/2021,Phuket,8,1078,417161,197202,219959,36699,20738,15961,65,33,19/1/2022 7:23
20/7/2021,Maha Sarakham,32,1562,950326,465921,484405,2664,2664,0,,,19/1/2022 7:23
20/7/2021,Mukdahan,18,358,351129,175445,175684,5772,5772,0,,,19/1/2022 7:23
20/7/2021,Yala,144,5346,541400,269573,271827,529,529,0,74,41,19/1/2022 7:23
20/7/2021,Yasothon,41,758,533683,266331,267352,1497,1497,0,,,19/1/2022 7:23
20/7/2021,Ranong,30,1719,194637,98230,96407,1633,1633,0,,,19/1/2022 7:23
20/7/2021,Rayong,139,4064,748108,367475,380633,20171,19927,244,34,29,19/1/2022 7:23
20/7/2021,Ratchaburi,163,3550,869206,422658,446548,10667,10667,0,,,19/1/2022 7:23
20/7/2021,Roi Et,169,1672,1296773,642509,654264,2573,2573,0,,,19/1/2022 7:23
20/7/2021,Lop Buri,86,2438,740037,368792,371245,5956,5927,29,,,19/1/2022 7:23
20/7/2021,Lampang,37,761,726701,354158,372543,6122,5950,172,54,18,19/1/2022 7:23
20/7/2021,Lamphun,6,412,401619,193055,208564,6810,6725,85,,,19/1/2022 7:23
20/7/2021,Si Sa Ket,54,1809,1457396,725574,731822,3604,3604,0,,,19/1/2022 7:23
20/7/2021,Sakon Nakhon,69,961,1146784,569879,576905,4796,4796,0,,,19/1/2022 7:23
20/7/2021,Songkhla,121,9923,1429789,696651,733138,1474,1474,0,78,48,19/1/2022 7:23
20/7/2021,Satun,23,437,324467,161491,162976,1839,1820,19,82,44,19/1/2022 7:23
20/7/2021,Samut Prakarn,676,29657,1355644,645919,709725,1526,1481,45,,,19/1/2022 7:23
20/7/2021,Samut Songkhram,28,1214,191611,91527,100084,6501,6501,0,17,11,19/1/2022 7:23
20/7/2021,Samut Sakhon,824,36275,586567,282712,303855,861,861,0,46,27,19/1/2022 7:23
20/7/2021,Saraburi,165,4237,643513,316041,327472,7419,7401,18,34,35,19/1/2022 7:23
20/7/2021,Sa kaeo,36,2273,561275,280157,281118,2531,2531,0,28,17,19/1/2022 7:23
20/7/2021,Sing Buri,17,420,205218,97486,107732,2031,2031,0,,,19/1/2022 7:23
20/7/2021,Suphan Buri,193,2814,836800,403755,433045,9449,9449,0,,,19/1/2022 7:23
20/7/2021,Surat Thani,35,2565,1070296,526627,543669,3602,3188,414,63,29,19/1/2022 7:23
20/7/2021,Surin,131,2023,1377078,685103,691975,7265,7252,13,,,19/1/2022 7:23
20/7/2021,Sukhothai,65,899,586111,283837,302274,5178,5003,175,,,19/1/2022 7:23
20/7/2021,Nong Khai,15,383,517035,256446,260589,8319,8316,3,25,11,19/1/2022 7:23
20/7/2021,Nong Bua Lam Phu,11,526,509092,253938,255154,2269,2269,0,,,19/1/2022 7:23
20/7/2021,Amnat Charoen,12,329,376294,187233,189061,1392,1392,0,,,19/1/2022 7:23
20/7/2021,Udon Thani,58,1900,1567167,776285,790882,10132,10127,5,,,19/1/2022 7:23
20/7/2021,Uttaradit,74,592,447361,218107,229254,5713,5713,0,,,19/1/2022 7:23
20/7/2021,Uthai Thani,18,431,325339,159003,166336,2109,2109,0,,,19/1/2022 7:23
20/7/2021,Ubon Ratchathani,136,2022,1867197,932136,935061,6431,6431,0,32,17,19/1/2022 7:23
20/7/2021,Ang Thong,70,1402,275675,131918,143757,1386,1386,0,,,19/1/2022 7:23
20/7/2021,Chiang Rai,22,1453,1297041,630437,666604,25803,25572,231,19,7,19/1/2022 7:23
20/7/2021,Chiang Mai,46,9104,1786622,863343,923279,69510,68521,989,49,21,19/1/2022 7:23
20/7/2021,Phetchaburi,96,10522,482401,232827,249574,15182,15093,89,,,19/1/2022 7:23
20/7/2021,Phetchabun,65,1049,979701,483282,496419,22759,22735,24,,,19/1/2022 7:23
20/7/2021,Loei,25,547,638517,320015,318502,4573,4565,8,17,12,19/1/2022 7:23
20/7/2021,Phrae,6,339,435659,209972,225687,5424,5424,0,32,12,19/1/2022 7:23
20/7/2021,Mae Hong Son,0,87,285729,144754,140975,9411,9186,225,10,3,19/1/2022 7:23
20/7/2021,,0,153,,,,,,,,,19/1/2022 7:23
21/7/2021,Krabi,16,952,478495,237646,240849,1716,1716,0,,,19/1/2022 7:23
21/7/2021,Bangkok,3161,147337,5551744,2605273,2946471,169121,147154,21967,36,30,19/1/2022 7:23
21/7/2021,Kanchanaburi,52,1607,893118,447911,445207,26909,26862,47,29,21,19/1/2022 7:23
21/7/2021,Kalasin,157,1317,976323,482572,493751,2495,2495,0,,,19/1/2022 7:23
21/7/2021,Kamphaeng Phet,67,1220,712903,351973,360930,6317,6317,0,,,19/1/2022 7:23
21/7/2021,Khon Kaen,264,2042,1792421,881179,911242,17954,17954,0,56,35,19/1/2022 7:23
21/7/2021,Chanthaburi,30,2054,535998,262065,273933,17139,17083,56,,,19/1/2022 7:23
21/7/2021,Chachoengsao,374,8676,722052,353870,368182,2359,2359,0,39,38,19/1/2022 7:23
21/7/2021,Chon Buri,636,18827,1579473,770979,808494,34619,34021,598,39,49,19/1/2022 7:23
21/7/2021,Chai Nat,11,406,321220,154391,166829,3194,3194,0,,,19/1/2022 7:23
21/7/2021,Chaiyaphum,110,1541,1123243,554962,568281,6802,6802,0,,,19/1/2022 7:23
21/7/2021,Chumphon,35,523,509453,251448,258005,1865,1865,0,,,19/1/2022 7:23
21/7/2021,Trang,49,1963,640011,312941,327070,2288,2288,0,,,19/1/2022 7:23
21/7/2021,Trat,34,694,228415,112919,115496,17144,17038,106,,,19/1/2022 7:23
21/7/2021,Tak,144,3088,674330,340958,333372,13933,13933,0,,,19/1/2022 7:23
21/7/2021,Nakhon Nayok,62,1574,259525,127999,131526,3515,3515,0,,,19/1/2022 7:23
21/7/2021,Nakhon Pathom,191,9553,922047,442945,479102,4047,4047,0,33,22,19/1/2022 7:23
21/7/2021,Nakhon Phanom,80,984,717065,357305,359760,4473,4473,0,,,19/1/2022 7:23
21/7/2021,Nakhon Ratchasima,111,3039,2633481,1294026,1339455,83136,82593,543,46,28,19/1/2022 7:23
21/7/2021,Nakhon Si Thammarat,54,2309,1549708,764609,785099,8425,8425,0,,,19/1/2022 7:23
21/7/2021,Nakhon Sawan,121,1932,1037270,506043,531227,14969,14969,0,46,33,19/1/2022 7:23
21/7/2021,Nonthaburi,661,26882,1284757,597804,686953,2156,2144,12,18,16,19/1/2022 7:23
21/7/2021,Narathiwat,139,4524,808277,399788,408489,474,474,0,81,39,19/1/2022 7:23
21/7/2021,Nan,41,470,475961,238094,237867,9841,9805,36,,,19/1/2022 7:23
21/7/2021,Bueng Kan,12,202,421989,211591,210398,2816,2816,0,,,19/1/2022 7:23
21/7/2021,Buri Ram,99,1743,1579847,783934,795913,10752,10721,31,,,19/1/2022 7:23
21/7/2021,Pathum Thani,352,17018,1184541,561189,623352,1116,1103,13,26,25,19/1/2022 7:23
21/7/2021,Prachuap Khiri Khan,43,4037,552465,273938,278527,19918,19850,68,,,19/1/2022 7:23
21/7/2021,Prachin Buri,90,2085,494352,243985,250367,3384,3384,0,50,31,19/1/2022 7:23
21/7/2021,Pattani,282,6649,728613,359883,368730,585,585,0,,,19/1/2022 7:23
21/7/2021,Phra Nakhon Si Ayutthaya,235,5458,820077,393953,426124,21529,21302,227,34,41,19/1/2022 7:23
21/7/2021,Phayao,27,441,465591,226581,239010,8278,8278,0,26,16,19/1/2022 7:23
21/7/2021,Phang-nga,5,437,268377,133890,134487,5208,4622,586,,,19/1/2022 7:23
21/7/2021,Phatthalung,13,921,522778,254665,268113,1934,1934,0,,,19/1/2022 7:23
21/7/2021,Phichit,33,687,530608,258695,271913,6355,6355,0,,,19/1/2022 7:23
21/7/2021,Phitsanulok,82,1092,847773,415064,432709,26075,25939,136,,,19/1/2022 7:23
21/7/2021,Phuket,7,1085,417161,197202,219959,36699,20738,15961,57,30,19/1/2022 7:23
21/7/2021,Maha Sarakham,169,1731,950326,465921,484405,2664,2664,0,,,19/1/2022 7:23
21/7/2021,Mukdahan,31,389,351129,175445,175684,5772,5772,0,,,19/1/2022 7:23
21/7/2021,Yala,164,5510,541400,269573,271827,529,529,0,79,49,19/1/2022 7:23
21/7/2021,Yasothon,41,799,533683,266331,267352,1497,1497,0,,,19/1/2022 7:23
21/7/2021,Ranong,61,1780,194637,98230,96407,1633,1633,0,,,19/1/2022 7:23
21/7/2021,Rayong,305,4369,748108,367475,380633,20171,19927,244,31,36,19/1/2022 7:23
21/7/2021,Ratchaburi,137,3687,869206,422658,446548,10667,10667,0,,,19/1/2022 7:23
21/7/2021,Roi Et,139,1811,1296773,642509,654264,2573,2573,0,,,19/1/2022 7:23
21/7/2021,Lop Buri,134,2572,740037,368792,371245,5956,5927,29,,,19/1/2022 7:23
21/7/2021,Lampang,46,807,726701,354158,372543,6122,5950,172,55,16,19/1/2022 7:23
21/7/2021,Lamphun,11,423,401619,193055,208564,6810,6725,85,,,19/1/2022 7:23
21/7/2021,Si Sa Ket,125,1934,1457396,725574,731822,3604,3604,0,,,19/1/2022 7:23
21/7/2021,Sakon Nakhon,78,1039,1146784,569879,576905,4796,4796,0,,,19/1/2022 7:23
21/7/2021,Songkhla,175,10098,1429789,696651,733138,1474,1474,0,89,44,19/1/2022 7:23
21/7/2021,Satun,5,442,324467,161491,162976,1839,1820,19,98,37,19/1/2022 7:23
21/7/2021,Samut Prakarn,1047,30704,1355644,645919,709725,1526,1481,45,,,19/1/2022 7:23
21/7/2021,Samut Songkhram,42,1256,191611,91527,100084,6501,6501,0,21,20,19/1/2022 7:23
21/7/2021,Samut Sakhon,942,37217,586567,282712,303855,861,861,0,44,38,19/1/2022 7:23
21/7/2021,Saraburi,200,4437,643513,316041,327472,7419,7401,18,38,37,19/1/2022 7:23
21/7/2021,Sa kaeo,54,2327,561275,280157,281118,2531,2531,0,27,27,19/1/2022 7:23
21/7/2021,Sing Buri,12,432,205218,97486,107732,2031,2031,0,,,19/1/2022 7:23
21/7/2021,Suphan Buri,212,3026,836800,403755,433045,9449,9449,0,,,19/1/2022 7:23
21/7/2021,Surat Thani,42,2607,1070296,526627,543669,3602,3188,414,50,31,19/1/2022 7:23
21/7/2021,Surin,121,2144,1377078,685103,691975,7265,7252,13,,,19/1/2022 7:23
21/7/2021,Sukhothai,71,970,586111,283837,302274,5178,5003,175,,,19/1/2022 7:23
21/7/2021,Nong Khai,29,412,517035,256446,260589,8319,8316,3,27,11,19/1/2022 7:23
21/7/2021,Nong Bua Lam Phu,39,565,509092,253938,255154,2269,2269,0,,,19/1/2022 7:23
21/7/2021,Amnat Charoen,28,357,376294,187233,189061,1392,1392,0,,,19/1/2022 7:23
21/7/2021,Udon Thani,96,1996,1567167,776285,790882,10132,10127,5,,,19/1/2022 7:23
21/7/2021,Uttaradit,66,658,447361,218107,229254,5713,5713,0,,,19/1/2022 7:23
21/7/2021,Uthai Thani,27,458,325339,159003,166336,2109,2109,0,,,19/1/2022 7:23
21/7/2021,Ubon Ratchathani,124,2146,1867197,932136,935061,6431,6431,0,37,25,19/1/2022 7:23
21/7/2021,Ang Thong,29,1431,275675,131918,143757,1386,1386,0,,,19/1/2022 7:23
21/7/2021,Chiang Rai,29,1482,1297041,630437,666604,25803,25572,231,22,7,19/1/2022 7:23
21/7/2021,Chiang Mai,47,9151,1786622,863343,923279,69510,68521,989,46,19,19/1/2022 7:23
21/7/2021,Phetchaburi,126,10648,482401,232827,249574,15182,15093,89,,,19/1/2022 7:23
21/7/2021,Phetchabun,56,1105,979701,483282,496419,22759,22735,24,,,19/1/2022 7:23
21/7/2021,Loei,38,585,638517,320015,318502,4573,4565,8,22,15,19/1/2022 7:23
21/7/2021,Phrae,23,362,435659,209972,225687,5424,5424,0,31,12,19/1/2022 7:23
21/7/2021,Mae Hong Son,1,88,285729,144754,140975,9411,9186,225,12,2,19/1/2022 7:23
21/7/2021,,0,153,,,,,,,,,19/1/2022 7:23
22/7/2021,Krabi,7,959,478495,237646,240849,1716,1716,0,,,19/1/2022 7:23
22/7/2021,Bangkok,2982,150319,5551744,2605273,2946471,169121,147154,21967,55,25,19/1/2022 7:23
22/7/2021,Kanchanaburi,119,1726,893118,447911,445207,26909,26862,47,29,16,19/1/2022 7:23
22/7/2021,Kalasin,131,1448,976323,482572,493751,2495,2495,0,,,19/1/2022 7:23
22/7/2021,Kamphaeng Phet,144,1364,712903,351973,360930,6317,6317,0,,,19/1/2022 7:23
22/7/2021,Khon Kaen,447,2489,1792421,881179,911242,17954,17954,0,63,31,19/1/2022 7:23
22/7/2021,Chanthaburi,43,2097,535998,262065,273933,17139,17083,56,,,19/1/2022 7:23
22/7/2021,Chachoengsao,251,8927,722052,353870,368182,2359,2359,0,52,37,19/1/2022 7:23
22/7/2021,Chon Buri,640,19467,1579473,770979,808494,34619,34021,598,57,40,19/1/2022 7:23
22/7/2021,Chai Nat,28,434,321220,154391,166829,3194,3194,0,,,19/1/2022 7:23
22/7/2021,Chaiyaphum,116,1657,1123243,554962,568281,6802,6802,0,,,19/1/2022 7:23
22/7/2021,Chumphon,38,561,509453,251448,258005,1865,1865,0,,,19/1/2022 7:23
22/7/2021,Trang,23,1986,640011,312941,327070,2288,2288,0,,,19/1/2022 7:23
22/7/2021,Trat,46,740,228415,112919,115496,17144,17038,106,,,19/1/2022 7:23
22/7/2021,Tak,126,3214,674330,340958,333372,13933,13933,0,,,19/1/2022 7:23
22/7/2021,Nakhon Nayok,157,1731,259525,127999,131526,3515,3515,0,,,19/1/2022 7:23
22/7/2021,Nakhon Pathom,198,9751,922047,442945,479102,4047,4047,0,49,18,19/1/2022 7:23
22/7/2021,Nakhon Phanom,102,1086,717065,357305,359760,4473,4473,0,,,19/1/2022 7:23
22/7/2021,Nakhon Ratchasima,293,3332,2633481,1294026,1339455,83136,82593,543,54,30,19/1/2022 7:23
22/7/2021,Nakhon Si Thammarat,72,2381,1549708,764609,785099,8425,8425,0,,,19/1/2022 7:23
22/7/2021,Nakhon Sawan,151,2083,1037270,506043,531227,14969,14969,0,63,24,19/1/2022 7:23
22/7/2021,Nonthaburi,416,27298,1284757,597804,686953,2156,2144,12,33,15,19/1/2022 7:23
22/7/2021,Narathiwat,124,4648,808277,399788,408489,474,474,0,76,23,19/1/2022 7:23
22/7/2021,Nan,30,500,475961,238094,237867,9841,9805,36,,,19/1/2022 7:23
22/7/2021,Bueng Kan,18,220,421989,211591,210398,2816,2816,0,,,19/1/2022 7:23
22/7/2021,Buri Ram,121,1864,1579847,783934,795913,10752,10721,31,,,19/1/2022 7:23
22/7/2021,Pathum Thani,366,17384,1184541,561189,623352,1116,1103,13,41,25,19/1/2022 7:23
22/7/2021,Prachuap Khiri Khan,59,4096,552465,273938,278527,19918,19850,68,,,19/1/2022 7:23
22/7/2021,Prachin Buri,107,2192,494352,243985,250367,3384,3384,0,59,35,19/1/2022 7:23
22/7/2021,Pattani,293,6942,728613,359883,368730,585,585,0,,,19/1/2022 7:23
22/7/2021,Phra Nakhon Si Ayutthaya,259,5717,820077,393953,426124,21529,21302,227,48,36,19/1/2022 7:23
22/7/2021,Phayao,19,460,465591,226581,239010,8278,8278,0,29,14,19/1/2022 7:23
22/7/2021,Phang-nga,2,439,268377,133890,134487,5208,4622,586,,,19/1/2022 7:23
22/7/2021,Phatthalung,73,994,522778,254665,268113,1934,1934,0,,,19/1/2022 7:23
22/7/2021,Phichit,67,754,530608,258695,271913,6355,6355,0,,,19/1/2022 7:23
22/7/2021,Phitsanulok,63,1155,847773,415064,432709,26075,25939,136,,,19/1/2022 7:23
22/7/2021,Phuket,13,1098,417161,197202,219959,36699,20738,15961,60,32,19/1/2022 7:23
22/7/2021,Maha Sarakham,116,1847,950326,465921,484405,2664,2664,0,,,19/1/2022 7:23
22/7/2021,Mukdahan,41,430,351129,175445,175684,5772,5772,0,,,19/1/2022 7:23
22/7/2021,Yala,214,5724,541400,269573,271827,529,529,0,78,33,19/1/2022 7:23
22/7/2021,Yasothon,60,859,533683,266331,267352,1497,1497,0,,,19/1/2022 7:23
22/7/2021,Ranong,65,1845,194637,98230,96407,1633,1633,0,,,19/1/2022 7:23
22/7/2021,Rayong,261,4630,748108,367475,380633,20171,19927,244,51,30,19/1/2022 7:23
22/7/2021,Ratchaburi,191,3878,869206,422658,446548,10667,10667,0,,,19/1/2022 7:23
22/7/2021,Roi Et,182,1993,1296773,642509,654264,2573,2573,0,,,19/1/2022 7:23
22/7/2021,Lop Buri,75,2647,740037,368792,371245,5956,5927,29,,,19/1/2022 7:23
22/7/2021,Lampang,15,822,726701,354158,372543,6122,5950,172,51,19,19/1/2022 7:23
22/7/2021,Lamphun,18,441,401619,193055,208564,6810,6725,85,,,19/1/2022 7:23
22/7/2021,Si Sa Ket,211,2145,1457396,725574,731822,3604,3604,0,,,19/1/2022 7:23
22/7/2021,Sakon Nakhon,90,1129,1146784,569879,576905,4796,4796,0,,,19/1/2022 7:23
22/7/2021,Songkhla,253,10351,1429789,696651,733138,1474,1474,0,82,43,19/1/2022 7:23
22/7/2021,Satun,9,451,324467,161491,162976,1839,1820,19,83,37,19/1/2022 7:23
22/7/2021,Samut Prakarn,900,31604,1355644,645919,709725,1526,1481,45,,,19/1/2022 7:23
22/7/2021,Samut Songkhram,46,1302,191611,91527,100084,6501,6501,0,40,16,19/1/2022 7:23
22/7/2021,Samut Sakhon,967,38184,586567,282712,303855,861,861,0,57,36,19/1/2022 7:23
22/7/2021,Saraburi,181,4618,643513,316041,327472,7419,7401,18,48,54,19/1/2022 7:23
22/7/2021,Sa kaeo,66,2393,561275,280157,281118,2531,2531,0,47,22,19/1/2022 7:23
22/7/2021,Sing Buri,32,464,205218,97486,107732,2031,2031,0,,,19/1/2022 7:23
22/7/2021,Suphan Buri,285,3311,836800,403755,433045,9449,9449,0,,,19/1/2022 7:23
22/7/2021,Surat Thani,36,2643,1070296,526627,543669,3602,3188,414,52,31,19/1/2022 7:23
22/7/2021,Surin,140,2284,1377078,685103,691975,7265,7252,13,,,19/1/2022 7:23
22/7/2021,Sukhothai,92,1062,586111,283837,302274,5178,5003,175,,,19/1/2022 7:23
22/7/2021,Nong Khai,36,448,517035,256446,260589,8319,8316,3,27,10,19/1/2022 7:23
22/7/2021,Nong Bua Lam Phu,19,584,509092,253938,255154,2269,2269,0,,,19/1/2022 7:23
22/7/2021,Amnat Charoen,65,422,376294,187233,189061,1392,1392,0,,,19/1/2022 7:23
22/7/2021,Udon Thani,114,2110,1567167,776285,790882,10132,10127,5,,,19/1/2022 7:23
22/7/2021,Uttaradit,69,727,447361,218107,229254,5713,5713,0,,,19/1/2022 7:23
22/7/2021,Uthai Thani,33,491,325339,159003,166336,2109,2109,0,,,19/1/2022 7:23
22/7/2021,Ubon Ratchathani,142,2288,1867197,932136,935061,6431,6431,0,51,26,19/1/2022 7:23
22/7/2021,Ang Thong,98,1529,275675,131918,143757,1386,1386,0,,,19/1/2022 7:23
22/7/2021,Chiang Rai,36,1518,1297041,630437,666604,25803,25572,231,21,7,19/1/2022 7:23
22/7/2021,Chiang Mai,64,9215,1786622,863343,923279,69510,68521,989,46,24,19/1/2022 7:23
22/7/2021,Phetchaburi,129,10777,482401,232827,249574,15182,15093,89,,,19/1/2022 7:23
22/7/2021,Phetchabun,60,1165,979701,483282,496419,22759,22735,24,,,19/1/2022 7:23
22/7/2021,Loei,73,658,638517,320015,318502,4573,4565,8,31,15,19/1/2022 7:23
22/7/2021,Phrae,16,378,435659,209972,225687,5424,5424,0,31,14,19/1/2022 7:23
22/7/2021,Mae Hong Son,11,99,285729,144754,140975,9411,9186,225,9,4,19/1/2022 7:23
22/7/2021,,0,153,,,,,,,,,19/1/2022 7:23
23/7/2021,Krabi,14,973,478495,237646,240849,1716,1716,0,,,19/1/2022 7:23
23/7/2021,Bangkok,3394,153713,5551744,2605273,2946471,169121,147154,21967,51,30,19/1/2022 7:23
23/7/2021,Kanchanaburi,116,1842,893118,447911,445207,26909,26862,47,25,20,19/1/2022 7:23
23/7/2021,Kalasin,124,1572,976323,482572,493751,2495,2495,0,,,19/1/2022 7:23
23/7/2021,Kamphaeng Phet,69,1433,712903,351973,360930,6317,6317,0,,,19/1/2022 7:23
23/7/2021,Khon Kaen,444,2933,1792421,881179,911242,17954,17954,0,62,24,19/1/2022 7:23
23/7/2021,Chanthaburi,37,2134,535998,262065,273933,17139,17083,56,,,19/1/2022 7:23
23/7/2021,Chachoengsao,352,9279,722052,353870,368182,2359,2359,0,52,39,19/1/2022 7:23
23/7/2021,Chon Buri,669,20136,1579473,770979,808494,34619,34021,598,53,42,19/1/2022 7:23
23/7/2021,Chai Nat,24,458,321220,154391,166829,3194,3194,0,,,19/1/2022 7:23
23/7/2021,Chaiyaphum,132,1789,1123243,554962,568281,6802,6802,0,,,19/1/2022 7:23
23/7/2021,Chumphon,23,584,509453,251448,258005,1865,1865,0,,,19/1/2022 7:23
23/7/2021,Trang,31,2017,640011,312941,327070,2288,2288,0,,,19/1/2022 7:23
23/7/2021,Trat,28,768,228415,112919,115496,17144,17038,106,,,19/1/2022 7:23
23/7/2021,Tak,348,3562,674330,340958,333372,13933,13933,0,,,19/1/2022 7:23
23/7/2021,Nakhon Nayok,73,1804,259525,127999,131526,3515,3515,0,,,19/1/2022 7:23
23/7/2021,Nakhon Pathom,261,10012,922047,442945,479102,4047,4047,0,45,25,19/1/2022 7:23
23/7/2021,Nakhon Phanom,76,1162,717065,357305,359760,4473,4473,0,,,19/1/2022 7:23
23/7/2021,Nakhon Ratchasima,111,3443,2633481,1294026,1339455,83136,82593,543,58,20,19/1/2022 7:23
23/7/2021,Nakhon Si Thammarat,107,2488,1549708,764609,785099,8425,8425,0,,,19/1/2022 7:23
23/7/2021,Nakhon Sawan,150,2233,1037270,506043,531227,14969,14969,0,46,32,19/1/2022 7:23
23/7/2021,Nonthaburi,305,27603,1284757,597804,686953,2156,2144,12,32,17,19/1/2022 7:23
23/7/2021,Narathiwat,146,4794,808277,399788,408489,474,474,0,52,24,19/1/2022 7:23
23/7/2021,Nan,22,522,475961,238094,237867,9841,9805,36,,,19/1/2022 7:23
23/7/2021,Bueng Kan,21,241,421989,211591,210398,2816,2816,0,,,19/1/2022 7:23
23/7/2021,Buri Ram,136,2000,1579847,783934,795913,10752,10721,31,,,19/1/2022 7:23
23/7/2021,Pathum Thani,542,17926,1184541,561189,623352,1116,1103,13,46,33,19/1/2022 7:23
23/7/2021,Prachuap Khiri Khan,61,4157,552465,273938,278527,19918,19850,68,,,19/1/2022 7:23
23/7/2021,Prachin Buri,110,2302,494352,243985,250367,3384,3384,0,70,28,19/1/2022 7:23
23/7/2021,Pattani,290,7232,728613,359883,368730,585,585,0,,,19/1/2022 7:23
23/7/2021,Phra Nakhon Si Ayutthaya,359,6076,820077,393953,426124,21529,21302,227,43,42,19/1/2022 7:23
23/7/2021,Phayao,28,488,465591,226581,239010,8278,8278,0,27,15,19/1/2022 7:23
23/7/2021,Phang-nga,4,443,268377,133890,134487,5208,4622,586,,,19/1/2022 7:23
23/7/2021,Phatthalung,67,1061,522778,254665,268113,1934,1934,0,,,19/1/2022 7:23
23/7/2021,Phichit,53,807,530608,258695,271913,6355,6355,0,,,19/1/2022 7:23
23/7/2021,Phitsanulok,49,1204,847773,415064,432709,26075,25939,136,,,19/1/2022 7:23
23/7/2021,Phuket,19,1117,417161,197202,219959,36699,20738,15961,60,32,19/1/2022 7:23
23/7/2021,Maha Sarakham,126,1973,950326,465921,484405,2664,2664,0,,,19/1/2022 7:23
23/7/2021,Mukdahan,34,464,351129,175445,175684,5772,5772,0,,,19/1/2022 7:23
23/7/2021,Yala,101,5825,541400,269573,271827,529,529,0,68,32,19/1/2022 7:23
23/7/2021,Yasothon,52,911,533683,266331,267352,1497,1497,0,,,19/1/2022 7:23
23/7/2021,Ranong,69,1914,194637,98230,96407,1633,1633,0,,,19/1/2022 7:23
23/7/2021,Rayong,516,5146,748108,367475,380633,20171,19927,244,76,35,19/1/2022 7:23
23/7/2021,Ratchaburi,155,4033,869206,422658,446548,10667,10667,0,,,19/1/2022 7:23
23/7/2021,Roi Et,135,2128,1296773,642509,654264,2573,2573,0,,,19/1/2022 7:23
23/7/2021,Lop Buri,92,2739,740037,368792,371245,5956,5927,29,,,19/1/2022 7:23
23/7/2021,Lampang,51,873,726701,354158,372543,6122,5950,172,58,18,19/1/2022 7:23
23/7/2021,Lamphun,7,448,401619,193055,208564,6810,6725,85,,,19/1/2022 7:23
23/7/2021,Si Sa Ket,208,2353,1457396,725574,731822,3604,3604,0,,,19/1/2022 7:23
23/7/2021,Sakon Nakhon,117,1246,1146784,569879,576905,4796,4796,0,,,19/1/2022 7:23
23/7/2021,Songkhla,234,10585,1429789,696651,733138,1474,1474,0,83,36,19/1/2022 7:23
23/7/2021,Satun,14,465,324467,161491,162976,1839,1820,19,82,27,19/1/2022 7:23
23/7/2021,Samut Prakarn,996,32600,1355644,645919,709725,1526,1481,45,,,19/1/2022 7:23
23/7/2021,Samut Songkhram,31,1333,191611,91527,100084,6501,6501,0,34,21,19/1/2022 7:23
23/7/2021,Samut Sakhon,1080,39264,586567,282712,303855,861,861,0,59,42,19/1/2022 7:23
23/7/2021,Saraburi,173,4791,643513,316041,327472,7419,7401,18,59,39,19/1/2022 7:23
23/7/2021,Sa kaeo,103,2496,561275,280157,281118,2531,2531,0,43,21,19/1/2022 7:23
23/7/2021,Sing Buri,20,484,205218,97486,107732,2031,2031,0,,,19/1/2022 7:23
23/7/2021,Suphan Buri,203,3514,836800,403755,433045,9449,9449,0,,,19/1/2022 7:23
23/7/2021,Surat Thani,55,2698,1070296,526627,543669,3602,3188,414,60,31,19/1/2022 7:23
23/7/2021,Surin,132,2416,1377078,685103,691975,7265,7252,13,,,19/1/2022 7:23
23/7/2021,Sukhothai,44,1106,586111,283837,302274,5178,5003,175,,,19/1/2022 7:23
23/7/2021,Nong Khai,34,482,517035,256446,260589,8319,8316,3,24,9,19/1/2022 7:23
23/7/2021,Nong Bua Lam Phu,43,627,509092,253938,255154,2269,2269,0,,,19/1/2022 7:23
23/7/2021,Amnat Charoen,37,459,376294,187233,189061,1392,1392,0,,,19/1/2022 7:23
23/7/2021,Udon Thani,101,2211,1567167,776285,790882,10132,10127,5,,,19/1/2022 7:23
23/7/2021,Uttaradit,117,844,447361,218107,229254,5713,5713,0,,,19/1/2022 7:23
23/7/2021,Uthai Thani,37,528,325339,159003,166336,2109,2109,0,,,19/1/2022 7:23
23/7/2021,Ubon Ratchathani,217,2505,1867197,932136,935061,6431,6431,0,52,17,19/1/2022 7:23
23/7/2021,Ang Thong,113,1642,275675,131918,143757,1386,1386,0,,,19/1/2022 7:23
23/7/2021,Chiang Rai,31,1549,1297041,630437,666604,25803,25572,231,26,9,19/1/2022 7:23
23/7/2021,Chiang Mai,38,9253,1786622,863343,923279,69510,68521,989,50,24,19/1/2022 7:23
23/7/2021,Phetchaburi,101,10878,482401,232827,249574,15182,15093,89,,,19/1/2022 7:23
23/7/2021,Phetchabun,99,1264,979701,483282,496419,22759,22735,24,,,19/1/2022 7:23
23/7/2021,Loei,44,702,638517,320015,318502,4573,4565,8,23,12,19/1/2022 7:23
23/7/2021,Phrae,18,396,435659,209972,225687,5424,5424,0,30,19,19/1/2022 7:23
23/7/2021,Mae Hong Son,2,101,285729,144754,140975,9411,9186,225,20,6,19/1/2022 7:23
23/7/2021,,0,153,,,,,,,,,19/1/2022 7:23
24/7/2021,Krabi,7,980,478495,237646,240849,1716,1716,0,,,19/1/2022 7:23
24/7/2021,Bangkok,2788,156501,5551744,2605273,2946471,169121,147154,21967,56,21,19/1/2022 7:23
24/7/2021,Kanchanaburi,294,2136,893118,447911,445207,26909,26862,47,33,11,19/1/2022 7:23
24/7/2021,Kalasin,200,1772,976323,482572,493751,2495,2495,0,,,19/1/2022 7:23
24/7/2021,Kamphaeng Phet,110,1543,712903,351973,360930,6317,6317,0,,,19/1/2022 7:23
24/7/2021,Khon Kaen,282,3215,1792421,881179,911242,17954,17954,0,58,24,19/1/2022 7:23
24/7/2021,Chanthaburi,75,2209,535998,262065,273933,17139,17083,56,,,19/1/2022 7:23
24/7/2021,Chachoengsao,385,9664,722052,353870,368182,2359,2359,0,62,27,19/1/2022 7:23
24/7/2021,Chon Buri,664,20800,1579473,770979,808494,34619,34021,598,56,27,19/1/2022 7:23
24/7/2021,Chai Nat,36,494,321220,154391,166829,3194,3194,0,,,19/1/2022 7:23
24/7/2021,Chaiyaphum,160,1949,1123243,554962,568281,6802,6802,0,,,19/1/2022 7:23
24/7/2021,Chumphon,32,616,509453,251448,258005,1865,1865,0,,,19/1/2022 7:23
24/7/2021,Trang,57,2074,640011,312941,327070,2288,2288,0,,,19/1/2022 7:23
24/7/2021,Trat,12,780,228415,112919,115496,17144,17038,106,,,19/1/2022 7:23
24/7/2021,Tak,171,3733,674330,340958,333372,13933,13933,0,,,19/1/2022 7:23
24/7/2021,Nakhon Nayok,142,1946,259525,127999,131526,3515,3515,0,,,19/1/2022 7:23
24/7/2021,Nakhon Pathom,220,10232,922047,442945,479102,4047,4047,0,51,16,19/1/2022 7:23
24/7/2021,Nakhon Phanom,86,1248,717065,357305,359760,4473,4473,0,,,19/1/2022 7:23
24/7/2021,Nakhon Ratchasima,156,3599,2633481,1294026,1339455,83136,82593,543,51,15,19/1/2022 7:23
24/7/2021,Nakhon Si Thammarat,139,2627,1549708,764609,785099,8425,8425,0,,,19/1/2022 7:23
24/7/2021,Nakhon Sawan,119,2352,1037270,506043,531227,14969,14969,0,62,22,19/1/2022 7:23
24/7/2021,Nonthaburi,664,28267,1284757,597804,686953,2156,2144,12,38,12,19/1/2022 7:23
24/7/2021,Narathiwat,143,4937,808277,399788,408489,474,474,0,57,29,19/1/2022 7:23
24/7/2021,Nan,32,554,475961,238094,237867,9841,9805,36,,,19/1/2022 7:23
24/7/2021,Bueng Kan,10,251,421989,211591,210398,2816,2816,0,,,19/1/2022 7:23
24/7/2021,Buri Ram,98,2098,1579847,783934,795913,10752,10721,31,,,19/1/2022 7:23
24/7/2021,Pathum Thani,286,18212,1184541,561189,623352,1116,1103,13,54,19,19/1/2022 7:23
24/7/2021,Prachuap Khiri Khan,61,4218,552465,273938,278527,19918,19850,68,,,19/1/2022 7:23
24/7/2021,Prachin Buri,200,2502,494352,243985,250367,3384,3384,0,67,23,19/1/2022 7:23
24/7/2021,Pattani,150,7382,728613,359883,368730,585,585,0,,,19/1/2022 7:23
24/7/2021,Phra Nakhon Si Ayutthaya,153,6229,820077,393953,426124,21529,21302,227,51,33,19/1/2022 7:23
24/7/2021,Phayao,46,534,465591,226581,239010,8278,8278,0,25,19,19/1/2022 7:23
24/7/2021,Phang-nga,19,462,268377,133890,134487,5208,4622,586,,,19/1/2022 7:23
24/7/2021,Phatthalung,127,1188,522778,254665,268113,1934,1934,0,,,19/1/2022 7:23
24/7/2021,Phichit,74,881,530608,258695,271913,6355,6355,0,,,19/1/2022 7:23
24/7/2021,Phitsanulok,68,1272,847773,415064,432709,26075,25939,136,,,19/1/2022 7:23
24/7/2021,Phuket,22,1139,417161,197202,219959,36699,20738,15961,57,28,19/1/2022 7:23
24/7/2021,Maha Sarakham,207,2180,950326,465921,484405,2664,2664,0,,,19/1/2022 7:23
24/7/2021,Mukdahan,18,482,351129,175445,175684,5772,5772,0,,,19/1/2022 7:23
24/7/2021,Yala,172,5997,541400,269573,271827,529,529,0,67,32,19/1/2022 7:23
24/7/2021,Yasothon,40,951,533683,266331,267352,1497,1497,0,,,19/1/2022 7:23
24/7/2021,Ranong,67,1981,194637,98230,96407,1633,1633,0,,,19/1/2022 7:23
24/7/2021,Rayong,332,5478,748108,367475,380633,20171,19927,244,57,24,19/1/2022 7:23
24/7/2021,Ratchaburi,200,4233,869206,422658,446548,10667,10667,0,,,19/1/2022 7:23
24/7/2021,Roi Et,147,2275,1296773,642509,654264,2573,2573,0,,,19/1/2022 7:23
24/7/2021,Lop Buri,125,2864,740037,368792,371245,5956,5927,29,,,19/1/2022 7:23
24/7/2021,Lampang,44,917,726701,354158,372543,6122,5950,172,57,22,19/1/2022 7:23
24/7/2021,Lamphun,16,464,401619,193055,208564,6810,6725,85,,,19/1/2022 7:23
24/7/2021,Si Sa Ket,158,2511,1457396,725574,731822,3604,3604,0,,,19/1/2022 7:23
24/7/2021,Sakon Nakhon,63,1309,1146784,569879,576905,4796,4796,0,,,19/1/2022 7:23
24/7/2021,Songkhla,172,10757,1429789,696651,733138,1474,1474,0,69,32,19/1/2022 7:23
24/7/2021,Satun,17,482,324467,161491,162976,1839,1820,19,60,34,19/1/2022 7:23
24/7/2021,Samut Prakarn,1314,33914,1355644,645919,709725,1526,1481,45,,,19/1/2022 7:23
24/7/2021,Samut Songkhram,69,1402,191611,91527,100084,6501,6501,0,44,11,19/1/2022 7:23
24/7/2021,Samut Sakhon,1058,40322,586567,282712,303855,861,861,0,64,28,19/1/2022 7:23
24/7/2021,Saraburi,171,4962,643513,316041,327472,7419,7401,18,52,30,19/1/2022 7:23
24/7/2021,Sa kaeo,62,2558,561275,280157,281118,2531,2531,0,41,16,19/1/2022 7:23
24/7/2021,Sing Buri,12,496,205218,97486,107732,2031,2031,0,,,19/1/2022 7:23
24/7/2021,Suphan Buri,184,3698,836800,403755,433045,9449,9449,0,,,19/1/2022 7:23
24/7/2021,Surat Thani,45,2743,1070296,526627,543669,3602,3188,414,53,30,19/1/2022 7:23
24/7/2021,Surin,195,2611,1377078,685103,691975,7265,7252,13,,,19/1/2022 7:23
24/7/2021,Sukhothai,39,1145,586111,283837,302274,5178,5003,175,,,19/1/2022 7:23
24/7/2021,Nong Khai,39,521,517035,256446,260589,8319,8316,3,21,11,19/1/2022 7:23
24/7/2021,Nong Bua Lam Phu,52,679,509092,253938,255154,2269,2269,0,,,19/1/2022 7:23
24/7/2021,Amnat Charoen,21,480,376294,187233,189061,1392,1392,0,,,19/1/2022 7:23
24/7/2021,Udon Thani,158,2369,1567167,776285,790882,10132,10127,5,,,19/1/2022 7:23
24/7/2021,Uttaradit,38,882,447361,218107,229254,5713,5713,0,,,19/1/2022 7:23
24/7/2021,Uthai Thani,72,600,325339,159003,166336,2109,2109,0,,,19/1/2022 7:23
24/7/2021,Ubon Ratchathani,224,2729,1867197,932136,935061,6431,6431,0,43,11,19/1/2022 7:23
24/7/2021,Ang Thong,107,1749,275675,131918,143757,1386,1386,0,,,19/1/2022 7:23
24/7/2021,Chiang Rai,26,1575,1297041,630437,666604,25803,25572,231,27,11,19/1/2022 7:23
24/7/2021,Chiang Mai,35,9288,1786622,863343,923279,69510,68521,989,55,28,19/1/2022 7:23
24/7/2021,Phetchaburi,130,11008,482401,232827,249574,15182,15093,89,,,19/1/2022 7:23
24/7/2021,Phetchabun,66,1330,979701,483282,496419,22759,22735,24,,,19/1/2022 7:23
24/7/2021,Loei,44,746,638517,320015,318502,4573,4565,8,21,14,19/1/2022 7:23
24/7/2021,Phrae,22,418,435659,209972,225687,5424,5424,0,41,15,19/1/2022 7:23
24/7/2021,Mae Hong Son,11,112,285729,144754,140975,9411,9186,225,23,6,19/1/2022 7:23
24/7/2021,,0,153,,,,,,,,,19/1/2022 7:23
25/7/2021,Krabi,7,987,478495,237646,240849,1716,1716,0,,,19/1/2022 7:23
25/7/2021,Bangkok,2752,159253,5551744,2605273,2946471,169121,147154,21967,44,22,19/1/2022 7:23
25/7/2021,Kanchanaburi,63,2199,893118,447911,445207,26909,26862,47,17,12,19/1/2022 7:23
25/7/2021,Kalasin,139,1911,976323,482572,493751,2495,2495,0,,,19/1/2022 7:23
25/7/2021,Kamphaeng Phet,120,1663,712903,351973,360930,6317,6317,0,,,19/1/2022 7:23
25/7/2021,Khon Kaen,397,3612,1792421,881179,911242,17954,17954,0,46,28,19/1/2022 7:23
25/7/2021,Chanthaburi,111,2320,535998,262065,273933,17139,17083,56,,,19/1/2022 7:23
25/7/2021,Chachoengsao,571,10235,722052,353870,368182,2359,2359,0,51,38,19/1/2022 7:23
25/7/2021,Chon Buri,800,21600,1579473,770979,808494,34619,34021,598,42,38,19/1/2022 7:23
25/7/2021,Chai Nat,23,517,321220,154391,166829,3194,3194,0,,,19/1/2022 7:23
25/7/2021,Chaiyaphum,155,2104,1123243,554962,568281,6802,6802,0,,,19/1/2022 7:23
25/7/2021,Chumphon,30,646,509453,251448,258005,1865,1865,0,,,19/1/2022 7:23
25/7/2021,Trang,71,2145,640011,312941,327070,2288,2288,0,,,19/1/2022 7:23
25/7/2021,Trat,65,845,228415,112919,115496,17144,17038,106,,,19/1/2022 7:23
25/7/2021,Tak,235,3968,674330,340958,333372,13933,13933,0,,,19/1/2022 7:23
25/7/2021,Nakhon Nayok,227,2173,259525,127999,131526,3515,3515,0,,,19/1/2022 7:23
25/7/2021,Nakhon Pathom,384,10616,922047,442945,479102,4047,4047,0,38,21,19/1/2022 7:23
25/7/2021,Nakhon Phanom,99,1347,717065,357305,359760,4473,4473,0,,,19/1/2022 7:23
25/7/2021,Nakhon Ratchasima,241,3840,2633481,1294026,1339455,83136,82593,543,36,27,19/1/2022 7:23
25/7/2021,Nakhon Si Thammarat,79,2706,1549708,764609,785099,8425,8425,0,,,19/1/2022 7:23
25/7/2021,Nakhon Sawan,155,2507,1037270,506043,531227,14969,14969,0,40,24,19/1/2022 7:23
25/7/2021,Nonthaburi,587,28854,1284757,597804,686953,2156,2144,12,28,15,19/1/2022 7:23
25/7/2021,Narathiwat,109,5046,808277,399788,408489,474,474,0,66,34,19/1/2022 7:23
25/7/2021,Nan,39,593,475961,238094,237867,9841,9805,36,,,19/1/2022 7:23
25/7/2021,Bueng Kan,16,267,421989,211591,210398,2816,2816,0,,,19/1/2022 7:23
25/7/2021,Buri Ram,178,2276,1579847,783934,795913,10752,10721,31,,,19/1/2022 7:23
25/7/2021,Pathum Thani,420,18632,1184541,561189,623352,1116,1103,13,34,23,19/1/2022 7:23
25/7/2021,Prachuap Khiri Khan,45,4263,552465,273938,278527,19918,19850,68,,,19/1/2022 7:23
25/7/2021,Prachin Buri,105,2607,494352,243985,250367,3384,3384,0,62,27,19/1/2022 7:23
25/7/2021,Pattani,276,7658,728613,359883,368730,585,585,0,,,19/1/2022 7:23
25/7/2021,Phra Nakhon Si Ayutthaya,379,6608,820077,393953,426124,21529,21302,227,34,36,19/1/2022 7:23
25/7/2021,Phayao,18,552,465591,226581,239010,8278,8278,0,41,17,19/1/2022 7:23
25/7/2021,Phang-nga,12,474,268377,133890,134487,5208,4622,586,,,19/1/2022 7:23
25/7/2021,Phatthalung,52,1240,522778,254665,268113,1934,1934,0,,,19/1/2022 7:23
25/7/2021,Phichit,33,914,530608,258695,271913,6355,6355,0,,,19/1/2022 7:23
25/7/2021,Phitsanulok,55,1327,847773,415064,432709,26075,25939,136,,,19/1/2022 7:23
25/7/2021,Phuket,15,1154,417161,197202,219959,36699,20738,15961,51,25,19/1/2022 7:23
25/7/2021,Maha Sarakham,199,2379,950326,465921,484405,2664,2664,0,,,19/1/2022 7:23
25/7/2021,Mukdahan,33,515,351129,175445,175684,5772,5772,0,,,19/1/2022 7:23
25/7/2021,Yala,221,6218,541400,269573,271827,529,529,0,67,34,19/1/2022 7:23
25/7/2021,Yasothon,88,1039,533683,266331,267352,1497,1497,0,,,19/1/2022 7:23
25/7/2021,Ranong,71,2052,194637,98230,96407,1633,1633,0,,,19/1/2022 7:23
25/7/2021,Rayong,322,5800,748108,367475,380633,20171,19927,244,49,24,19/1/2022 7:23
25/7/2021,Ratchaburi,210,4443,869206,422658,446548,10667,10667,0,,,19/1/2022 7:23
25/7/2021,Roi Et,146,2421,1296773,642509,654264,2573,2573,0,,,19/1/2022 7:23
25/7/2021,Lop Buri,105,2969,740037,368792,371245,5956,5927,29,,,19/1/2022 7:23
25/7/2021,Lampang,10,927,726701,354158,372543,6122,5950,172,66,19,19/1/2022 7:23
25/7/2021,Lamphun,25,489,401619,193055,208564,6810,6725,85,,,19/1/2022 7:23
25/7/2021,Si Sa Ket,116,2627,1457396,725574,731822,3604,3604,0,,,19/1/2022 7:23
25/7/2021,Sakon Nakhon,29,1338,1146784,569879,576905,4796,4796,0,,,19/1/2022 7:23
25/7/2021,Songkhla,206,10963,1429789,696651,733138,1474,1474,0,62,38,19/1/2022 7:23
25/7/2021,Satun,61,543,324467,161491,162976,1839,1820,19,73,25,19/1/2022 7:23
25/7/2021,Samut Prakarn,1056,34970,1355644,645919,709725,1526,1481,45,,,19/1/2022 7:23
25/7/2021,Samut Songkhram,61,1463,191611,91527,100084,6501,6501,0,23,12,19/1/2022 7:23
25/7/2021,Samut Sakhon,1082,41404,586567,282712,303855,861,861,0,53,35,19/1/2022 7:23
25/7/2021,Saraburi,241,5203,643513,316041,327472,7419,7401,18,38,40,19/1/2022 7:23
25/7/2021,Sa kaeo,78,2636,561275,280157,281118,2531,2531,0,33,23,19/1/2022 7:23
25/7/2021,Sing Buri,36,532,205218,97486,107732,2031,2031,0,,,19/1/2022 7:23
25/7/2021,Suphan Buri,183,3881,836800,403755,433045,9449,9449,0,,,19/1/2022 7:23
25/7/2021,Surat Thani,110,2853,1070296,526627,543669,3602,3188,414,54,29,19/1/2022 7:23
25/7/2021,Surin,169,2780,1377078,685103,691975,7265,7252,13,,,19/1/2022 7:23
25/7/2021,Sukhothai,205,1350,586111,283837,302274,5178,5003,175,,,19/1/2022 7:23
25/7/2021,Nong Khai,40,561,517035,256446,260589,8319,8316,3,27,9,19/1/2022 7:23
25/7/2021,Nong Bua Lam Phu,45,724,509092,253938,255154,2269,2269,0,,,19/1/2022 7:23
25/7/2021,Amnat Charoen,73,553,376294,187233,189061,1392,1392,0,,,19/1/2022 7:23
25/7/2021,Udon Thani,180,2549,1567167,776285,790882,10132,10127,5,,,19/1/2022 7:23
25/7/2021,Uttaradit,70,952,447361,218107,229254,5713,5713,0,,,19/1/2022 7:23
25/7/2021,Uthai Thani,56,656,325339,159003,166336,2109,2109,0,,,19/1/2022 7:23
25/7/2021,Ubon Ratchathani,260,2989,1867197,932136,935061,6431,6431,0,24,23,19/1/2022 7:23
25/7/2021,Ang Thong,119,1868,275675,131918,143757,1386,1386,0,,,19/1/2022 7:23
25/7/2021,Chiang Rai,22,1597,1297041,630437,666604,25803,25572,231,36,8,19/1/2022 7:23
25/7/2021,Chiang Mai,54,9342,1786622,863343,923279,69510,68521,989,63,26,19/1/2022 7:23
25/7/2021,Phetchaburi,156,11164,482401,232827,249574,15182,15093,89,,,19/1/2022 7:23
25/7/2021,Phetchabun,73,1403,979701,483282,496419,22759,22735,24,,,19/1/2022 7:23
25/7/2021,Loei,45,791,638517,320015,318502,4573,4565,8,22,15,19/1/2022 7:23
25/7/2021,Phrae,12,430,435659,209972,225687,5424,5424,0,33,15,19/1/2022 7:23
25/7/2021,Mae Hong Son,4,116,285729,144754,140975,9411,9186,225,24,4,19/1/2022 7:23
25/7/2021,,0,153,,,,,,,,,19/1/2022 7:23
26/7/2021,Krabi,20,1007,478495,237646,240849,1716,1716,0,,,19/1/2022 7:23
26/7/2021,Bangkok,2631,161884,5551744,2605273,2946471,169121,147154,21967,48,21,19/1/2022 7:23
26/7/2021,Kanchanaburi,557,2756,893118,447911,445207,26909,26862,47,27,10,19/1/2022 7:23
26/7/2021,Kalasin,136,2047,976323,482572,493751,2495,2495,0,,,19/1/2022 7:23
26/7/2021,Kamphaeng Phet,138,1801,712903,351973,360930,6317,6317,0,,,19/1/2022 7:23
26/7/2021,Khon Kaen,98,3710,1792421,881179,911242,17954,17954,0,52,31,19/1/2022 7:23
26/7/2021,Chanthaburi,71,2391,535998,262065,273933,17139,17083,56,,,19/1/2022 7:23
26/7/2021,Chachoengsao,320,10555,722052,353870,368182,2359,2359,0,38,30,19/1/2022 7:23
26/7/2021,Chon Buri,876,22476,1579473,770979,808494,34619,34021,598,47,37,19/1/2022 7:23
26/7/2021,Chai Nat,26,543,321220,154391,166829,3194,3194,0,,,19/1/2022 7:23
26/7/2021,Chaiyaphum,68,2172,1123243,554962,568281,6802,6802,0,,,19/1/2022 7:23
26/7/2021,Chumphon,43,689,509453,251448,258005,1865,1865,0,,,19/1/2022 7:23
26/7/2021,Trang,40,2185,640011,312941,327070,2288,2288,0,,,19/1/2022 7:23
26/7/2021,Trat,63,908,228415,112919,115496,17144,17038,106,,,19/1/2022 7:23
26/7/2021,Tak,150,4118,674330,340958,333372,13933,13933,0,,,19/1/2022 7:23
26/7/2021,Nakhon Nayok,61,2234,259525,127999,131526,3515,3515,0,,,19/1/2022 7:23
26/7/2021,Nakhon Pathom,460,11076,922047,442945,479102,4047,4047,0,49,13,19/1/2022 7:23
26/7/2021,Nakhon Phanom,122,1469,717065,357305,359760,4473,4473,0,,,19/1/2022 7:23
26/7/2021,Nakhon Ratchasima,205,4045,2633481,1294026,1339455,83136,82593,543,54,23,19/1/2022 7:23
26/7/2021,Nakhon Si Thammarat,259,2965,1549708,764609,785099,8425,8425,0,,,19/1/2022 7:23
26/7/2021,Nakhon Sawan,110,2617,1037270,506043,531227,14969,14969,0,43,24,19/1/2022 7:23
26/7/2021,Nonthaburi,719,29573,1284757,597804,686953,2156,2144,12,35,10,19/1/2022 7:23
26/7/2021,Narathiwat,193,5239,808277,399788,408489,474,474,0,82,26,19/1/2022 7:23
26/7/2021,Nan,41,634,475961,238094,237867,9841,9805,36,,,19/1/2022 7:23
26/7/2021,Bueng Kan,45,312,421989,211591,210398,2816,2816,0,,,19/1/2022 7:23
26/7/2021,Buri Ram,66,2342,1579847,783934,795913,10752,10721,31,,,19/1/2022 7:23
26/7/2021,Pathum Thani,477,19109,1184541,561189,623352,1116,1103,13,39,17,19/1/2022 7:23
26/7/2021,Prachuap Khiri Khan,56,4319,552465,273938,278527,19918,19850,68,,,19/1/2022 7:23
26/7/2021,Prachin Buri,101,2708,494352,243985,250367,3384,3384,0,59,24,19/1/2022 7:23
26/7/2021,Pattani,150,7808,728613,359883,368730,585,585,0,,,19/1/2022 7:23
26/7/2021,Phra Nakhon Si Ayutthaya,292,6900,820077,393953,426124,21529,21302,227,34,32,19/1/2022 7:23
26/7/2021,Phayao,28,580,465591,226581,239010,8278,8278,0,32,15,19/1/2022 7:23
26/7/2021,Phang-nga,29,503,268377,133890,134487,5208,4622,586,,,19/1/2022 7:23
26/7/2021,Phatthalung,57,1297,522778,254665,268113,1934,1934,0,,,19/1/2022 7:23
26/7/2021,Phichit,75,989,530608,258695,271913,6355,6355,0,,,19/1/2022 7:23
26/7/2021,Phitsanulok,51,1378,847773,415064,432709,26075,25939,136,,,19/1/2022 7:23
26/7/2021,Phuket,29,1183,417161,197202,219959,36699,20738,15961,49,28,19/1/2022 7:23
26/7/2021,Maha Sarakham,167,2546,950326,465921,484405,2664,2664,0,,,19/1/2022 7:23
26/7/2021,Mukdahan,21,536,351129,175445,175684,5772,5772,0,,,19/1/2022 7:23
26/7/2021,Yala,122,6340,541400,269573,271827,529,529,0,71,28,19/1/2022 7:23
26/7/2021,Yasothon,54,1093,533683,266331,267352,1497,1497,0,,,19/1/2022 7:23
26/7/2021,Ranong,80,2132,194637,98230,96407,1633,1633,0,,,19/1/2022 7:23
26/7/2021,Rayong,411,6211,748108,367475,380633,20171,19927,244,40,24,19/1/2022 7:23
26/7/2021,Ratchaburi,164,4607,869206,422658,446548,10667,10667,0,,,19/1/2022 7:23
26/7/2021,Roi Et,208,2629,1296773,642509,654264,2573,2573,0,,,19/1/2022 7:23
26/7/2021,Lop Buri,185,3154,740037,368792,371245,5956,5927,29,,,19/1/2022 7:23
26/7/2021,Lampang,45,972,726701,354158,372543,6122,5950,172,45,17,19/1/2022 7:23
26/7/2021,Lamphun,13,502,401619,193055,208564,6810,6725,85,,,19/1/2022 7:23
26/7/2021,Si Sa Ket,183,2810,1457396,725574,731822,3604,3604,0,,,19/1/2022 7:23
26/7/2021,Sakon Nakhon,107,1445,1146784,569879,576905,4796,4796,0,,,19/1/2022 7:23
26/7/2021,Songkhla,197,11160,1429789,696651,733138,1474,1474,0,71,31,19/1/2022 7:23
26/7/2021,Satun,11,554,324467,161491,162976,1839,1820,19,56,34,19/1/2022 7:23
26/7/2021,Samut Prakarn,1188,36158,1355644,645919,709725,1526,1481,45,,,19/1/2022 7:23
26/7/2021,Samut Songkhram,66,1529,191611,91527,100084,6501,6501,0,25,8,19/1/2022 7:23
26/7/2021,Samut Sakhon,1075,42479,586567,282712,303855,861,861,0,54,28,19/1/2022 7:23
26/7/2021,Saraburi,305,5508,643513,316041,327472,7419,7401,18,42,45,19/1/2022 7:23
26/7/2021,Sa kaeo,58,2694,561275,280157,281118,2531,2531,0,41,20,19/1/2022 7:23
26/7/2021,Sing Buri,15,547,205218,97486,107732,2031,2031,0,,,19/1/2022 7:23
26/7/2021,Suphan Buri,171,4052,836800,403755,433045,9449,9449,0,,,19/1/2022 7:23
26/7/2021,Surat Thani,51,2904,1070296,526627,543669,3602,3188,414,47,27,19/1/2022 7:23
26/7/2021,Surin,200,2980,1377078,685103,691975,7265,7252,13,,,19/1/2022 7:23
26/7/2021,Sukhothai,76,1426,586111,283837,302274,5178,5003,175,,,19/1/2022 7:23
26/7/2021,Nong Khai,52,613,517035,256446,260589,8319,8316,3,23,10,19/1/2022 7:23
26/7/2021,Nong Bua Lam Phu,79,803,509092,253938,255154,2269,2269,0,,,19/1/2022 7:23
26/7/2021,Amnat Charoen,10,563,376294,187233,189061,1392,1392,0,,,19/1/2022 7:23
26/7/2021,Udon Thani,241,2790,1567167,776285,790882,10132,10127,5,,,19/1/2022 7:23
26/7/2021,Uttaradit,40,992,447361,218107,229254,5713,5713,0,,,19/1/2022 7:23
26/7/2021,Uthai Thani,36,692,325339,159003,166336,2109,2109,0,,,19/1/2022 7:23
26/7/2021,Ubon Ratchathani,242,3231,1867197,932136,935061,6431,6431,0,44,24,19/1/2022 7:23
26/7/2021,Ang Thong,144,2012,275675,131918,143757,1386,1386,0,,,19/1/2022 7:23
26/7/2021,Chiang Rai,36,1633,1297041,630437,666604,25803,25572,231,27,9,19/1/2022 7:23
26/7/2021,Chiang Mai,100,9442,1786622,863343,923279,69510,68521,989,60,27,19/1/2022 7:23
26/7/2021,Phetchaburi,121,11285,482401,232827,249574,15182,15093,89,,,19/1/2022 7:23
26/7/2021,Phetchabun,132,1535,979701,483282,496419,22759,22735,24,,,19/1/2022 7:23
26/7/2021,Loei,61,852,638517,320015,318502,4573,4565,8,24,16,19/1/2022 7:23
26/7/2021,Phrae,37,467,435659,209972,225687,5424,5424,0,34,16,19/1/2022 7:23
26/7/2021,Mae Hong Son,9,125,285729,144754,140975,9411,9186,225,18,5,19/1/2022 7:23
26/7/2021,,0,153,,,,,,,,,19/1/2022 7:23
27/7/2021,Krabi,6,1013,478495,237646,240849,1716,1716,0,,,19/1/2022 7:23
27/7/2021,Bangkok,2653,164537,5551744,2605273,2946471,169121,147154,21967,40,22,19/1/2022 7:23
27/7/2021,Kanchanaburi,103,2859,893118,447911,445207,26909,26862,47,25,12,19/1/2022 7:23
27/7/2021,Kalasin,125,2172,976323,482572,493751,2495,2495,0,,,19/1/2022 7:23
27/7/2021,Kamphaeng Phet,115,1916,712903,351973,360930,6317,6317,0,,,19/1/2022 7:23
27/7/2021,Khon Kaen,127,3837,1792421,881179,911242,17954,17954,0,63,29,19/1/2022 7:23
27/7/2021,Chanthaburi,72,2463,535998,262065,273933,17139,17083,56,,,19/1/2022 7:23
27/7/2021,Chachoengsao,486,11041,722052,353870,368182,2359,2359,0,41,30,19/1/2022 7:23
27/7/2021,Chon Buri,884,23360,1579473,770979,808494,34619,34021,598,42,36,19/1/2022 7:23
27/7/2021,Chai Nat,41,584,321220,154391,166829,3194,3194,0,,,19/1/2022 7:23
27/7/2021,Chaiyaphum,100,2272,1123243,554962,568281,6802,6802,0,,,19/1/2022 7:23
27/7/2021,Chumphon,42,731,509453,251448,258005,1865,1865,0,,,19/1/2022 7:23
27/7/2021,Trang,40,2225,640011,312941,327070,2288,2288,0,,,19/1/2022 7:23
27/7/2021,Trat,41,949,228415,112919,115496,17144,17038,106,,,19/1/2022 7:23
27/7/2021,Tak,155,4273,674330,340958,333372,13933,13933,0,,,19/1/2022 7:23
27/7/2021,Nakhon Nayok,190,2424,259525,127999,131526,3515,3515,0,,,19/1/2022 7:23
27/7/2021,Nakhon Pathom,238,11314,922047,442945,479102,4047,4047,0,34,17,19/1/2022 7:23
27/7/2021,Nakhon Phanom,113,1582,717065,357305,359760,4473,4473,0,,,19/1/2022 7:23
27/7/2021,Nakhon Ratchasima,226,4271,2633481,1294026,1339455,83136,82593,543,46,22,19/1/2022 7:23
27/7/2021,Nakhon Si Thammarat,82,3047,1549708,764609,785099,8425,8425,0,,,19/1/2022 7:23
27/7/2021,Nakhon Sawan,130,2747,1037270,506043,531227,14969,14969,0,44,20,19/1/2022 7:23
27/7/2021,Nonthaburi,536,30109,1284757,597804,686953,2156,2144,12,24,13,19/1/2022 7:23
27/7/2021,Narathiwat,124,5363,808277,399788,408489,474,474,0,62,27,19/1/2022 7:23
27/7/2021,Nan,35,669,475961,238094,237867,9841,9805,36,,,19/1/2022 7:23
27/7/2021,Bueng Kan,35,347,421989,211591,210398,2816,2816,0,,,19/1/2022 7:23
27/7/2021,Buri Ram,136,2478,1579847,783934,795913,10752,10721,31,,,19/1/2022 7:23
27/7/2021,Pathum Thani,301,19410,1184541,561189,623352,1116,1103,13,35,17,19/1/2022 7:23
27/7/2021,Prachuap Khiri Khan,176,4495,552465,273938,278527,19918,19850,68,,,19/1/2022 7:23
27/7/2021,Prachin Buri,95,2803,494352,243985,250367,3384,3384,0,55,23,19/1/2022 7:23
27/7/2021,Pattani,258,8066,728613,359883,368730,585,585,0,,,19/1/2022 7:23
27/7/2021,Phra Nakhon Si Ayutthaya,149,7049,820077,393953,426124,21529,21302,227,30,35,19/1/2022 7:23
27/7/2021,Phayao,37,617,465591,226581,239010,8278,8278,0,38,15,19/1/2022 7:23
27/7/2021,Phang-nga,14,517,268377,133890,134487,5208,4622,586,,,19/1/2022 7:23
27/7/2021,Phatthalung,38,1335,522778,254665,268113,1934,1934,0,,,19/1/2022 7:23
27/7/2021,Phichit,27,1016,530608,258695,271913,6355,6355,0,,,19/1/2022 7:23
27/7/2021,Phitsanulok,83,1461,847773,415064,432709,26075,25939,136,,,19/1/2022 7:23
27/7/2021,Phuket,29,1212,417161,197202,219959,36699,20738,15961,52,26,19/1/2022 7:23
27/7/2021,Maha Sarakham,175,2721,950326,465921,484405,2664,2664,0,,,19/1/2022 7:23
27/7/2021,Mukdahan,46,582,351129,175445,175684,5772,5772,0,,,19/1/2022 7:23
27/7/2021,Yala,132,6472,541400,269573,271827,529,529,0,57,25,19/1/2022 7:23
27/7/2021,Yasothon,123,1216,533683,266331,267352,1497,1497,0,,,19/1/2022 7:23
27/7/2021,Ranong,11,2143,194637,98230,96407,1633,1633,0,,,19/1/2022 7:23
27/7/2021,Rayong,314,6525,748108,367475,380633,20171,19927,244,32,24,19/1/2022 7:23
27/7/2021,Ratchaburi,100,4707,869206,422658,446548,10667,10667,0,,,19/1/2022 7:23
27/7/2021,Roi Et,236,2865,1296773,642509,654264,2573,2573,0,,,19/1/2022 7:23
27/7/2021,Lop Buri,165,3319,740037,368792,371245,5956,5927,29,,,19/1/2022 7:23
27/7/2021,Lampang,35,1007,726701,354158,372543,6122,5950,172,27,18,19/1/2022 7:23
27/7/2021,Lamphun,17,519,401619,193055,208564,6810,6725,85,,,19/1/2022 7:23
27/7/2021,Si Sa Ket,185,2995,1457396,725574,731822,3604,3604,0,,,19/1/2022 7:23
27/7/2021,Sakon Nakhon,239,1684,1146784,569879,576905,4796,4796,0,,,19/1/2022 7:23
27/7/2021,Songkhla,196,11356,1429789,696651,733138,1474,1474,0,53,28,19/1/2022 7:23
27/7/2021,Satun,23,577,324467,161491,162976,1839,1820,19,63,25,19/1/2022 7:23
27/7/2021,Samut Prakarn,719,36877,1355644,645919,709725,1526,1481,45,,,19/1/2022 7:23
27/7/2021,Samut Songkhram,68,1597,191611,91527,100084,6501,6501,0,14,10,19/1/2022 7:23
27/7/2021,Samut Sakhon,1092,43571,586567,282712,303855,861,861,0,44,26,19/1/2022 7:23
27/7/2021,Saraburi,272,5780,643513,316041,327472,7419,7401,18,47,39,19/1/2022 7:23
27/7/2021,Sa kaeo,289,2983,561275,280157,281118,2531,2531,0,33,17,19/1/2022 7:23
27/7/2021,Sing Buri,33,580,205218,97486,107732,2031,2031,0,,,19/1/2022 7:23
27/7/2021,Suphan Buri,219,4271,836800,403755,433045,9449,9449,0,,,19/1/2022 7:23
27/7/2021,Surat Thani,49,2953,1070296,526627,543669,3602,3188,414,64,26,19/1/2022 7:23
27/7/2021,Surin,193,3173,1377078,685103,691975,7265,7252,13,,,19/1/2022 7:23
27/7/2021,Sukhothai,69,1495,586111,283837,302274,5178,5003,175,,,19/1/2022 7:23
27/7/2021,Nong Khai,46,659,517035,256446,260589,8319,8316,3,23,8,19/1/2022 7:23
27/7/2021,Nong Bua Lam Phu,79,882,509092,253938,255154,2269,2269,0,,,19/1/2022 7:23
27/7/2021,Amnat Charoen,29,592,376294,187233,189061,1392,1392,0,,,19/1/2022 7:23
27/7/2021,Udon Thani,111,2901,1567167,776285,790882,10132,10127,5,,,19/1/2022 7:23
27/7/2021,Uttaradit,100,1092,447361,218107,229254,5713,5713,0,,,19/1/2022 7:23
27/7/2021,Uthai Thani,19,711,325339,159003,166336,2109,2109,0,,,19/1/2022 7:23
27/7/2021,Ubon Ratchathani,289,3520,1867197,932136,935061,6431,6431,0,50,20,19/1/2022 7:23
27/7/2021,Ang Thong,83,2095,275675,131918,143757,1386,1386,0,,,19/1/2022 7:23
27/7/2021,Chiang Rai,23,1656,1297041,630437,666604,25803,25572,231,31,8,19/1/2022 7:23
27/7/2021,Chiang Mai,46,9488,1786622,863343,923279,69510,68521,989,59,25,19/1/2022 7:23
27/7/2021,Phetchaburi,103,11388,482401,232827,249574,15182,15093,89,,,19/1/2022 7:23
27/7/2021,Phetchabun,104,1639,979701,483282,496419,22759,22735,24,,,19/1/2022 7:23
27/7/2021,Loei,51,903,638517,320015,318502,4573,4565,8,29,14,19/1/2022 7:23
27/7/2021,Phrae,22,489,435659,209972,225687,5424,5424,0,37,14,19/1/2022 7:23
27/7/2021,Mae Hong Son,3,128,285729,144754,140975,9411,9186,225,20,7,19/1/2022 7:23
27/7/2021,,0,153,,,,,,,,,19/1/2022 7:23
28/7/2021,Krabi,16,1029,478495,237646,240849,1716,1716,0,,,19/1/2022 7:23
28/7/2021,Bangkok,4047,168584,5551744,2605273,2946471,169121,147154,21967,45,23,19/1/2022 7:23
28/7/2021,Kanchanaburi,585,3444,893118,447911,445207,26909,26862,47,34,16,19/1/2022 7:23
28/7/2021,Kalasin,107,2279,976323,482572,493751,2495,2495,0,,,19/1/2022 7:23
28/7/2021,Kamphaeng Phet,85,2001,712903,351973,360930,6317,6317,0,,,19/1/2022 7:23
28/7/2021,Khon Kaen,89,3926,1792421,881179,911242,17954,17954,0,55,33,19/1/2022 7:23
28/7/2021,Chanthaburi,46,2509,535998,262065,273933,17139,17083,56,,,19/1/2022 7:23
28/7/2021,Chachoengsao,447,11488,722052,353870,368182,2359,2359,0,42,31,19/1/2022 7:23
28/7/2021,Chon Buri,864,24224,1579473,770979,808494,34619,34021,598,38,38,19/1/2022 7:23
28/7/2021,Chai Nat,56,640,321220,154391,166829,3194,3194,0,,,19/1/2022 7:23
28/7/2021,Chaiyaphum,93,2365,1123243,554962,568281,6802,6802,0,,,19/1/2022 7:23
28/7/2021,Chumphon,40,771,509453,251448,258005,1865,1865,0,,,19/1/2022 7:23
28/7/2021,Trang,42,2267,640011,312941,327070,2288,2288,0,,,19/1/2022 7:23
28/7/2021,Trat,40,989,228415,112919,115496,17144,17038,106,,,19/1/2022 7:23
28/7/2021,Tak,179,4452,674330,340958,333372,13933,13933,0,,,19/1/2022 7:23
28/7/2021,Nakhon Nayok,79,2503,259525,127999,131526,3515,3515,0,,,19/1/2022 7:23
28/7/2021,Nakhon Pathom,522,11836,922047,442945,479102,4047,4047,0,39,18,19/1/2022 7:23
28/7/2021,Nakhon Phanom,95,1677,717065,357305,359760,4473,4473,0,,,19/1/2022 7:23
28/7/2021,Nakhon Ratchasima,217,4488,2633481,1294026,1339455,83136,82593,543,48,30,19/1/2022 7:23
28/7/2021,Nakhon Si Thammarat,128,3175,1549708,764609,785099,8425,8425,0,,,19/1/2022 7:23
28/7/2021,Nakhon Sawan,162,2909,1037270,506043,531227,14969,14969,0,35,27,19/1/2022 7:23
28/7/2021,Nonthaburi,520,30629,1284757,597804,686953,2156,2144,12,21,13,19/1/2022 7:23
28/7/2021,Narathiwat,275,5638,808277,399788,408489,474,474,0,62,30,19/1/2022 7:23
28/7/2021,Nan,82,751,475961,238094,237867,9841,9805,36,,,19/1/2022 7:23
28/7/2021,Bueng Kan,25,372,421989,211591,210398,2816,2816,0,,,19/1/2022 7:23
28/7/2021,Buri Ram,208,2686,1579847,783934,795913,10752,10721,31,,,19/1/2022 7:23
28/7/2021,Pathum Thani,309,19719,1184541,561189,623352,1116,1103,13,30,18,19/1/2022 7:23
28/7/2021,Prachuap Khiri Khan,46,4541,552465,273938,278527,19918,19850,68,,,19/1/2022 7:23
28/7/2021,Prachin Buri,82,2885,494352,243985,250367,3384,3384,0,51,29,19/1/2022 7:23
28/7/2021,Pattani,156,8222,728613,359883,368730,585,585,0,,,19/1/2022 7:23
28/7/2021,Phra Nakhon Si Ayutthaya,155,7204,820077,393953,426124,21529,21302,227,38,37,19/1/2022 7:23
28/7/2021,Phayao,37,654,465591,226581,239010,8278,8278,0,32,20,19/1/2022 7:23
28/7/2021,Phang-nga,24,541,268377,133890,134487,5208,4622,586,,,19/1/2022 7:23
28/7/2021,Phatthalung,38,1373,522778,254665,268113,1934,1934,0,,,19/1/2022 7:23
28/7/2021,Phichit,63,1079,530608,258695,271913,6355,6355,0,,,19/1/2022 7:23
28/7/2021,Phitsanulok,88,1549,847773,415064,432709,26075,25939,136,,,19/1/2022 7:23
28/7/2021,Phuket,38,1250,417161,197202,219959,36699,20738,15961,47,29,19/1/2022 7:23
28/7/2021,Maha Sarakham,141,2862,950326,465921,484405,2664,2664,0,,,19/1/2022 7:23
28/7/2021,Mukdahan,42,624,351129,175445,175684,5772,5772,0,,,19/1/2022 7:23
28/7/2021,Yala,182,6654,541400,269573,271827,529,529,0,53,26,19/1/2022 7:23
28/7/2021,Yasothon,30,1246,533683,266331,267352,1497,1497,0,,,19/1/2022 7:23
28/7/2021,Ranong,55,2198,194637,98230,96407,1633,1633,0,,,19/1/2022 7:23
28/7/2021,Rayong,237,6762,748108,367475,380633,20171,19927,244,35,27,19/1/2022 7:23
28/7/2021,Ratchaburi,145,4852,869206,422658,446548,10667,10667,0,,,19/1/2022 7:23
28/7/2021,Roi Et,219,3084,1296773,642509,654264,2573,2573,0,,,19/1/2022 7:23
28/7/2021,Lop Buri,150,3469,740037,368792,371245,5956,5927,29,,,19/1/2022 7:23
28/7/2021,Lampang,54,1061,726701,354158,372543,6122,5950,172,27,24,19/1/2022 7:23
28/7/2021,Lamphun,25,544,401619,193055,208564,6810,6725,85,,,19/1/2022 7:23
28/7/2021,Si Sa Ket,248,3243,1457396,725574,731822,3604,3604,0,,,19/1/2022 7:23
28/7/2021,Sakon Nakhon,118,1802,1146784,569879,576905,4796,4796,0,,,19/1/2022 7:23
28/7/2021,Songkhla,283,11639,1429789,696651,733138,1474,1474,0,50,31,19/1/2022 7:23
28/7/2021,Satun,32,609,324467,161491,162976,1839,1820,19,59,26,19/1/2022 7:23
28/7/2021,Samut Prakarn,1090,37967,1355644,645919,709725,1526,1481,45,,,19/1/2022 7:23
28/7/2021,Samut Songkhram,76,1673,191611,91527,100084,6501,6501,0,19,13,19/1/2022 7:23
28/7/2021,Samut Sakhon,1147,44718,586567,282712,303855,861,861,0,47,34,19/1/2022 7:23
28/7/2021,Saraburi,152,5932,643513,316041,327472,7419,7401,18,44,45,19/1/2022 7:23
28/7/2021,Sa kaeo,86,3069,561275,280157,281118,2531,2531,0,30,19,19/1/2022 7:23
28/7/2021,Sing Buri,37,617,205218,97486,107732,2031,2031,0,,,19/1/2022 7:23
28/7/2021,Suphan Buri,375,4646,836800,403755,433045,9449,9449,0,,,19/1/2022 7:23
28/7/2021,Surat Thani,35,2988,1070296,526627,543669,3602,3188,414,60,24,19/1/2022 7:23
28/7/2021,Surin,171,3344,1377078,685103,691975,7265,7252,13,,,19/1/2022 7:23
28/7/2021,Sukhothai,99,1594,586111,283837,302274,5178,5003,175,,,19/1/2022 7:23
28/7/2021,Nong Khai,43,702,517035,256446,260589,8319,8316,3,17,15,19/1/2022 7:23
28/7/2021,Nong Bua Lam Phu,40,922,509092,253938,255154,2269,2269,0,,,19/1/2022 7:23
28/7/2021,Amnat Charoen,69,661,376294,187233,189061,1392,1392,0,,,19/1/2022 7:23
28/7/2021,Udon Thani,189,3090,1567167,776285,790882,10132,10127,5,,,19/1/2022 7:23
28/7/2021,Uttaradit,73,1165,447361,218107,229254,5713,5713,0,,,19/1/2022 7:23
28/7/2021,Uthai Thani,17,728,325339,159003,166336,2109,2109,0,,,19/1/2022 7:23
28/7/2021,Ubon Ratchathani,314,3834,1867197,932136,935061,6431,6431,0,42,22,19/1/2022 7:23
28/7/2021,Ang Thong,84,2179,275675,131918,143757,1386,1386,0,,,19/1/2022 7:23
28/7/2021,Chiang Rai,18,1674,1297041,630437,666604,25803,25572,231,25,11,19/1/2022 7:23
28/7/2021,Chiang Mai,64,9552,1786622,863343,923279,69510,68521,989,59,32,19/1/2022 7:23
28/7/2021,Phetchaburi,123,11511,482401,232827,249574,15182,15093,89,,,19/1/2022 7:23
28/7/2021,Phetchabun,107,1746,979701,483282,496419,22759,22735,24,,,19/1/2022 7:23
28/7/2021,Loei,49,952,638517,320015,318502,4573,4565,8,29,17,19/1/2022 7:23
28/7/2021,Phrae,21,510,435659,209972,225687,5424,5424,0,38,19,19/1/2022 7:23
28/7/2021,Mae Hong Son,8,136,285729,144754,140975,9411,9186,225,29,9,19/1/2022 7:23
28/7/2021,,0,153,,,,,,,,,19/1/2022 7:23
29/7/2021,Krabi,13,1042,478495,237646,240849,1716,1716,0,,,19/1/2022 7:23
29/7/2021,Bangkok,3965,172549,5551744,2605273,2946471,169121,147154,21967,44,26,19/1/2022 7:23
29/7/2021,Kanchanaburi,291,3735,893118,447911,445207,26909,26862,47,29,15,19/1/2022 7:23
29/7/2021,Kalasin,125,2404,976323,482572,493751,2495,2495,0,,,19/1/2022 7:23
29/7/2021,Kamphaeng Phet,77,2078,712903,351973,360930,6317,6317,0,,,19/1/2022 7:23
29/7/2021,Khon Kaen,162,4088,1792421,881179,911242,17954,17954,0,61,36,19/1/2022 7:23
29/7/2021,Chanthaburi,53,2562,535998,262065,273933,17139,17083,56,,,19/1/2022 7:23
29/7/2021,Chachoengsao,589,12077,722052,353870,368182,2359,2359,0,38,31,19/1/2022 7:23
29/7/2021,Chon Buri,986,25210,1579473,770979,808494,34619,34021,598,44,37,19/1/2022 7:23
29/7/2021,Chai Nat,38,678,321220,154391,166829,3194,3194,0,,,19/1/2022 7:23
29/7/2021,Chaiyaphum,172,2537,1123243,554962,568281,6802,6802,0,,,19/1/2022 7:23
29/7/2021,Chumphon,46,817,509453,251448,258005,1865,1865,0,,,19/1/2022 7:23
29/7/2021,Trang,77,2344,640011,312941,327070,2288,2288,0,,,19/1/2022 7:23
29/7/2021,Trat,39,1028,228415,112919,115496,17144,17038,106,,,19/1/2022 7:23
29/7/2021,Tak,163,4615,674330,340958,333372,13933,13933,0,,,19/1/2022 7:23
29/7/2021,Nakhon Nayok,89,2592,259525,127999,131526,3515,3515,0,,,19/1/2022 7:23
29/7/2021,Nakhon Pathom,983,12819,922047,442945,479102,4047,4047,0,43,22,19/1/2022 7:23
29/7/2021,Nakhon Phanom,111,1788,717065,357305,359760,4473,4473,0,,,19/1/2022 7:23
29/7/2021,Nakhon Ratchasima,192,4680,2633481,1294026,1339455,83136,82593,543,56,28,19/1/2022 7:23
29/7/2021,Nakhon Si Thammarat,97,3272,1549708,764609,785099,8425,8425,0,,,19/1/2022 7:23
29/7/2021,Nakhon Sawan,147,3056,1037270,506043,531227,14969,14969,0,49,27,19/1/2022 7:23
29/7/2021,Nonthaburi,633,31262,1284757,597804,686953,2156,2144,12,26,15,19/1/2022 7:23
29/7/2021,Narathiwat,256,5894,808277,399788,408489,474,474,0,67,18,19/1/2022 7:23
29/7/2021,Nan,67,818,475961,238094,237867,9841,9805,36,,,19/1/2022 7:23
29/7/2021,Bueng Kan,53,425,421989,211591,210398,2816,2816,0,,,19/1/2022 7:23
29/7/2021,Buri Ram,240,2926,1579847,783934,795913,10752,10721,31,,,19/1/2022 7:23
29/7/2021,Pathum Thani,320,20039,1184541,561189,623352,1116,1103,13,37,22,19/1/2022 7:23
29/7/2021,Prachuap Khiri Khan,56,4597,552465,273938,278527,19918,19850,68,,,19/1/2022 7:23
29/7/2021,Prachin Buri,196,3081,494352,243985,250367,3384,3384,0,57,27,19/1/2022 7:23
29/7/2021,Pattani,171,8393,728613,359883,368730,585,585,0,,,19/1/2022 7:23
29/7/2021,Phra Nakhon Si Ayutthaya,313,7517,820077,393953,426124,21529,21302,227,41,39,19/1/2022 7:23
29/7/2021,Phayao,45,699,465591,226581,239010,8278,8278,0,42,22,19/1/2022 7:23
29/7/2021,Phang-nga,27,568,268377,133890,134487,5208,4622,586,,,19/1/2022 7:23
29/7/2021,Phatthalung,54,1427,522778,254665,268113,1934,1934,0,,,19/1/2022 7:23
29/7/2021,Phichit,74,1153,530608,258695,271913,6355,6355,0,,,19/1/2022 7:23
29/7/2021,Phitsanulok,78,1627,847773,415064,432709,26075,25939,136,,,19/1/2022 7:23
29/7/2021,Phuket,30,1280,417161,197202,219959,36699,20738,15961,50,26,19/1/2022 7:23
29/7/2021,Maha Sarakham,151,3013,950326,465921,484405,2664,2664,0,,,19/1/2022 7:23
29/7/2021,Mukdahan,46,670,351129,175445,175684,5772,5772,0,,,19/1/2022 7:23
29/7/2021,Yala,220,6874,541400,269573,271827,529,529,0,57,19,19/1/2022 7:23
29/7/2021,Yasothon,107,1353,533683,266331,267352,1497,1497,0,,,19/1/2022 7:23
29/7/2021,Ranong,71,2269,194637,98230,96407,1633,1633,0,,,19/1/2022 7:23
29/7/2021,Rayong,394,7156,748108,367475,380633,20171,19927,244,39,25,19/1/2022 7:23
29/7/2021,Ratchaburi,118,4970,869206,422658,446548,10667,10667,0,,,19/1/2022 7:23
29/7/2021,Roi Et,205,3289,1296773,642509,654264,2573,2573,0,,,19/1/2022 7:23
29/7/2021,Lop Buri,124,3593,740037,368792,371245,5956,5927,29,,,19/1/2022 7:23
29/7/2021,Lampang,57,1118,726701,354158,372543,6122,5950,172,33,21,19/1/2022 7:23
29/7/2021,Lamphun,6,550,401619,193055,208564,6810,6725,85,,,19/1/2022 7:23
29/7/2021,Si Sa Ket,251,3494,1457396,725574,731822,3604,3604,0,,,19/1/2022 7:23
29/7/2021,Sakon Nakhon,102,1904,1146784,569879,576905,4796,4796,0,,,19/1/2022 7:23
29/7/2021,Songkhla,216,11855,1429789,696651,733138,1474,1474,0,60,24,19/1/2022 7:23
29/7/2021,Satun,18,627,324467,161491,162976,1839,1820,19,47,26,19/1/2022 7:23
29/7/2021,Samut Prakarn,814,38781,1355644,645919,709725,1526,1481,45,,,19/1/2022 7:23
29/7/2021,Samut Songkhram,79,1752,191611,91527,100084,6501,6501,0,25,18,19/1/2022 7:23
29/7/2021,Samut Sakhon,1175,45893,586567,282712,303855,861,861,0,51,35,19/1/2022 7:23
29/7/2021,Saraburi,332,6264,643513,316041,327472,7419,7401,18,54,44,19/1/2022 7:23
29/7/2021,Sa kaeo,94,3163,561275,280157,281118,2531,2531,0,36,22,19/1/2022 7:23
29/7/2021,Sing Buri,38,655,205218,97486,107732,2031,2031,0,,,19/1/2022 7:23
29/7/2021,Suphan Buri,161,4807,836800,403755,433045,9449,9449,0,,,19/1/2022 7:23
29/7/2021,Surat Thani,63,3051,1070296,526627,543669,3602,3188,414,48,22,19/1/2022 7:23
29/7/2021,Surin,221,3565,1377078,685103,691975,7265,7252,13,,,19/1/2022 7:23
29/7/2021,Sukhothai,141,1735,586111,283837,302274,5178,5003,175,,,19/1/2022 7:23
29/7/2021,Nong Khai,35,737,517035,256446,260589,8319,8316,3,32,15,19/1/2022 7:23
29/7/2021,Nong Bua Lam Phu,38,960,509092,253938,255154,2269,2269,0,,,19/1/2022 7:23
29/7/2021,Amnat Charoen,85,746,376294,187233,189061,1392,1392,0,,,19/1/2022 7:23
29/7/2021,Udon Thani,303,3393,1567167,776285,790882,10132,10127,5,,,19/1/2022 7:23
29/7/2021,Uttaradit,104,1269,447361,218107,229254,5713,5713,0,,,19/1/2022 7:23
29/7/2021,Uthai Thani,74,802,325339,159003,166336,2109,2109,0,,,19/1/2022 7:23
29/7/2021,Ubon Ratchathani,302,4136,1867197,932136,935061,6431,6431,0,47,24,19/1/2022 7:23
29/7/2021,Ang Thong,113,2292,275675,131918,143757,1386,1386,0,,,19/1/2022 7:23
29/7/2021,Chiang Rai,38,1712,1297041,630437,666604,25803,25572,231,38,12,19/1/2022 7:23
29/7/2021,Chiang Mai,69,9621,1786622,863343,923279,69510,68521,989,64,33,19/1/2022 7:23
29/7/2021,Phetchaburi,120,11631,482401,232827,249574,15182,15093,89,,,19/1/2022 7:23
29/7/2021,Phetchabun,75,1821,979701,483282,496419,22759,22735,24,,,19/1/2022 7:23
29/7/2021,Loei,42,994,638517,320015,318502,4573,4565,8,34,18,19/1/2022 7:23
29/7/2021,Phrae,32,542,435659,209972,225687,5424,5424,0,44,20,19/1/2022 7:23
29/7/2021,Mae Hong Son,7,143,285729,144754,140975,9411,9186,225,38,10,19/1/2022 7:23
29/7/2021,,0,153,,,,,,,,,19/1/2022 7:23
30/7/2021,Krabi,15,1057,478495,237646,240849,1716,1716,0,,,19/1/2022 7:23
30/7/2021,Bangkok,3237,175786,5551744,2605273,2946471,169121,147154,21967,53,30,19/1/2022 7:23
30/7/2021,Kanchanaburi,154,3889,893118,447911,445207,26909,26862,47,26,12,19/1/2022 7:23
30/7/2021,Kalasin,202,2606,976323,482572,493751,2495,2495,0,,,19/1/2022 7:23
30/7/2021,Kamphaeng Phet,91,2169,712903,351973,360930,6317,6317,0,,,19/1/2022 7:23
30/7/2021,Khon Kaen,192,4280,1792421,881179,911242,17954,17954,0,63,35,19/1/2022 7:23
30/7/2021,Chanthaburi,56,2618,535998,262065,273933,17139,17083,56,,,19/1/2022 7:23
30/7/2021,Chachoengsao,479,12556,722052,353870,368182,2359,2359,0,46,32,19/1/2022 7:23
30/7/2021,Chon Buri,959,26169,1579473,770979,808494,34619,34021,598,49,36,19/1/2022 7:23
30/7/2021,Chai Nat,27,705,321220,154391,166829,3194,3194,0,,,19/1/2022 7:23
30/7/2021,Chaiyaphum,187,2724,1123243,554962,568281,6802,6802,0,,,19/1/2022 7:23
30/7/2021,Chumphon,40,857,509453,251448,258005,1865,1865,0,,,19/1/2022 7:23
30/7/2021,Trang,45,2389,640011,312941,327070,2288,2288,0,,,19/1/2022 7:23
30/7/2021,Trat,29,1057,228415,112919,115496,17144,17038,106,,,19/1/2022 7:23
30/7/2021,Tak,271,4886,674330,340958,333372,13933,13933,0,,,19/1/2022 7:23
30/7/2021,Nakhon Nayok,93,2685,259525,127999,131526,3515,3515,0,,,19/1/2022 7:23
30/7/2021,Nakhon Pathom,400,13219,922047,442945,479102,4047,4047,0,45,20,19/1/2022 7:23
30/7/2021,Nakhon Phanom,80,1868,717065,357305,359760,4473,4473,0,,,19/1/2022 7:23
30/7/2021,Nakhon Ratchasima,240,4920,2633481,1294026,1339455,83136,82593,543,56,25,19/1/2022 7:23
30/7/2021,Nakhon Si Thammarat,114,3386,1549708,764609,785099,8425,8425,0,,,19/1/2022 7:23
30/7/2021,Nakhon Sawan,149,3205,1037270,506043,531227,14969,14969,0,49,23,19/1/2022 7:23
30/7/2021,Nonthaburi,587,31849,1284757,597804,686953,2156,2144,12,33,17,19/1/2022 7:23
30/7/2021,Narathiwat,163,6057,808277,399788,408489,474,474,0,42,16,19/1/2022 7:23
30/7/2021,Nan,60,878,475961,238094,237867,9841,9805,36,,,19/1/2022 7:23
30/7/2021,Bueng Kan,23,448,421989,211591,210398,2816,2816,0,,,19/1/2022 7:23
30/7/2021,Buri Ram,203,3129,1579847,783934,795913,10752,10721,31,,,19/1/2022 7:23
30/7/2021,Pathum Thani,437,20476,1184541,561189,623352,1116,1103,13,42,22,19/1/2022 7:23
30/7/2021,Prachuap Khiri Khan,80,4677,552465,273938,278527,19918,19850,68,,,19/1/2022 7:23
30/7/2021,Prachin Buri,93,3174,494352,243985,250367,3384,3384,0,57,28,19/1/2022 7:23
30/7/2021,Pattani,183,8576,728613,359883,368730,585,585,0,,,19/1/2022 7:23
30/7/2021,Phra Nakhon Si Ayutthaya,372,7889,820077,393953,426124,21529,21302,227,43,36,19/1/2022 7:23
30/7/2021,Phayao,28,727,465591,226581,239010,8278,8278,0,47,18,19/1/2022 7:23
30/7/2021,Phang-nga,37,605,268377,133890,134487,5208,4622,586,,,19/1/2022 7:23
30/7/2021,Phatthalung,47,1474,522778,254665,268113,1934,1934,0,,,19/1/2022 7:23
30/7/2021,Phichit,29,1182,530608,258695,271913,6355,6355,0,,,19/1/2022 7:23
30/7/2021,Phitsanulok,89,1716,847773,415064,432709,26075,25939,136,,,19/1/2022 7:23
30/7/2021,Phuket,51,1331,417161,197202,219959,36699,20738,15961,53,28,19/1/2022 7:23
30/7/2021,Maha Sarakham,258,3271,950326,465921,484405,2664,2664,0,,,19/1/2022 7:23
30/7/2021,Mukdahan,45,715,351129,175445,175684,5772,5772,0,,,19/1/2022 7:23
30/7/2021,Yala,238,7112,541400,269573,271827,529,529,0,46,13,19/1/2022 7:23
30/7/2021,Yasothon,130,1483,533683,266331,267352,1497,1497,0,,,19/1/2022 7:23
30/7/2021,Ranong,58,2327,194637,98230,96407,1633,1633,0,,,19/1/2022 7:23
30/7/2021,Rayong,246,7402,748108,367475,380633,20171,19927,244,32,29,19/1/2022 7:23
30/7/2021,Ratchaburi,123,5093,869206,422658,446548,10667,10667,0,,,19/1/2022 7:23
30/7/2021,Roi Et,226,3515,1296773,642509,654264,2573,2573,0,,,19/1/2022 7:23
30/7/2021,Lop Buri,259,3852,740037,368792,371245,5956,5927,29,,,19/1/2022 7:23
30/7/2021,Lampang,42,1160,726701,354158,372543,6122,5950,172,40,18,19/1/2022 7:23
30/7/2021,Lamphun,30,580,401619,193055,208564,6810,6725,85,,,19/1/2022 7:23
30/7/2021,Si Sa Ket,280,3774,1457396,725574,731822,3604,3604,0,,,19/1/2022 7:23
30/7/2021,Sakon Nakhon,112,2016,1146784,569879,576905,4796,4796,0,,,19/1/2022 7:23
30/7/2021,Songkhla,324,12179,1429789,696651,733138,1474,1474,0,46,28,19/1/2022 7:23
30/7/2021,Satun,4,631,324467,161491,162976,1839,1820,19,50,30,19/1/2022 7:23
30/7/2021,Samut Prakarn,1397,40178,1355644,645919,709725,1526,1481,45,,,19/1/2022 7:23
30/7/2021,Samut Songkhram,97,1849,191611,91527,100084,6501,6501,0,32,18,19/1/2022 7:23
30/7/2021,Samut Sakhon,1186,47079,586567,282712,303855,861,861,0,67,41,19/1/2022 7:23
30/7/2021,Saraburi,448,6712,643513,316041,327472,7419,7401,18,56,47,19/1/2022 7:23
30/7/2021,Sa kaeo,122,3285,561275,280157,281118,2531,2531,0,42,22,19/1/2022 7:23
30/7/2021,Sing Buri,44,699,205218,97486,107732,2031,2031,0,,,19/1/2022 7:23
30/7/2021,Suphan Buri,233,5040,836800,403755,433045,9449,9449,0,,,19/1/2022 7:23
30/7/2021,Surat Thani,103,3154,1070296,526627,543669,3602,3188,414,41,25,19/1/2022 7:23
30/7/2021,Surin,321,3886,1377078,685103,691975,7265,7252,13,,,19/1/2022 7:23
30/7/2021,Sukhothai,82,1817,586111,283837,302274,5178,5003,175,,,19/1/2022 7:23
30/7/2021,Nong Khai,68,805,517035,256446,260589,8319,8316,3,38,13,19/1/2022 7:23
30/7/2021,Nong Bua Lam Phu,25,985,509092,253938,255154,2269,2269,0,,,19/1/2022 7:23
30/7/2021,Amnat Charoen,50,796,376294,187233,189061,1392,1392,0,,,19/1/2022 7:23
30/7/2021,Udon Thani,78,3471,1567167,776285,790882,10132,10127,5,,,19/1/2022 7:23
30/7/2021,Uttaradit,95,1364,447361,218107,229254,5713,5713,0,,,19/1/2022 7:23
30/7/2021,Uthai Thani,40,842,325339,159003,166336,2109,2109,0,,,19/1/2022 7:23
30/7/2021,Ubon Ratchathani,417,4553,1867197,932136,935061,6431,6431,0,52,25,19/1/2022 7:23
30/7/2021,Ang Thong,186,2478,275675,131918,143757,1386,1386,0,,,19/1/2022 7:23
30/7/2021,Chiang Rai,31,1743,1297041,630437,666604,25803,25572,231,41,10,19/1/2022 7:23
30/7/2021,Chiang Mai,65,9686,1786622,863343,923279,69510,68521,989,65,28,19/1/2022 7:23
30/7/2021,Phetchaburi,134,11765,482401,232827,249574,15182,15093,89,,,19/1/2022 7:23
30/7/2021,Phetchabun,118,1939,979701,483282,496419,22759,22735,24,,,19/1/2022 7:23
30/7/2021,Loei,56,1050,638517,320015,318502,4573,4565,8,38,16,19/1/2022 7:23
30/7/2021,Phrae,26,568,435659,209972,225687,5424,5424,0,48,18,19/1/2022 7:23
30/7/2021,Mae Hong Son,6,149,285729,144754,140975,9411,9186,225,40,7,19/1/2022 7:23
30/7/2021,,0,153,,,,,,,,,19/1/2022 7:23
31/7/2021,Krabi,17,1074,478495,237646,240849,1716,1716,0,,,19/1/2022 7:23
31/7/2021,Bangkok,3733,179519,5551744,2605273,2946471,169121,147154,21967,61,24,19/1/2022 7:23
31/7/2021,Kanchanaburi,310,4199,893118,447911,445207,26909,26862,47,29,12,19/1/2022 7:23
31/7/2021,Kalasin,197,2803,976323,482572,493751,2495,2495,0,,,19/1/2022 7:23
31/7/2021,Kamphaeng Phet,128,2297,712903,351973,360930,6317,6317,0,,,19/1/2022 7:23
31/7/2021,Khon Kaen,161,4441,1792421,881179,911242,17954,17954,0,62,30,19/1/2022 7:23
31/7/2021,Chanthaburi,85,2703,535998,262065,273933,17139,17083,56,,,19/1/2022 7:23
31/7/2021,Chachoengsao,437,12993,722052,353870,368182,2359,2359,0,41,30,19/1/2022 7:23
31/7/2021,Chon Buri,1068,27237,1579473,770979,808494,34619,34021,598,47,31,19/1/2022 7:23
31/7/2021,Chai Nat,68,773,321220,154391,166829,3194,3194,0,,,19/1/2022 7:23
31/7/2021,Chaiyaphum,249,2973,1123243,554962,568281,6802,6802,0,,,19/1/2022 7:23
31/7/2021,Chumphon,72,929,509453,251448,258005,1865,1865,0,,,19/1/2022 7:23
31/7/2021,Trang,34,2423,640011,312941,327070,2288,2288,0,,,19/1/2022 7:23
31/7/2021,Trat,15,1072,228415,112919,115496,17144,17038,106,,,19/1/2022 7:23
31/7/2021,Tak,188,5074,674330,340958,333372,13933,13933,0,,,19/1/2022 7:23
31/7/2021,Nakhon Nayok,324,3009,259525,127999,131526,3515,3515,0,,,19/1/2022 7:23
31/7/2021,Nakhon Pathom,557,13776,922047,442945,479102,4047,4047,0,44,19,19/1/2022 7:23
31/7/2021,Nakhon Phanom,127,1995,717065,357305,359760,4473,4473,0,,,19/1/2022 7:23
31/7/2021,Nakhon Ratchasima,231,5151,2633481,1294026,1339455,83136,82593,543,54,25,19/1/2022 7:23
31/7/2021,Nakhon Si Thammarat,151,3537,1549708,764609,785099,8425,8425,0,,,19/1/2022 7:23
31/7/2021,Nakhon Sawan,195,3400,1037270,506043,531227,14969,14969,0,41,17,19/1/2022 7:23
31/7/2021,Nonthaburi,581,32430,1284757,597804,686953,2156,2144,12,38,13,19/1/2022 7:23
31/7/2021,Narathiwat,217,6274,808277,399788,408489,474,474,0,36,17,19/1/2022 7:23
31/7/2021,Nan,61,939,475961,238094,237867,9841,9805,36,,,19/1/2022 7:23
31/7/2021,Bueng Kan,42,490,421989,211591,210398,2816,2816,0,,,19/1/2022 7:23
31/7/2021,Buri Ram,298,3427,1579847,783934,795913,10752,10721,31,,,19/1/2022 7:23
31/7/2021,Pathum Thani,462,20938,1184541,561189,623352,1116,1103,13,46,17,19/1/2022 7:23
31/7/2021,Prachuap Khiri Khan,84,4761,552465,273938,278527,19918,19850,68,,,19/1/2022 7:23
31/7/2021,Prachin Buri,130,3304,494352,243985,250367,3384,3384,0,61,33,19/1/2022 7:23
31/7/2021,Pattani,173,8749,728613,359883,368730,585,585,0,,,19/1/2022 7:23
31/7/2021,Phra Nakhon Si Ayutthaya,310,8199,820077,393953,426124,21529,21302,227,44,34,19/1/2022 7:23
31/7/2021,Phayao,36,763,465591,226581,239010,8278,8278,0,42,17,19/1/2022 7:23
31/7/2021,Phang-nga,41,646,268377,133890,134487,5208,4622,586,,,19/1/2022 7:23
31/7/2021,Phatthalung,49,1523,522778,254665,268113,1934,1934,0,,,19/1/2022 7:23
31/7/2021,Phichit,29,1211,530608,258695,271913,6355,6355,0,,,19/1/2022 7:23
31/7/2021,Phitsanulok,42,1758,847773,415064,432709,26075,25939,136,,,19/1/2022 7:23
31/7/2021,Phuket,35,1366,417161,197202,219959,36699,20738,15961,53,29,19/1/2022 7:23
31/7/2021,Maha Sarakham,231,3502,950326,465921,484405,2664,2664,0,,,19/1/2022 7:23
31/7/2021,Mukdahan,37,752,351129,175445,175684,5772,5772,0,,,19/1/2022 7:23
31/7/2021,Yala,168,7280,541400,269573,271827,529,529,0,36,16,19/1/2022 7:23
31/7/2021,Yasothon,132,1615,533683,266331,267352,1497,1497,0,,,19/1/2022 7:23
31/7/2021,Ranong,74,2401,194637,98230,96407,1633,1633,0,,,19/1/2022 7:23
31/7/2021,Rayong,670,8072,748108,367475,380633,20171,19927,244,46,26,19/1/2022 7:23
31/7/2021,Ratchaburi,233,5326,869206,422658,446548,10667,10667,0,,,19/1/2022 7:23
31/7/2021,Roi Et,228,3743,1296773,642509,654264,2573,2573,0,,,19/1/2022 7:23
31/7/2021,Lop Buri,260,4112,740037,368792,371245,5956,5927,29,,,19/1/2022 7:23
31/7/2021,Lampang,43,1203,726701,354158,372543,6122,5950,172,52,17,19/1/2022 7:23
31/7/2021,Lamphun,13,593,401619,193055,208564,6810,6725,85,,,19/1/2022 7:23
31/7/2021,Si Sa Ket,369,4143,1457396,725574,731822,3604,3604,0,,,19/1/2022 7:23
31/7/2021,Sakon Nakhon,156,2172,1146784,569879,576905,4796,4796,0,,,19/1/2022 7:23
31/7/2021,Songkhla,324,12503,1429789,696651,733138,1474,1474,0,56,24,19/1/2022 7:23
31/7/2021,Satun,8,639,324467,161491,162976,1839,1820,19,42,39,19/1/2022 7:23
31/7/2021,Samut Prakarn,934,41112,1355644,645919,709725,1526,1481,45,,,19/1/2022 7:23
31/7/2021,Samut Songkhram,98,1947,191611,91527,100084,6501,6501,0,36,16,19/1/2022 7:23
31/7/2021,Samut Sakhon,1184,48263,586567,282712,303855,861,861,0,74,29,19/1/2022 7:23
31/7/2021,Saraburi,409,7121,643513,316041,327472,7419,7401,18,55,38,19/1/2022 7:23
31/7/2021,Sa kaeo,107,3392,561275,280157,281118,2531,2531,0,41,22,19/1/2022 7:23
31/7/2021,Sing Buri,56,755,205218,97486,107732,2031,2031,0,,,19/1/2022 7:23
31/7/2021,Suphan Buri,181,5221,836800,403755,433045,9449,9449,0,,,19/1/2022 7:23
31/7/2021,Surat Thani,135,3289,1070296,526627,543669,3602,3188,414,27,25,19/1/2022 7:23
31/7/2021,Surin,185,4071,1377078,685103,691975,7265,7252,13,,,19/1/2022 7:23
31/7/2021,Sukhothai,108,1925,586111,283837,302274,5178,5003,175,,,19/1/2022 7:23
31/7/2021,Nong Khai,49,854,517035,256446,260589,8319,8316,3,33,14,19/1/2022 7:23
31/7/2021,Nong Bua Lam Phu,95,1080,509092,253938,255154,2269,2269,0,,,19/1/2022 7:23
31/7/2021,Amnat Charoen,74,870,376294,187233,189061,1392,1392,0,,,19/1/2022 7:23
31/7/2021,Udon Thani,174,3645,1567167,776285,790882,10132,10127,5,,,19/1/2022 7:23
31/7/2021,Uttaradit,73,1437,447361,218107,229254,5713,5713,0,,,19/1/2022 7:23
31/7/2021,Uthai Thani,62,904,325339,159003,166336,2109,2109,0,,,19/1/2022 7:23
31/7/2021,Ubon Ratchathani,295,4848,1867197,932136,935061,6431,6431,0,55,26,19/1/2022 7:23
31/7/2021,Ang Thong,361,2839,275675,131918,143757,1386,1386,0,,,19/1/2022 7:23
31/7/2021,Chiang Rai,27,1770,1297041,630437,666604,25803,25572,231,34,10,19/1/2022 7:23
31/7/2021,Chiang Mai,102,9788,1786622,863343,923279,69510,68521,989,61,30,19/1/2022 7:23
31/7/2021,Phetchaburi,131,11896,482401,232827,249574,15182,15093,89,,,19/1/2022 7:23
31/7/2021,Phetchabun,119,2058,979701,483282,496419,22759,22735,24,,,19/1/2022 7:23
31/7/2021,Loei,57,1107,638517,320015,318502,4573,4565,8,34,14,19/1/2022 7:23
31/7/2021,Phrae,9,577,435659,209972,225687,5424,5424,0,40,18,19/1/2022 7:23
31/7/2021,Mae Hong Son,4,153,285729,144754,140975,9411,9186,225,29,6,19/1/2022 7:23
31/7/2021,,0,153,,,,,,,,,19/1/2022 7:23
1/8/2021,Krabi,20,1094,478664,237717,240947,2096,1981,115,,,19/1/2022 7:23
1/8/2021,Bangkok,2905,182424,5544789,2601856,2942933,202959,181431,21528,52,23,19/1/2022 7:23
1/8/2021,Kanchanaburi,188,4387,893129,447919,445210,20185,20157,28,28,19,19/1/2022 7:23
1/8/2021,Kalasin,213,3016,976083,482351,493732,2306,2306,0,,,19/1/2022 7:23
1/8/2021,Kamphaeng Phet,137,2434,712600,351801,360799,6769,6769,0,,,19/1/2022 7:23
1/8/2021,Khon Kaen,160,4601,1791967,880624,911343,21098,21098,0,57,30,19/1/2022 7:23
1/8/2021,Chanthaburi,79,2782,536132,262097,274035,17881,17815,66,,,19/1/2022 7:23
1/8/2021,Chachoengsao,327,13320,722615,354177,368438,1995,1995,0,44,35,19/1/2022 7:23
1/8/2021,Chon Buri,1150,28387,1580389,771364,809025,30270,29695,575,49,41,19/1/2022 7:23
1/8/2021,Chai Nat,49,822,321015,154292,166723,4171,4171,0,,,19/1/2022 7:23
1/8/2021,Chaiyaphum,326,3299,1122780,554646,568134,13695,13682,13,,,19/1/2022 7:23
1/8/2021,Chumphon,23,952,509292,251346,257946,1644,1644,0,,,19/1/2022 7:23
1/8/2021,Trang,53,2476,639931,312837,327094,2469,2469,0,,,19/1/2022 7:23
1/8/2021,Trat,25,1097,228459,112922,115537,22368,22277,91,,,19/1/2022 7:23
1/8/2021,Tak,189,5263,674616,341111,333505,12606,12606,0,,,19/1/2022 7:23
1/8/2021,Nakhon Nayok,23,3032,259735,128303,131432,2679,2679,0,,,19/1/2022 7:23
1/8/2021,Nakhon Pathom,429,14205,921500,442584,478916,2714,2714,0,43,18,19/1/2022 7:23
1/8/2021,Nakhon Phanom,114,2109,717048,357194,359854,3548,3548,0,,,19/1/2022 7:23
1/8/2021,Nakhon Ratchasima,178,5329,2633733,1293977,1339756,88532,87939,593,51,27,19/1/2022 7:23
1/8/2021,Nakhon Si Thammarat,142,3679,1549496,764523,784973,7996,7996,0,,,19/1/2022 7:23
1/8/2021,Nakhon Sawan,219,3619,1036534,505545,530989,15946,15946,0,29,21,19/1/2022 7:23
1/8/2021,Nonthaburi,723,33153,1285013,597870,687143,2822,2815,7,30,14,19/1/2022 7:23
1/8/2021,Narathiwat,167,6441,808758,400002,408756,421,421,0,38,21,19/1/2022 7:23
1/8/2021,Nan,75,1014,475941,238073,237868,9832,9798,34,,,19/1/2022 7:23
1/8/2021,Bueng Kan,31,521,421931,211488,210443,2114,2114,0,,,19/1/2022 7:23
1/8/2021,Buri Ram,360,3787,1579709,783665,796044,12087,12044,43,,,19/1/2022 7:23
1/8/2021,Pathum Thani,540,21478,1185082,561507,623575,1319,1306,13,36,22,19/1/2022 7:23
1/8/2021,Prachuap Khiri Khan,140,4901,552888,274321,278567,13974,13921,53,,,19/1/2022 7:23
1/8/2021,Prachin Buri,135,3439,494505,244150,250355,3143,3143,0,62,29,19/1/2022 7:23
1/8/2021,Pattani,216,8965,728801,359974,368827,517,517,0,,,19/1/2022 7:23
1/8/2021,Phra Nakhon Si Ayutthaya,310,8509,819892,393788,426104,17000,16958,42,31,41,19/1/2022 7:23
1/8/2021,Phayao,54,817,465390,226498,238892,9277,9277,0,38,24,19/1/2022 7:23
1/8/2021,Phang-nga,4,650,268269,133881,134388,7037,5969,1068,,,19/1/2022 7:23
1/8/2021,Phatthalung,53,1576,522612,254531,268081,1598,1598,0,,,19/1/2022 7:23
1/8/2021,Phichit,150,1361,530258,258492,271766,6914,6914,0,,,19/1/2022 7:23
1/8/2021,Phitsanulok,82,1840,847684,414983,432701,25715,25564,151,,,19/1/2022 7:23
1/8/2021,Phuket,41,1407,418055,197662,220393,33530,18204,15326,54,27,19/1/2022 7:23
1/8/2021,Maha Sarakham,349,3851,949783,465624,484159,2772,2772,0,,,19/1/2022 7:23
1/8/2021,Mukdahan,35,787,351259,175474,175785,5322,5322,0,,,19/1/2022 7:23
1/8/2021,Yala,162,7442,541494,269636,271858,438,438,0,37,17,19/1/2022 7:23
1/8/2021,Yasothon,80,1695,533506,266189,267317,1561,1561,0,,,19/1/2022 7:23
1/8/2021,Ranong,74,2475,194677,98263,96414,1369,1369,0,,,19/1/2022 7:23
1/8/2021,Rayong,354,8426,748943,367783,381160,18635,18409,226,43,27,19/1/2022 7:23
1/8/2021,Ratchaburi,166,5492,869099,422558,446541,7187,7187,0,,,19/1/2022 7:23
1/8/2021,Roi Et,202,3945,1296428,642234,654194,2700,2700,0,,,19/1/2022 7:23
1/8/2021,Lop Buri,278,4390,740487,369278,371209,7057,7028,29,,,19/1/2022 7:23
1/8/2021,Lampang,53,1256,726261,353817,372444,6862,6727,135,52,18,19/1/2022 7:23
1/8/2021,Lamphun,25,618,401525,192998,208527,7455,7381,74,,,19/1/2022 7:23
1/8/2021,Si Sa Ket,279,4422,1456985,725190,731795,3838,3838,0,,,19/1/2022 7:23
1/8/2021,Sakon Nakhon,167,2339,1146507,569654,576853,4675,4675,0,,,19/1/2022 7:23
1/8/2021,Songkhla,320,12823,1430543,696923,733620,1132,1132,0,42,28,19/1/2022 7:23
1/8/2021,Satun,34,673,324496,161423,163073,1183,1170,13,47,27,19/1/2022 7:23
1/8/2021,Samut Prakarn,1113,42225,1355823,645868,709955,1887,1860,27,,,19/1/2022 7:23
1/8/2021,Samut Songkhram,115,2062,191276,91338,99938,4546,4546,0,34,17,19/1/2022 7:23
1/8/2021,Samut Sakhon,1259,49522,585685,282240,303445,1338,1338,0,54,33,19/1/2022 7:23
1/8/2021,Saraburi,427,7548,643873,316304,327569,9794,9776,18,48,40,19/1/2022 7:23
1/8/2021,Sa kaeo,128,3520,561509,280362,281147,2377,2377,0,39,22,19/1/2022 7:23
1/8/2021,Sing Buri,31,786,205088,97428,107660,3064,3064,0,,,19/1/2022 7:23
1/8/2021,Suphan Buri,288,5509,836435,403512,432923,6542,6542,0,,,19/1/2022 7:23
1/8/2021,Surat Thani,71,3360,1071496,527024,544472,4790,4115,675,57,24,19/1/2022 7:23
1/8/2021,Surin,174,4245,1376723,684837,691886,8153,8131,22,,,19/1/2022 7:23
1/8/2021,Sukhothai,109,2034,585851,283686,302165,4868,4868,0,,,19/1/2022 7:23
1/8/2021,Nong Khai,86,940,516896,256327,260569,6520,6513,7,34,15,19/1/2022 7:23
1/8/2021,Nong Bua Lam Phu,56,1136,508942,253805,255137,1487,1487,0,,,19/1/2022 7:23
1/8/2021,Amnat Charoen,107,977,376228,187133,189095,1440,1440,0,,,19/1/2022 7:23
1/8/2021,Udon Thani,278,3923,1566940,776022,790918,9291,9282,9,,,19/1/2022 7:23
1/8/2021,Uttaradit,77,1514,447089,217944,229145,6329,6329,0,,,19/1/2022 7:23
1/8/2021,Uthai Thani,96,1000,325254,158926,166328,2279,2279,0,,,19/1/2022 7:23
1/8/2021,Ubon Ratchathani,414,5262,1867365,932174,935191,7252,7252,0,55,25,19/1/2022 7:23
1/8/2021,Ang Thong,207,3046,275476,131801,143675,962,962,0,,,19/1/2022 7:23
1/8/2021,Chiang Rai,26,1796,1297168,630483,666685,28142,27897,245,31,11,19/1/2022 7:23
1/8/2021,Chiang Mai,46,9834,1787281,863640,923641,68614,67650,964,62,34,19/1/2022 7:23
1/8/2021,Phetchaburi,144,12040,482600,232958,249642,12139,12096,43,,,19/1/2022 7:23
1/8/2021,Phetchabun,68,2126,979033,482878,496155,20292,20262,30,,,19/1/2022 7:23
1/8/2021,Loei,66,1173,638862,320119,318743,5789,5778,11,30,16,19/1/2022 7:23
1/8/2021,Phrae,28,605,435481,209872,225609,5872,5872,0,42,17,19/1/2022 7:23
1/8/2021,Mae Hong Son,5,158,285778,144757,141021,8861,8659,202,26,5,19/1/2022 7:23
1/8/2021,,0,153,,,,,,,,,19/1/2022 7:23
2/8/2021,Krabi,23,1117,478664,237717,240947,2096,1981,115,,,19/1/2022 7:23
2/8/2021,Bangkok,3203,185627,5544789,2601856,2942933,202959,181431,21528,42,20,19/1/2022 7:23
2/8/2021,Kanchanaburi,279,4666,893129,447919,445210,20185,20157,28,37,14,19/1/2022 7:23
2/8/2021,Kalasin,216,3232,976083,482351,493732,2306,2306,0,,,19/1/2022 7:23
2/8/2021,Kamphaeng Phet,168,2602,712600,351801,360799,6769,6769,0,,,19/1/2022 7:23
2/8/2021,Khon Kaen,143,4744,1791967,880624,911343,21098,21098,0,59,32,19/1/2022 7:23
2/8/2021,Chanthaburi,34,2816,536132,262097,274035,17881,17815,66,,,19/1/2022 7:23
2/8/2021,Chachoengsao,465,13785,722615,354177,368438,1995,1995,0,44,30,19/1/2022 7:23
2/8/2021,Chon Buri,1145,29532,1580389,771364,809025,30270,29695,575,52,36,19/1/2022 7:23
2/8/2021,Chai Nat,55,877,321015,154292,166723,4171,4171,0,,,19/1/2022 7:23
2/8/2021,Chaiyaphum,252,3551,1122780,554646,568134,13695,13682,13,,,19/1/2022 7:23
2/8/2021,Chumphon,76,1028,509292,251346,257946,1644,1644,0,,,19/1/2022 7:23
2/8/2021,Trang,57,2533,639931,312837,327094,2469,2469,0,,,19/1/2022 7:23
2/8/2021,Trat,22,1119,228459,112922,115537,22368,22277,91,,,19/1/2022 7:23
2/8/2021,Tak,66,5329,674616,341111,333505,12606,12606,0,,,19/1/2022 7:23
2/8/2021,Nakhon Nayok,90,3122,259735,128303,131432,2679,2679,0,,,19/1/2022 7:23
2/8/2021,Nakhon Pathom,143,14348,921500,442584,478916,2714,2714,0,45,16,19/1/2022 7:23
2/8/2021,Nakhon Phanom,113,2222,717048,357194,359854,3548,3548,0,,,19/1/2022 7:23
2/8/2021,Nakhon Ratchasima,457,5786,2633733,1293977,1339756,88532,87939,593,51,25,19/1/2022 7:23
2/8/2021,Nakhon Si Thammarat,158,3837,1549496,764523,784973,7996,7996,0,,,19/1/2022 7:23
2/8/2021,Nakhon Sawan,170,3789,1036534,505545,530989,15946,15946,0,36,21,19/1/2022 7:23
2/8/2021,Nonthaburi,743,33896,1285013,597870,687143,2822,2815,7,32,12,19/1/2022 7:23
2/8/2021,Narathiwat,296,6737,808758,400002,408756,421,421,0,44,18,19/1/2022 7:23
2/8/2021,Nan,46,1060,475941,238073,237868,9832,9798,34,,,19/1/2022 7:23
2/8/2021,Bueng Kan,66,587,421931,211488,210443,2114,2114,0,,,19/1/2022 7:23
2/8/2021,Buri Ram,330,4117,1579709,783665,796044,12087,12044,43,,,19/1/2022 7:23
2/8/2021,Pathum Thani,454,21932,1185082,561507,623575,1319,1306,13,42,21,19/1/2022 7:23
2/8/2021,Prachuap Khiri Khan,89,4990,552888,274321,278567,13974,13921,53,,,19/1/2022 7:23
2/8/2021,Prachin Buri,127,3566,494505,244150,250355,3143,3143,0,60,27,19/1/2022 7:23
2/8/2021,Pattani,197,9162,728801,359974,368827,517,517,0,,,19/1/2022 7:23
2/8/2021,Phra Nakhon Si Ayutthaya,298,8807,819892,393788,426104,17000,16958,42,44,36,19/1/2022 7:23
2/8/2021,Phayao,41,858,465390,226498,238892,9277,9277,0,48,18,19/1/2022 7:23
2/8/2021,Phang-nga,19,669,268269,133881,134388,7037,5969,1068,,,19/1/2022 7:23
2/8/2021,Phatthalung,37,1613,522612,254531,268081,1598,1598,0,,,19/1/2022 7:23
2/8/2021,Phichit,82,1443,530258,258492,271766,6914,6914,0,,,19/1/2022 7:23
2/8/2021,Phitsanulok,78,1918,847684,414983,432701,25715,25564,151,,,19/1/2022 7:23
2/8/2021,Phuket,41,1448,418055,197662,220393,33530,18204,15326,52,25,19/1/2022 7:23
2/8/2021,Maha Sarakham,130,3981,949783,465624,484159,2772,2772,0,,,19/1/2022 7:23
2/8/2021,Mukdahan,51,838,351259,175474,175785,5322,5322,0,,,19/1/2022 7:23
2/8/2021,Yala,177,7619,541494,269636,271858,438,438,0,37,19,19/1/2022 7:23
2/8/2021,Yasothon,73,1768,533506,266189,267317,1561,1561,0,,,19/1/2022 7:23
2/8/2021,Ranong,38,2513,194677,98263,96414,1369,1369,0,,,19/1/2022 7:23
2/8/2021,Rayong,403,8829,748943,367783,381160,18635,18409,226,41,23,19/1/2022 7:23
2/8/2021,Ratchaburi,304,5796,869099,422558,446541,7187,7187,0,,,19/1/2022 7:23
2/8/2021,Roi Et,257,4202,1296428,642234,654194,2700,2700,0,,,19/1/2022 7:23
2/8/2021,Lop Buri,283,4673,740487,369278,371209,7057,7028,29,,,19/1/2022 7:23
2/8/2021,Lampang,34,1290,726261,353817,372444,6862,6727,135,56,18,19/1/2022 7:23
2/8/2021,Lamphun,26,644,401525,192998,208527,7455,7381,74,,,19/1/2022 7:23
2/8/2021,Si Sa Ket,172,4594,1456985,725190,731795,3838,3838,0,,,19/1/2022 7:23
2/8/2021,Sakon Nakhon,153,2492,1146507,569654,576853,4675,4675,0,,,19/1/2022 7:23
2/8/2021,Songkhla,318,13141,1430543,696923,733620,1132,1132,0,51,30,19/1/2022 7:23
2/8/2021,Satun,60,733,324496,161423,163073,1183,1170,13,40,35,19/1/2022 7:23
2/8/2021,Samut Prakarn,872,43097,1355823,645868,709955,1887,1860,27,,,19/1/2022 7:23
2/8/2021,Samut Songkhram,163,2225,191276,91338,99938,4546,4546,0,33,13,19/1/2022 7:23
2/8/2021,Samut Sakhon,1253,50775,585685,282240,303445,1338,1338,0,56,33,19/1/2022 7:23
2/8/2021,Saraburi,486,8034,643873,316304,327569,9794,9776,18,51,40,19/1/2022 7:23
2/8/2021,Sa kaeo,387,3907,561509,280362,281147,2377,2377,0,40,21,19/1/2022 7:23
2/8/2021,Sing Buri,59,845,205088,97428,107660,3064,3064,0,,,19/1/2022 7:23
2/8/2021,Suphan Buri,226,5735,836435,403512,432923,6542,6542,0,,,19/1/2022 7:23
2/8/2021,Surat Thani,72,3432,1071496,527024,544472,4790,4115,675,62,24,19/1/2022 7:23
2/8/2021,Surin,216,4461,1376723,684837,691886,8153,8131,22,,,19/1/2022 7:23
2/8/2021,Sukhothai,90,2124,585851,283686,302165,4868,4868,0,,,19/1/2022 7:23
2/8/2021,Nong Khai,32,972,516896,256327,260569,6520,6513,7,37,16,19/1/2022 7:23
2/8/2021,Nong Bua Lam Phu,73,1209,508942,253805,255137,1487,1487,0,,,19/1/2022 7:23
2/8/2021,Amnat Charoen,74,1051,376228,187133,189095,1440,1440,0,,,19/1/2022 7:23
2/8/2021,Udon Thani,263,4186,1566940,776022,790918,9291,9282,9,,,19/1/2022 7:23
2/8/2021,Uttaradit,58,1572,447089,217944,229145,6329,6329,0,,,19/1/2022 7:23
2/8/2021,Uthai Thani,58,1058,325254,158926,166328,2279,2279,0,,,19/1/2022 7:23
2/8/2021,Ubon Ratchathani,292,5554,1867365,932174,935191,7252,7252,0,52,25,19/1/2022 7:23
2/8/2021,Ang Thong,165,3211,275476,131801,143675,962,962,0,,,19/1/2022 7:23
2/8/2021,Chiang Rai,57,1853,1297168,630483,666685,28142,27897,245,36,7,19/1/2022 7:23
2/8/2021,Chiang Mai,59,9893,1787281,863640,923641,68614,67650,964,66,29,19/1/2022 7:23
2/8/2021,Phetchaburi,112,12152,482600,232958,249642,12139,12096,43,,,19/1/2022 7:23
2/8/2021,Phetchabun,45,2171,979033,482878,496155,20292,20262,30,,,19/1/2022 7:23
2/8/2021,Loei,71,1244,638862,320119,318743,5789,5778,11,30,20,19/1/2022 7:23
2/8/2021,Phrae,23,628,435481,209872,225609,5872,5872,0,48,19,19/1/2022 7:23
2/8/2021,Mae Hong Son,6,164,285778,144757,141021,8861,8659,202,24,6,19/1/2022 7:23
2/8/2021,,0,153,,,,,,,,,19/1/2022 7:23
3/8/2021,Krabi,13,1130,478664,237717,240947,2096,1981,115,,,19/1/2022 7:23
3/8/2021,Bangkok,3611,189238,5544789,2601856,2942933,202959,181431,21528,40,25,19/1/2022 7:23
3/8/2021,Kanchanaburi,269,4935,893129,447919,445210,20185,20157,28,29,20,19/1/2022 7:23
3/8/2021,Kalasin,142,3374,976083,482351,493732,2306,2306,0,,,19/1/2022 7:23
3/8/2021,Kamphaeng Phet,135,2737,712600,351801,360799,6769,6769,0,,,19/1/2022 7:23
3/8/2021,Khon Kaen,141,4885,1791967,880624,911343,21098,21098,0,61,35,19/1/2022 7:23
3/8/2021,Chanthaburi,65,2881,536132,262097,274035,17881,17815,66,,,19/1/2022 7:23
3/8/2021,Chachoengsao,315,14100,722615,354177,368438,1995,1995,0,43,32,19/1/2022 7:23
3/8/2021,Chon Buri,1359,30891,1580389,771364,809025,30270,29695,575,47,48,19/1/2022 7:23
3/8/2021,Chai Nat,42,919,321015,154292,166723,4171,4171,0,,,19/1/2022 7:23
3/8/2021,Chaiyaphum,101,3652,1122780,554646,568134,13695,13682,13,,,19/1/2022 7:23
3/8/2021,Chumphon,60,1088,509292,251346,257946,1644,1644,0,,,19/1/2022 7:23
3/8/2021,Trang,68,2601,639931,312837,327094,2469,2469,0,,,19/1/2022 7:23
3/8/2021,Trat,35,1154,228459,112922,115537,22368,22277,91,,,19/1/2022 7:23
3/8/2021,Tak,101,5430,674616,341111,333505,12606,12606,0,,,19/1/2022 7:23
3/8/2021,Nakhon Nayok,46,3168,259735,128303,131432,2679,2679,0,,,19/1/2022 7:23
3/8/2021,Nakhon Pathom,325,14673,921500,442584,478916,2714,2714,0,39,17,19/1/2022 7:23
3/8/2021,Nakhon Phanom,150,2372,717048,357194,359854,3548,3548,0,,,19/1/2022 7:23
3/8/2021,Nakhon Ratchasima,454,6240,2633733,1293977,1339756,88532,87939,593,54,27,19/1/2022 7:23
3/8/2021,Nakhon Si Thammarat,78,3915,1549496,764523,784973,7996,7996,0,,,19/1/2022 7:23
3/8/2021,Nakhon Sawan,140,3929,1036534,505545,530989,15946,15946,0,37,31,19/1/2022 7:23
3/8/2021,Nonthaburi,565,34461,1285013,597870,687143,2822,2815,7,28,14,19/1/2022 7:23
3/8/2021,Narathiwat,185,6922,808758,400002,408756,421,421,0,44,18,19/1/2022 7:23
3/8/2021,Nan,66,1126,475941,238073,237868,9832,9798,34,,,19/1/2022 7:23
3/8/2021,Bueng Kan,76,663,421931,211488,210443,2114,2114,0,,,19/1/2022 7:23
3/8/2021,Buri Ram,405,4522,1579709,783665,796044,12087,12044,43,,,19/1/2022 7:23
3/8/2021,Pathum Thani,578,22510,1185082,561507,623575,1319,1306,13,41,25,19/1/2022 7:23
3/8/2021,Prachuap Khiri Khan,69,5059,552888,274321,278567,13974,13921,53,,,19/1/2022 7:23
3/8/2021,Prachin Buri,106,3672,494505,244150,250355,3143,3143,0,59,27,19/1/2022 7:23
3/8/2021,Pattani,198,9360,728801,359974,368827,517,517,0,,,19/1/2022 7:23
3/8/2021,Phra Nakhon Si Ayutthaya,409,9216,819892,393788,426104,17000,16958,42,37,43,19/1/2022 7:23
3/8/2021,Phayao,43,901,465390,226498,238892,9277,9277,0,38,18,19/1/2022 7:23
3/8/2021,Phang-nga,3,672,268269,133881,134388,7037,5969,1068,,,19/1/2022 7:23
3/8/2021,Phatthalung,40,1653,522612,254531,268081,1598,1598,0,,,19/1/2022 7:23
3/8/2021,Phichit,58,1501,530258,258492,271766,6914,6914,0,,,19/1/2022 7:23
3/8/2021,Phitsanulok,47,1965,847684,414983,432701,25715,25564,151,,,19/1/2022 7:23
3/8/2021,Phuket,36,1484,418055,197662,220393,33530,18204,15326,53,29,19/1/2022 7:23
3/8/2021,Maha Sarakham,216,4197,949783,465624,484159,2772,2772,0,,,19/1/2022 7:23
3/8/2021,Mukdahan,29,867,351259,175474,175785,5322,5322,0,,,19/1/2022 7:23
3/8/2021,Yala,173,7792,541494,269636,271858,438,438,0,42,20,19/1/2022 7:23
3/8/2021,Yasothon,217,1985,533506,266189,267317,1561,1561,0,,,19/1/2022 7:23
3/8/2021,Ranong,62,2575,194677,98263,96414,1369,1369,0,,,19/1/2022 7:23
3/8/2021,Rayong,219,9048,748943,367783,381160,18635,18409,226,32,26,19/1/2022 7:23
3/8/2021,Ratchaburi,115,5911,869099,422558,446541,7187,7187,0,,,19/1/2022 7:23
3/8/2021,Roi Et,167,4369,1296428,642234,654194,2700,2700,0,,,19/1/2022 7:23
3/8/2021,Lop Buri,176,4849,740487,369278,371209,7057,7028,29,,,19/1/2022 7:23
3/8/2021,Lampang,52,1342,726261,353817,372444,6862,6727,135,56,17,19/1/2022 7:23
3/8/2021,Lamphun,21,665,401525,192998,208527,7455,7381,74,,,19/1/2022 7:23
3/8/2021,Si Sa Ket,358,4952,1456985,725190,731795,3838,3838,0,,,19/1/2022 7:23
3/8/2021,Sakon Nakhon,192,2684,1146507,569654,576853,4675,4675,0,,,19/1/2022 7:23
3/8/2021,Songkhla,122,13263,1430543,696923,733620,1132,1132,0,52,25,19/1/2022 7:23
3/8/2021,Satun,19,752,324496,161423,163073,1183,1170,13,54,34,19/1/2022 7:23
3/8/2021,Samut Prakarn,1426,44523,1355823,645868,709955,1887,1860,27,,,19/1/2022 7:23
3/8/2021,Samut Songkhram,246,2471,191276,91338,99938,4546,4546,0,25,19,19/1/2022 7:23
3/8/2021,Samut Sakhon,1283,52058,585685,282240,303445,1338,1338,0,55,40,19/1/2022 7:23
3/8/2021,Saraburi,308,8342,643873,316304,327569,9794,9776,18,52,42,19/1/2022 7:23
3/8/2021,Sa kaeo,384,4291,561509,280362,281147,2377,2377,0,36,20,19/1/2022 7:23
3/8/2021,Sing Buri,46,891,205088,97428,107660,3064,3064,0,,,19/1/2022 7:23
3/8/2021,Suphan Buri,230,5965,836435,403512,432923,6542,6542,0,,,19/1/2022 7:23
3/8/2021,Surat Thani,65,3497,1071496,527024,544472,4790,4115,675,59,25,19/1/2022 7:23
3/8/2021,Surin,292,4753,1376723,684837,691886,8153,8131,22,,,19/1/2022 7:23
3/8/2021,Sukhothai,90,2214,585851,283686,302165,4868,4868,0,,,19/1/2022 7:23
3/8/2021,Nong Khai,36,1008,516896,256327,260569,6520,6513,7,40,15,19/1/2022 7:23
3/8/2021,Nong Bua Lam Phu,32,1241,508942,253805,255137,1487,1487,0,,,19/1/2022 7:23
3/8/2021,Amnat Charoen,78,1129,376228,187133,189095,1440,1440,0,,,19/1/2022 7:23
3/8/2021,Udon Thani,247,4433,1566940,776022,790918,9291,9282,9,,,19/1/2022 7:23
3/8/2021,Uttaradit,110,1682,447089,217944,229145,6329,6329,0,,,19/1/2022 7:23
3/8/2021,Uthai Thani,64,1122,325254,158926,166328,2279,2279,0,,,19/1/2022 7:23
3/8/2021,Ubon Ratchathani,495,6049,1867365,932174,935191,7252,7252,0,55,24,19/1/2022 7:23
3/8/2021,Ang Thong,342,3553,275476,131801,143675,962,962,0,,,19/1/2022 7:23
3/8/2021,Chiang Rai,32,1885,1297168,630483,666685,28142,27897,245,25,7,19/1/2022 7:23
3/8/2021,Chiang Mai,63,9956,1787281,863640,923641,68614,67650,964,61,28,19/1/2022 7:23
3/8/2021,Phetchaburi,116,12268,482600,232958,249642,12139,12096,43,,,19/1/2022 7:23
3/8/2021,Phetchabun,169,2340,979033,482878,496155,20292,20262,30,,,19/1/2022 7:23
3/8/2021,Loei,38,1282,638862,320119,318743,5789,5778,11,38,18,19/1/2022 7:23
3/8/2021,Phrae,28,656,435481,209872,225609,5872,5872,0,48,18,19/1/2022 7:23
3/8/2021,Mae Hong Son,9,173,285778,144757,141021,8861,8659,202,26,5,19/1/2022 7:23
3/8/2021,,0,153,,,,,,,,,19/1/2022 7:23
4/8/2021,Krabi,17,1147,478664,237717,240947,2096,1981,115,,,19/1/2022 7:23
4/8/2021,Bangkok,4130,193368,5544789,2601856,2942933,202959,181431,21528,52,29,19/1/2022 7:23
4/8/2021,Kanchanaburi,219,5154,893129,447919,445210,20185,20157,28,36,19,19/1/2022 7:23
4/8/2021,Kalasin,188,3562,976083,482351,493732,2306,2306,0,,,19/1/2022 7:23
4/8/2021,Kamphaeng Phet,113,2850,712600,351801,360799,6769,6769,0,,,19/1/2022 7:23
4/8/2021,Khon Kaen,186,5071,1791967,880624,911343,21098,21098,0,65,39,19/1/2022 7:23
4/8/2021,Chanthaburi,42,2923,536132,262097,274035,17881,17815,66,,,19/1/2022 7:23
4/8/2021,Chachoengsao,556,14656,722615,354177,368438,1995,1995,0,51,36,19/1/2022 7:23
4/8/2021,Chon Buri,1681,32572,1580389,771364,809025,30270,29695,575,49,45,19/1/2022 7:23
4/8/2021,Chai Nat,75,994,321015,154292,166723,4171,4171,0,,,19/1/2022 7:23
4/8/2021,Chaiyaphum,136,3788,1122780,554646,568134,13695,13682,13,,,19/1/2022 7:23
4/8/2021,Chumphon,142,1230,509292,251346,257946,1644,1644,0,,,19/1/2022 7:23
4/8/2021,Trang,57,2658,639931,312837,327094,2469,2469,0,,,19/1/2022 7:23
4/8/2021,Trat,30,1184,228459,112922,115537,22368,22277,91,,,19/1/2022 7:23
4/8/2021,Tak,279,5709,674616,341111,333505,12606,12606,0,,,19/1/2022 7:23
4/8/2021,Nakhon Nayok,249,3417,259735,128303,131432,2679,2679,0,,,19/1/2022 7:23
4/8/2021,Nakhon Pathom,282,14955,921500,442584,478916,2714,2714,0,39,17,19/1/2022 7:23
4/8/2021,Nakhon Phanom,115,2487,717048,357194,359854,3548,3548,0,,,19/1/2022 7:23
4/8/2021,Nakhon Ratchasima,456,6696,2633733,1293977,1339756,88532,87939,593,55,26,19/1/2022 7:23
4/8/2021,Nakhon Si Thammarat,93,4008,1549496,764523,784973,7996,7996,0,,,19/1/2022 7:23
4/8/2021,Nakhon Sawan,179,4108,1036534,505545,530989,15946,15946,0,59,32,19/1/2022 7:23
4/8/2021,Nonthaburi,909,35370,1285013,597870,687143,2822,2815,7,37,15,19/1/2022 7:23
4/8/2021,Narathiwat,248,7170,808758,400002,408756,421,421,0,40,21,19/1/2022 7:23
4/8/2021,Nan,59,1185,475941,238073,237868,9832,9798,34,,,19/1/2022 7:23
4/8/2021,Bueng Kan,62,725,421931,211488,210443,2114,2114,0,,,19/1/2022 7:23
4/8/2021,Buri Ram,234,4756,1579709,783665,796044,12087,12044,43,,,19/1/2022 7:23
4/8/2021,Pathum Thani,269,22779,1185082,561507,623575,1319,1306,13,46,27,19/1/2022 7:23
4/8/2021,Prachuap Khiri Khan,108,5167,552888,274321,278567,13974,13921,53,,,19/1/2022 7:23
4/8/2021,Prachin Buri,128,3800,494505,244150,250355,3143,3143,0,58,36,19/1/2022 7:23
4/8/2021,Pattani,246,9606,728801,359974,368827,517,517,0,,,19/1/2022 7:23
4/8/2021,Phra Nakhon Si Ayutthaya,357,9573,819892,393788,426104,17000,16958,42,50,43,19/1/2022 7:23
4/8/2021,Phayao,49,950,465390,226498,238892,9277,9277,0,35,19,19/1/2022 7:23
4/8/2021,Phang-nga,24,696,268269,133881,134388,7037,5969,1068,,,19/1/2022 7:23
4/8/2021,Phatthalung,17,1670,522612,254531,268081,1598,1598,0,,,19/1/2022 7:23
4/8/2021,Phichit,65,1566,530258,258492,271766,6914,6914,0,,,19/1/2022 7:23
4/8/2021,Phitsanulok,55,2020,847684,414983,432701,25715,25564,151,,,19/1/2022 7:23
4/8/2021,Phuket,24,1508,418055,197662,220393,33530,18204,15326,52,34,19/1/2022 7:23
4/8/2021,Maha Sarakham,300,4497,949783,465624,484159,2772,2772,0,,,19/1/2022 7:23
4/8/2021,Mukdahan,52,919,351259,175474,175785,5322,5322,0,,,19/1/2022 7:23
4/8/2021,Yala,143,7935,541494,269636,271858,438,438,0,42,20,19/1/2022 7:23
4/8/2021,Yasothon,84,2069,533506,266189,267317,1561,1561,0,,,19/1/2022 7:23
4/8/2021,Ranong,54,2629,194677,98263,96414,1369,1369,0,,,19/1/2022 7:23
4/8/2021,Rayong,272,9320,748943,367783,381160,18635,18409,226,47,26,19/1/2022 7:23
4/8/2021,Ratchaburi,350,6261,869099,422558,446541,7187,7187,0,,,19/1/2022 7:23
4/8/2021,Roi Et,244,4613,1296428,642234,654194,2700,2700,0,,,19/1/2022 7:23
4/8/2021,Lop Buri,108,4957,740487,369278,371209,7057,7028,29,,,19/1/2022 7:23
4/8/2021,Lampang,36,1378,726261,353817,372444,6862,6727,135,54,19,19/1/2022 7:23
4/8/2021,Lamphun,20,685,401525,192998,208527,7455,7381,74,,,19/1/2022 7:23
4/8/2021,Si Sa Ket,252,5204,1456985,725190,731795,3838,3838,0,,,19/1/2022 7:23
4/8/2021,Sakon Nakhon,175,2859,1146507,569654,576853,4675,4675,0,,,19/1/2022 7:23
4/8/2021,Songkhla,354,13617,1430543,696923,733620,1132,1132,0,43,26,19/1/2022 7:23
4/8/2021,Satun,38,790,324496,161423,163073,1183,1170,13,44,38,19/1/2022 7:23
4/8/2021,Samut Prakarn,948,45471,1355823,645868,709955,1887,1860,27,,,19/1/2022 7:23
4/8/2021,Samut Songkhram,128,2599,191276,91338,99938,4546,4546,0,39,17,19/1/2022 7:23
4/8/2021,Samut Sakhon,1294,53352,585685,282240,303445,1338,1338,0,67,41,19/1/2022 7:23
4/8/2021,Saraburi,529,8871,643873,316304,327569,9794,9776,18,58,45,19/1/2022 7:23
4/8/2021,Sa kaeo,192,4483,561509,280362,281147,2377,2377,0,39,25,19/1/2022 7:23
4/8/2021,Sing Buri,51,942,205088,97428,107660,3064,3064,0,,,19/1/2022 7:23
4/8/2021,Suphan Buri,287,6252,836435,403512,432923,6542,6542,0,,,19/1/2022 7:23
4/8/2021,Surat Thani,78,3575,1071496,527024,544472,4790,4115,675,57,26,19/1/2022 7:23
4/8/2021,Surin,340,5093,1376723,684837,691886,8153,8131,22,,,19/1/2022 7:23
4/8/2021,Sukhothai,153,2367,585851,283686,302165,4868,4868,0,,,19/1/2022 7:23
4/8/2021,Nong Khai,41,1049,516896,256327,260569,6520,6513,7,36,16,19/1/2022 7:23
4/8/2021,Nong Bua Lam Phu,94,1335,508942,253805,255137,1487,1487,0,,,19/1/2022 7:23
4/8/2021,Amnat Charoen,60,1189,376228,187133,189095,1440,1440,0,,,19/1/2022 7:23
4/8/2021,Udon Thani,388,4821,1566940,776022,790918,9291,9282,9,,,19/1/2022 7:23
4/8/2021,Uttaradit,69,1751,447089,217944,229145,6329,6329,0,,,19/1/2022 7:23
4/8/2021,Uthai Thani,88,1210,325254,158926,166328,2279,2279,0,,,19/1/2022 7:23
4/8/2021,Ubon Ratchathani,411,6460,1867365,932174,935191,7252,7252,0,52,27,19/1/2022 7:23
4/8/2021,Ang Thong,151,3704,275476,131801,143675,962,962,0,,,19/1/2022 7:23
4/8/2021,Chiang Rai,48,1933,1297168,630483,666685,28142,27897,245,24,9,19/1/2022 7:23
4/8/2021,Chiang Mai,66,10022,1787281,863640,923641,68614,67650,964,58,26,19/1/2022 7:23
4/8/2021,Phetchaburi,111,12379,482600,232958,249642,12139,12096,43,,,19/1/2022 7:23
4/8/2021,Phetchabun,27,2367,979033,482878,496155,20292,20262,30,,,19/1/2022 7:23
4/8/2021,Loei,48,1330,638862,320119,318743,5789,5778,11,36,24,19/1/2022 7:23
4/8/2021,Phrae,24,680,435481,209872,225609,5872,5872,0,47,23,19/1/2022 7:23
4/8/2021,Mae Hong Son,13,186,285778,144757,141021,8861,8659,202,23,8,19/1/2022 7:23
4/8/2021,,0,153,,,,,,,,,19/1/2022 7:23
5/8/2021,Krabi,17,1164,478664,237717,240947,2096,1981,115,,,19/1/2022 7:23
5/8/2021,Bangkok,4154,197522,5544789,2601856,2942933,202959,181431,21528,60,24,19/1/2022 7:23
5/8/2021,Kanchanaburi,121,5275,893129,447919,445210,20185,20157,28,33,16,19/1/2022 7:23
5/8/2021,Kalasin,202,3764,976083,482351,493732,2306,2306,0,,,19/1/2022 7:23
5/8/2021,Kamphaeng Phet,215,3065,712600,351801,360799,6769,6769,0,,,19/1/2022 7:23
5/8/2021,Khon Kaen,159,5230,1791967,880624,911343,21098,21098,0,71,36,19/1/2022 7:23
5/8/2021,Chanthaburi,56,2979,536132,262097,274035,17881,17815,66,,,19/1/2022 7:23
5/8/2021,Chachoengsao,449,15105,722615,354177,368438,1995,1995,0,51,31,19/1/2022 7:23
5/8/2021,Chon Buri,1352,33924,1580389,771364,809025,30270,29695,575,52,39,19/1/2022 7:23
5/8/2021,Chai Nat,66,1060,321015,154292,166723,4171,4171,0,,,19/1/2022 7:23
5/8/2021,Chaiyaphum,240,4028,1122780,554646,568134,13695,13682,13,,,19/1/2022 7:23
5/8/2021,Chumphon,93,1323,509292,251346,257946,1644,1644,0,,,19/1/2022 7:23
5/8/2021,Trang,62,2720,639931,312837,327094,2469,2469,0,,,19/1/2022 7:23
5/8/2021,Trat,21,1205,228459,112922,115537,22368,22277,91,,,19/1/2022 7:23
5/8/2021,Tak,195,5904,674616,341111,333505,12606,12606,0,,,19/1/2022 7:23
5/8/2021,Nakhon Nayok,165,3582,259735,128303,131432,2679,2679,0,,,19/1/2022 7:23
5/8/2021,Nakhon Pathom,377,15332,921500,442584,478916,2714,2714,0,39,19,19/1/2022 7:23
5/8/2021,Nakhon Phanom,147,2634,717048,357194,359854,3548,3548,0,,,19/1/2022 7:23
5/8/2021,Nakhon Ratchasima,565,7261,2633733,1293977,1339756,88532,87939,593,56,24,19/1/2022 7:23
5/8/2021,Nakhon Si Thammarat,165,4173,1549496,764523,784973,7996,7996,0,,,19/1/2022 7:23
5/8/2021,Nakhon Sawan,129,4237,1036534,505545,530989,15946,15946,0,62,32,19/1/2022 7:23
5/8/2021,Nonthaburi,754,36124,1285013,597870,687143,2822,2815,7,35,15,19/1/2022 7:23
5/8/2021,Narathiwat,253,7423,808758,400002,408756,421,421,0,49,24,19/1/2022 7:23
5/8/2021,Nan,71,1256,475941,238073,237868,9832,9798,34,,,19/1/2022 7:23
5/8/2021,Bueng Kan,50,775,421931,211488,210443,2114,2114,0,,,19/1/2022 7:23
5/8/2021,Buri Ram,338,5094,1579709,783665,796044,12087,12044,43,,,19/1/2022 7:23
5/8/2021,Pathum Thani,590,23369,1185082,561507,623575,1319,1306,13,46,32,19/1/2022 7:23
5/8/2021,Prachuap Khiri Khan,94,5261,552888,274321,278567,13974,13921,53,,,19/1/2022 7:23
5/8/2021,Prachin Buri,131,3931,494505,244150,250355,3143,3143,0,71,27,19/1/2022 7:23
5/8/2021,Pattani,275,9881,728801,359974,368827,517,517,0,,,19/1/2022 7:23
5/8/2021,Phra Nakhon Si Ayutthaya,431,10004,819892,393788,426104,17000,16958,42,45,38,19/1/2022 7:23
5/8/2021,Phayao,41,991,465390,226498,238892,9277,9277,0,42,18,19/1/2022 7:23
5/8/2021,Phang-nga,14,710,268269,133881,134388,7037,5969,1068,,,19/1/2022 7:23
5/8/2021,Phatthalung,32,1702,522612,254531,268081,1598,1598,0,,,19/1/2022 7:23
5/8/2021,Phichit,57,1623,530258,258492,271766,6914,6914,0,,,19/1/2022 7:23
5/8/2021,Phitsanulok,44,2064,847684,414983,432701,25715,25564,151,,,19/1/2022 7:23
5/8/2021,Phuket,69,1577,418055,197662,220393,33530,18204,15326,54,33,19/1/2022 7:23
5/8/2021,Maha Sarakham,361,4858,949783,465624,484159,2772,2772,0,,,19/1/2022 7:23
5/8/2021,Mukdahan,56,975,351259,175474,175785,5322,5322,0,,,19/1/2022 7:23
5/8/2021,Yala,219,8154,541494,269636,271858,438,438,0,46,28,19/1/2022 7:23
5/8/2021,Yasothon,190,2259,533506,266189,267317,1561,1561,0,,,19/1/2022 7:23
5/8/2021,Ranong,66,2695,194677,98263,96414,1369,1369,0,,,19/1/2022 7:23
5/8/2021,Rayong,288,9608,748943,367783,381160,18635,18409,226,40,26,19/1/2022 7:23
5/8/2021,Ratchaburi,267,6528,869099,422558,446541,7187,7187,0,,,19/1/2022 7:23
5/8/2021,Roi Et,307,4920,1296428,642234,654194,2700,2700,0,,,19/1/2022 7:23
5/8/2021,Lop Buri,219,5176,740487,369278,371209,7057,7028,29,,,19/1/2022 7:23
5/8/2021,Lampang,48,1426,726261,353817,372444,6862,6727,135,58,17,19/1/2022 7:23
5/8/2021,Lamphun,17,702,401525,192998,208527,7455,7381,74,,,19/1/2022 7:23
5/8/2021,Si Sa Ket,268,5472,1456985,725190,731795,3838,3838,0,,,19/1/2022 7:23
5/8/2021,Sakon Nakhon,247,3106,1146507,569654,576853,4675,4675,0,,,19/1/2022 7:23
5/8/2021,Songkhla,237,13854,1430543,696923,733620,1132,1132,0,50,39,19/1/2022 7:23
5/8/2021,Satun,28,818,324496,161423,163073,1183,1170,13,44,41,19/1/2022 7:23
5/8/2021,Samut Prakarn,1327,46798,1355823,645868,709955,1887,1860,27,,,19/1/2022 7:23
5/8/2021,Samut Songkhram,156,2755,191276,91338,99938,4546,4546,0,36,15,19/1/2022 7:23
5/8/2021,Samut Sakhon,1279,54631,585685,282240,303445,1338,1338,0,65,35,19/1/2022 7:23
5/8/2021,Saraburi,494,9365,643873,316304,327569,9794,9776,18,50,43,19/1/2022 7:23
5/8/2021,Sa kaeo,265,4748,561509,280362,281147,2377,2377,0,46,21,19/1/2022 7:23
5/8/2021,Sing Buri,49,991,205088,97428,107660,3064,3064,0,,,19/1/2022 7:23
5/8/2021,Suphan Buri,126,6378,836435,403512,432923,6542,6542,0,,,19/1/2022 7:23
5/8/2021,Surat Thani,97,3672,1071496,527024,544472,4790,4115,675,61,25,19/1/2022 7:23
5/8/2021,Surin,220,5313,1376723,684837,691886,8153,8131,22,,,19/1/2022 7:23
5/8/2021,Sukhothai,108,2475,585851,283686,302165,4868,4868,0,,,19/1/2022 7:23
5/8/2021,Nong Khai,71,1120,516896,256327,260569,6520,6513,7,40,14,19/1/2022 7:23
5/8/2021,Nong Bua Lam Phu,73,1408,508942,253805,255137,1487,1487,0,,,19/1/2022 7:23
5/8/2021,Amnat Charoen,79,1268,376228,187133,189095,1440,1440,0,,,19/1/2022 7:23
5/8/2021,Udon Thani,322,5143,1566940,776022,790918,9291,9282,9,,,19/1/2022 7:23
5/8/2021,Uttaradit,90,1841,447089,217944,229145,6329,6329,0,,,19/1/2022 7:23
5/8/2021,Uthai Thani,48,1258,325254,158926,166328,2279,2279,0,,,19/1/2022 7:23
5/8/2021,Ubon Ratchathani,334,6794,1867365,932174,935191,7252,7252,0,57,29,19/1/2022 7:23
5/8/2021,Ang Thong,215,3919,275476,131801,143675,962,962,0,,,19/1/2022 7:23
5/8/2021,Chiang Rai,72,2005,1297168,630483,666685,28142,27897,245,32,11,19/1/2022 7:23
5/8/2021,Chiang Mai,49,10071,1787281,863640,923641,68614,67650,964,53,25,19/1/2022 7:23
5/8/2021,Phetchaburi,133,12512,482600,232958,249642,12139,12096,43,,,19/1/2022 7:23
5/8/2021,Phetchabun,192,2559,979033,482878,496155,20292,20262,30,,,19/1/2022 7:23
5/8/2021,Loei,63,1393,638862,320119,318743,5789,5778,11,49,22,19/1/2022 7:23
5/8/2021,Phrae,45,725,435481,209872,225609,5872,5872,0,54,21,19/1/2022 7:23
5/8/2021,Mae Hong Son,1,187,285778,144757,141021,8861,8659,202,32,10,19/1/2022 7:23
5/8/2021,,0,153,,,,,,,,,19/1/2022 7:23
6/8/2021,Krabi,16,1180,478664,237717,240947,2096,1981,115,,,19/1/2022 7:23
6/8/2021,Bangkok,4713,202235,5544789,2601856,2942933,202959,181431,21528,53,26,19/1/2022 7:23
6/8/2021,Kanchanaburi,179,5454,893129,447919,445210,20185,20157,28,34,13,19/1/2022 7:23
6/8/2021,Kalasin,239,4003,976083,482351,493732,2306,2306,0,,,19/1/2022 7:23
6/8/2021,Kamphaeng Phet,114,3179,712600,351801,360799,6769,6769,0,,,19/1/2022 7:23
6/8/2021,Khon Kaen,188,5418,1791967,880624,911343,21098,21098,0,67,34,19/1/2022 7:23
6/8/2021,Chanthaburi,64,3043,536132,262097,274035,17881,17815,66,,,19/1/2022 7:23
6/8/2021,Chachoengsao,527,15632,722615,354177,368438,1995,1995,0,46,32,19/1/2022 7:23
6/8/2021,Chon Buri,1381,35305,1580389,771364,809025,30270,29695,575,51,38,19/1/2022 7:23
6/8/2021,Chai Nat,68,1128,321015,154292,166723,4171,4171,0,,,19/1/2022 7:23
6/8/2021,Chaiyaphum,249,4277,1122780,554646,568134,13695,13682,13,,,19/1/2022 7:23
6/8/2021,Chumphon,59,1382,509292,251346,257946,1644,1644,0,,,19/1/2022 7:23
6/8/2021,Trang,60,2780,639931,312837,327094,2469,2469,0,,,19/1/2022 7:23
6/8/2021,Trat,27,1232,228459,112922,115537,22368,22277,91,,,19/1/2022 7:23
6/8/2021,Tak,172,6076,674616,341111,333505,12606,12606,0,,,19/1/2022 7:23
6/8/2021,Nakhon Nayok,77,3659,259735,128303,131432,2679,2679,0,,,19/1/2022 7:23
6/8/2021,Nakhon Pathom,482,15814,921500,442584,478916,2714,2714,0,42,20,19/1/2022 7:23
6/8/2021,Nakhon Phanom,113,2747,717048,357194,359854,3548,3548,0,,,19/1/2022 7:23
6/8/2021,Nakhon Ratchasima,281,7542,2633733,1293977,1339756,88532,87939,593,54,25,19/1/2022 7:23
6/8/2021,Nakhon Si Thammarat,351,4524,1549496,764523,784973,7996,7996,0,,,19/1/2022 7:23
6/8/2021,Nakhon Sawan,325,4562,1036534,505545,530989,15946,15946,0,62,28,19/1/2022 7:23
6/8/2021,Nonthaburi,716,36840,1285013,597870,687143,2822,2815,7,32,15,19/1/2022 7:23
6/8/2021,Narathiwat,240,7663,808758,400002,408756,421,421,0,60,26,19/1/2022 7:23
6/8/2021,Nan,34,1290,475941,238073,237868,9832,9798,34,,,19/1/2022 7:23
6/8/2021,Bueng Kan,99,874,421931,211488,210443,2114,2114,0,,,19/1/2022 7:23
6/8/2021,Buri Ram,200,5294,1579709,783665,796044,12087,12044,43,,,19/1/2022 7:23
6/8/2021,Pathum Thani,552,23921,1185082,561507,623575,1319,1306,13,55,25,19/1/2022 7:23
6/8/2021,Prachuap Khiri Khan,163,5424,552888,274321,278567,13974,13921,53,,,19/1/2022 7:23
6/8/2021,Prachin Buri,95,4026,494505,244150,250355,3143,3143,0,58,28,19/1/2022 7:23
6/8/2021,Pattani,289,10170,728801,359974,368827,517,517,0,,,19/1/2022 7:23
6/8/2021,Phra Nakhon Si Ayutthaya,354,10358,819892,393788,426104,17000,16958,42,36,43,19/1/2022 7:23
6/8/2021,Phayao,44,1035,465390,226498,238892,9277,9277,0,40,18,19/1/2022 7:23
6/8/2021,Phang-nga,14,724,268269,133881,134388,7037,5969,1068,,,19/1/2022 7:23
6/8/2021,Phatthalung,55,1757,522612,254531,268081,1598,1598,0,,,19/1/2022 7:23
6/8/2021,Phichit,58,1681,530258,258492,271766,6914,6914,0,,,19/1/2022 7:23
6/8/2021,Phitsanulok,103,2167,847684,414983,432701,25715,25564,151,,,19/1/2022 7:23
6/8/2021,Phuket,39,1616,418055,197662,220393,33530,18204,15326,58,27,19/1/2022 7:23
6/8/2021,Maha Sarakham,254,5112,949783,465624,484159,2772,2772,0,,,19/1/2022 7:23
6/8/2021,Mukdahan,41,1016,351259,175474,175785,5322,5322,0,,,19/1/2022 7:23
6/8/2021,Yala,199,8353,541494,269636,271858,438,438,0,58,31,19/1/2022 7:23
6/8/2021,Yasothon,148,2407,533506,266189,267317,1561,1561,0,,,19/1/2022 7:23
6/8/2021,Ranong,70,2765,194677,98263,96414,1369,1369,0,,,19/1/2022 7:23
6/8/2021,Rayong,339,9947,748943,367783,381160,18635,18409,226,45,26,19/1/2022 7:23
6/8/2021,Ratchaburi,204,6732,869099,422558,446541,7187,7187,0,,,19/1/2022 7:23
6/8/2021,Roi Et,217,5137,1296428,642234,654194,2700,2700,0,,,19/1/2022 7:23
6/8/2021,Lop Buri,291,5467,740487,369278,371209,7057,7028,29,,,19/1/2022 7:23
6/8/2021,Lampang,73,1499,726261,353817,372444,6862,6727,135,53,17,19/1/2022 7:23
6/8/2021,Lamphun,21,723,401525,192998,208527,7455,7381,74,,,19/1/2022 7:23
6/8/2021,Si Sa Ket,201,5673,1456985,725190,731795,3838,3838,0,,,19/1/2022 7:23
6/8/2021,Sakon Nakhon,186,3292,1146507,569654,576853,4675,4675,0,,,19/1/2022 7:23
6/8/2021,Songkhla,266,14120,1430543,696923,733620,1132,1132,0,76,34,19/1/2022 7:23
6/8/2021,Satun,9,827,324496,161423,163073,1183,1170,13,49,36,19/1/2022 7:23
6/8/2021,Samut Prakarn,1368,48166,1355823,645868,709955,1887,1860,27,,,19/1/2022 7:23
6/8/2021,Samut Songkhram,461,3216,191276,91338,99938,4546,4546,0,29,15,19/1/2022 7:23
6/8/2021,Samut Sakhon,1355,55986,585685,282240,303445,1338,1338,0,61,32,19/1/2022 7:23
6/8/2021,Saraburi,428,9793,643873,316304,327569,9794,9776,18,52,53,19/1/2022 7:23
6/8/2021,Sa kaeo,131,4879,561509,280362,281147,2377,2377,0,45,20,19/1/2022 7:23
6/8/2021,Sing Buri,49,1040,205088,97428,107660,3064,3064,0,,,19/1/2022 7:23
6/8/2021,Suphan Buri,194,6572,836435,403512,432923,6542,6542,0,,,19/1/2022 7:23
6/8/2021,Surat Thani,94,3766,1071496,527024,544472,4790,4115,675,60,24,19/1/2022 7:23
6/8/2021,Surin,248,5561,1376723,684837,691886,8153,8131,22,,,19/1/2022 7:23
6/8/2021,Sukhothai,166,2641,585851,283686,302165,4868,4868,0,,,19/1/2022 7:23
6/8/2021,Nong Khai,96,1216,516896,256327,260569,6520,6513,7,36,15,19/1/2022 7:23
6/8/2021,Nong Bua Lam Phu,59,1467,508942,253805,255137,1487,1487,0,,,19/1/2022 7:23
6/8/2021,Amnat Charoen,41,1309,376228,187133,189095,1440,1440,0,,,19/1/2022 7:23
6/8/2021,Udon Thani,187,5330,1566940,776022,790918,9291,9282,9,,,19/1/2022 7:23
6/8/2021,Uttaradit,94,1935,447089,217944,229145,6329,6329,0,,,19/1/2022 7:23
6/8/2021,Uthai Thani,79,1337,325254,158926,166328,2279,2279,0,,,19/1/2022 7:23
6/8/2021,Ubon Ratchathani,358,7152,1867365,932174,935191,7252,7252,0,60,29,19/1/2022 7:23
6/8/2021,Ang Thong,256,4175,275476,131801,143675,962,962,0,,,19/1/2022 7:23
6/8/2021,Chiang Rai,48,2053,1297168,630483,666685,28142,27897,245,37,11,19/1/2022 7:23
6/8/2021,Chiang Mai,47,10118,1787281,863640,923641,68614,67650,964,55,30,19/1/2022 7:23
6/8/2021,Phetchaburi,140,12652,482600,232958,249642,12139,12096,43,,,19/1/2022 7:23
6/8/2021,Phetchabun,136,2695,979033,482878,496155,20292,20262,30,,,19/1/2022 7:23
6/8/2021,Loei,54,1447,638862,320119,318743,5789,5778,11,48,16,19/1/2022 7:23
6/8/2021,Phrae,20,745,435481,209872,225609,5872,5872,0,50,21,19/1/2022 7:23
6/8/2021,Mae Hong Son,11,198,285778,144757,141021,8861,8659,202,38,11,19/1/2022 7:23
6/8/2021,,0,153,,,,,,,,,19/1/2022 7:23
7/8/2021,Krabi,19,1199,478664,237717,240947,2096,1981,115,,,19/1/2022 7:23
7/8/2021,Bangkok,4234,206469,5544789,2601856,2942933,202959,181431,21528,54,28,19/1/2022 7:23
7/8/2021,Kanchanaburi,205,5659,893129,447919,445210,20185,20157,28,29,19,19/1/2022 7:23
7/8/2021,Kalasin,283,4286,976083,482351,493732,2306,2306,0,,,19/1/2022 7:23
7/8/2021,Kamphaeng Phet,114,3293,712600,351801,360799,6769,6769,0,,,19/1/2022 7:23
7/8/2021,Khon Kaen,315,5733,1791967,880624,911343,21098,21098,0,64,36,19/1/2022 7:23
7/8/2021,Chanthaburi,81,3124,536132,262097,274035,17881,17815,66,,,19/1/2022 7:23
7/8/2021,Chachoengsao,448,16080,722615,354177,368438,1995,1995,0,42,32,19/1/2022 7:23
7/8/2021,Chon Buri,1462,36767,1580389,771364,809025,30270,29695,575,47,24,19/1/2022 7:23
7/8/2021,Chai Nat,46,1174,321015,154292,166723,4171,4171,0,,,19/1/2022 7:23
7/8/2021,Chaiyaphum,255,4532,1122780,554646,568134,13695,13682,13,,,19/1/2022 7:23
7/8/2021,Chumphon,107,1489,509292,251346,257946,1644,1644,0,,,19/1/2022 7:23
7/8/2021,Trang,61,2841,639931,312837,327094,2469,2469,0,,,19/1/2022 7:23
7/8/2021,Trat,23,1255,228459,112922,115537,22368,22277,91,,,19/1/2022 7:23
7/8/2021,Tak,140,6216,674616,341111,333505,12606,12606,0,,,19/1/2022 7:23
7/8/2021,Nakhon Nayok,162,3821,259735,128303,131432,2679,2679,0,,,19/1/2022 7:23
7/8/2021,Nakhon Pathom,781,16595,921500,442584,478916,2714,2714,0,48,21,19/1/2022 7:23
7/8/2021,Nakhon Phanom,80,2827,717048,357194,359854,3548,3548,0,,,19/1/2022 7:23
7/8/2021,Nakhon Ratchasima,220,7762,2633733,1293977,1339756,88532,87939,593,55,33,19/1/2022 7:23
7/8/2021,Nakhon Si Thammarat,79,4603,1549496,764523,784973,7996,7996,0,,,19/1/2022 7:23
7/8/2021,Nakhon Sawan,204,4766,1036534,505545,530989,15946,15946,0,52,32,19/1/2022 7:23
7/8/2021,Nonthaburi,699,37539,1285013,597870,687143,2822,2815,7,35,16,19/1/2022 7:23
7/8/2021,Narathiwat,185,7848,808758,400002,408756,421,421,0,59,21,19/1/2022 7:23
7/8/2021,Nan,92,1382,475941,238073,237868,9832,9798,34,,,19/1/2022 7:23
7/8/2021,Bueng Kan,64,938,421931,211488,210443,2114,2114,0,,,19/1/2022 7:23
7/8/2021,Buri Ram,246,5540,1579709,783665,796044,12087,12044,43,,,19/1/2022 7:23
7/8/2021,Pathum Thani,514,24435,1185082,561507,623575,1319,1306,13,53,27,19/1/2022 7:23
7/8/2021,Prachuap Khiri Khan,112,5536,552888,274321,278567,13974,13921,53,,,19/1/2022 7:23
7/8/2021,Prachin Buri,142,4168,494505,244150,250355,3143,3143,0,56,36,19/1/2022 7:23
7/8/2021,Pattani,309,10479,728801,359974,368827,517,517,0,,,19/1/2022 7:23
7/8/2021,Phra Nakhon Si Ayutthaya,586,10944,819892,393788,426104,17000,16958,42,54,45,19/1/2022 7:23
7/8/2021,Phayao,27,1062,465390,226498,238892,9277,9277,0,39,26,19/1/2022 7:23
7/8/2021,Phang-nga,18,742,268269,133881,134388,7037,5969,1068,,,19/1/2022 7:23
7/8/2021,Phatthalung,58,1815,522612,254531,268081,1598,1598,0,,,19/1/2022 7:23
7/8/2021,Phichit,125,1806,530258,258492,271766,6914,6914,0,,,19/1/2022 7:23
7/8/2021,Phitsanulok,87,2254,847684,414983,432701,25715,25564,151,,,19/1/2022 7:23
7/8/2021,Phuket,43,1659,418055,197662,220393,33530,18204,15326,52,24,19/1/2022 7:23
7/8/2021,Maha Sarakham,271,5383,949783,465624,484159,2772,2772,0,,,19/1/2022 7:23
7/8/2021,Mukdahan,60,1076,351259,175474,175785,5322,5322,0,,,19/1/2022 7:23
7/8/2021,Yala,80,8433,541494,269636,271858,438,438,0,64,24,19/1/2022 7:23
7/8/2021,Yasothon,139,2546,533506,266189,267317,1561,1561,0,,,19/1/2022 7:23
7/8/2021,Ranong,51,2816,194677,98263,96414,1369,1369,0,,,19/1/2022 7:23
7/8/2021,Rayong,251,10198,748943,367783,381160,18635,18409,226,36,28,19/1/2022 7:23
7/8/2021,Ratchaburi,262,6994,869099,422558,446541,7187,7187,0,,,19/1/2022 7:23
7/8/2021,Roi Et,385,5522,1296428,642234,654194,2700,2700,0,,,19/1/2022 7:23
7/8/2021,Lop Buri,199,5666,740487,369278,371209,7057,7028,29,,,19/1/2022 7:23
7/8/2021,Lampang,23,1522,726261,353817,372444,6862,6727,135,52,20,19/1/2022 7:23
7/8/2021,Lamphun,29,752,401525,192998,208527,7455,7381,74,,,19/1/2022 7:23
7/8/2021,Si Sa Ket,335,6008,1456985,725190,731795,3838,3838,0,,,19/1/2022 7:23
7/8/2021,Sakon Nakhon,207,3499,1146507,569654,576853,4675,4675,0,,,19/1/2022 7:23
7/8/2021,Songkhla,252,14372,1430543,696923,733620,1132,1132,0,64,27,19/1/2022 7:23
7/8/2021,Satun,25,852,324496,161423,163073,1183,1170,13,54,35,19/1/2022 7:23
7/8/2021,Samut Prakarn,1479,49645,1355823,645868,709955,1887,1860,27,,,19/1/2022 7:23
7/8/2021,Samut Songkhram,368,3584,191276,91338,99938,4546,4546,0,29,16,19/1/2022 7:23
7/8/2021,Samut Sakhon,1373,57359,585685,282240,303445,1338,1338,0,52,37,19/1/2022 7:23
7/8/2021,Saraburi,691,10484,643873,316304,327569,9794,9776,18,62,51,19/1/2022 7:23
7/8/2021,Sa kaeo,208,5087,561509,280362,281147,2377,2377,0,38,24,19/1/2022 7:23
7/8/2021,Sing Buri,61,1101,205088,97428,107660,3064,3064,0,,,19/1/2022 7:23
7/8/2021,Suphan Buri,234,6806,836435,403512,432923,6542,6542,0,,,19/1/2022 7:23
7/8/2021,Surat Thani,161,3927,1071496,527024,544472,4790,4115,675,57,24,19/1/2022 7:23
7/8/2021,Surin,311,5872,1376723,684837,691886,8153,8131,22,,,19/1/2022 7:23
7/8/2021,Sukhothai,131,2772,585851,283686,302165,4868,4868,0,,,19/1/2022 7:23
7/8/2021,Nong Khai,59,1275,516896,256327,260569,6520,6513,7,36,15,19/1/2022 7:23
7/8/2021,Nong Bua Lam Phu,92,1559,508942,253805,255137,1487,1487,0,,,19/1/2022 7:23
7/8/2021,Amnat Charoen,39,1348,376228,187133,189095,1440,1440,0,,,19/1/2022 7:23
7/8/2021,Udon Thani,287,5617,1566940,776022,790918,9291,9282,9,,,19/1/2022 7:23
7/8/2021,Uttaradit,76,2011,447089,217944,229145,6329,6329,0,,,19/1/2022 7:23
7/8/2021,Uthai Thani,85,1422,325254,158926,166328,2279,2279,0,,,19/1/2022 7:23
7/8/2021,Ubon Ratchathani,396,7548,1867365,932174,935191,7252,7252,0,64,30,19/1/2022 7:23
7/8/2021,Ang Thong,235,4410,275476,131801,143675,962,962,0,,,19/1/2022 7:23
7/8/2021,Chiang Rai,30,2083,1297168,630483,666685,28142,27897,245,40,12,19/1/2022 7:23
7/8/2021,Chiang Mai,60,10178,1787281,863640,923641,68614,67650,964,61,33,19/1/2022 7:23
7/8/2021,Phetchaburi,143,12795,482600,232958,249642,12139,12096,43,,,19/1/2022 7:23
7/8/2021,Phetchabun,40,2735,979033,482878,496155,20292,20262,30,,,19/1/2022 7:23
7/8/2021,Loei,32,1479,638862,320119,318743,5789,5778,11,32,21,19/1/2022 7:23
7/8/2021,Phrae,52,797,435481,209872,225609,5872,5872,0,48,24,19/1/2022 7:23
7/8/2021,Mae Hong Son,0,198,285778,144757,141021,8861,8659,202,44,9,19/1/2022 7:23
7/8/2021,,0,153,,,,,,,,,19/1/2022 7:23
8/8/2021,Krabi,21,1220,478664,237717,240947,2096,1981,115,,,19/1/2022 7:23
8/8/2021,Bangkok,3098,209567,5544789,2601856,2942933,202959,181431,21528,57,29,19/1/2022 7:23
8/8/2021,Kanchanaburi,212,5871,893129,447919,445210,20185,20157,28,32,14,19/1/2022 7:23
8/8/2021,Kalasin,223,4509,976083,482351,493732,2306,2306,0,,,19/1/2022 7:23
8/8/2021,Kamphaeng Phet,179,3472,712600,351801,360799,6769,6769,0,,,19/1/2022 7:23
8/8/2021,Khon Kaen,136,5869,1791967,880624,911343,21098,21098,0,65,42,19/1/2022 7:23
8/8/2021,Chanthaburi,110,3234,536132,262097,274035,17881,17815,66,,,19/1/2022 7:23
8/8/2021,Chachoengsao,449,16529,722615,354177,368438,1995,1995,0,47,34,19/1/2022 7:23
8/8/2021,Chon Buri,1539,38306,1580389,771364,809025,30270,29695,575,44,35,19/1/2022 7:23
8/8/2021,Chai Nat,45,1219,321015,154292,166723,4171,4171,0,,,19/1/2022 7:23
8/8/2021,Chaiyaphum,168,4700,1122780,554646,568134,13695,13682,13,,,19/1/2022 7:23
8/8/2021,Chumphon,45,1534,509292,251346,257946,1644,1644,0,,,19/1/2022 7:23
8/8/2021,Trang,47,2888,639931,312837,327094,2469,2469,0,,,19/1/2022 7:23
8/8/2021,Trat,22,1277,228459,112922,115537,22368,22277,91,,,19/1/2022 7:23
8/8/2021,Tak,183,6399,674616,341111,333505,12606,12606,0,,,19/1/2022 7:23
8/8/2021,Nakhon Nayok,168,3989,259735,128303,131432,2679,2679,0,,,19/1/2022 7:23
8/8/2021,Nakhon Pathom,587,17182,921500,442584,478916,2714,2714,0,45,20,19/1/2022 7:23
8/8/2021,Nakhon Phanom,140,2967,717048,357194,359854,3548,3548,0,,,19/1/2022 7:23
8/8/2021,Nakhon Ratchasima,385,8147,2633733,1293977,1339756,88532,87939,593,63,34,19/1/2022 7:23
8/8/2021,Nakhon Si Thammarat,105,4708,1549496,764523,784973,7996,7996,0,,,19/1/2022 7:23
8/8/2021,Nakhon Sawan,242,5008,1036534,505545,530989,15946,15946,0,62,37,19/1/2022 7:23
8/8/2021,Nonthaburi,757,38296,1285013,597870,687143,2822,2815,7,39,15,19/1/2022 7:23
8/8/2021,Narathiwat,187,8035,808758,400002,408756,421,421,0,50,17,19/1/2022 7:23
8/8/2021,Nan,44,1426,475941,238073,237868,9832,9798,34,,,19/1/2022 7:23
8/8/2021,Bueng Kan,69,1007,421931,211488,210443,2114,2114,0,,,19/1/2022 7:23
8/8/2021,Buri Ram,123,5663,1579709,783665,796044,12087,12044,43,,,19/1/2022 7:23
8/8/2021,Pathum Thani,668,25103,1185082,561507,623575,1319,1306,13,49,26,19/1/2022 7:23
8/8/2021,Prachuap Khiri Khan,151,5687,552888,274321,278567,13974,13921,53,,,19/1/2022 7:23
8/8/2021,Prachin Buri,110,4278,494505,244150,250355,3143,3143,0,65,37,19/1/2022 7:23
8/8/2021,Pattani,356,10835,728801,359974,368827,517,517,0,,,19/1/2022 7:23
8/8/2021,Phra Nakhon Si Ayutthaya,396,11340,819892,393788,426104,17000,16958,42,46,49,19/1/2022 7:23
8/8/2021,Phayao,37,1099,465390,226498,238892,9277,9277,0,45,25,19/1/2022 7:23
8/8/2021,Phang-nga,17,759,268269,133881,134388,7037,5969,1068,,,19/1/2022 7:23
8/8/2021,Phatthalung,39,1854,522612,254531,268081,1598,1598,0,,,19/1/2022 7:23
8/8/2021,Phichit,92,1898,530258,258492,271766,6914,6914,0,,,19/1/2022 7:23
8/8/2021,Phitsanulok,71,2325,847684,414983,432701,25715,25564,151,,,19/1/2022 7:23
8/8/2021,Phuket,42,1701,418055,197662,220393,33530,18204,15326,49,23,19/1/2022 7:23
8/8/2021,Maha Sarakham,283,5666,949783,465624,484159,2772,2772,0,,,19/1/2022 7:23
8/8/2021,Mukdahan,81,1157,351259,175474,175785,5322,5322,0,,,19/1/2022 7:23
8/8/2021,Yala,143,8576,541494,269636,271858,438,438,0,51,21,19/1/2022 7:23
8/8/2021,Yasothon,139,2685,533506,266189,267317,1561,1561,0,,,19/1/2022 7:23
8/8/2021,Ranong,72,2888,194677,98263,96414,1369,1369,0,,,19/1/2022 7:23
8/8/2021,Rayong,219,10417,748943,367783,381160,18635,18409,226,39,31,19/1/2022 7:23
8/8/2021,Ratchaburi,274,7268,869099,422558,446541,7187,7187,0,,,19/1/2022 7:23
8/8/2021,Roi Et,482,6004,1296428,642234,654194,2700,2700,0,,,19/1/2022 7:23
8/8/2021,Lop Buri,287,5953,740487,369278,371209,7057,7028,29,,,19/1/2022 7:23
8/8/2021,Lampang,28,1550,726261,353817,372444,6862,6727,135,60,18,19/1/2022 7:23
8/8/2021,Lamphun,25,777,401525,192998,208527,7455,7381,74,,,19/1/2022 7:23
8/8/2021,Si Sa Ket,221,6229,1456985,725190,731795,3838,3838,0,,,19/1/2022 7:23
8/8/2021,Sakon Nakhon,247,3746,1146507,569654,576853,4675,4675,0,,,19/1/2022 7:23
8/8/2021,Songkhla,365,14737,1430543,696923,733620,1132,1132,0,49,31,19/1/2022 7:23
8/8/2021,Satun,27,879,324496,161423,163073,1183,1170,13,49,32,19/1/2022 7:23
8/8/2021,Samut Prakarn,1137,50782,1355823,645868,709955,1887,1860,27,,,19/1/2022 7:23
8/8/2021,Samut Songkhram,177,3761,191276,91338,99938,4546,4546,0,35,18,19/1/2022 7:23
8/8/2021,Samut Sakhon,1391,58750,585685,282240,303445,1338,1338,0,64,34,19/1/2022 7:23
8/8/2021,Saraburi,396,10880,643873,316304,327569,9794,9776,18,63,45,19/1/2022 7:23
8/8/2021,Sa kaeo,265,5352,561509,280362,281147,2377,2377,0,47,26,19/1/2022 7:23
8/8/2021,Sing Buri,53,1154,205088,97428,107660,3064,3064,0,,,19/1/2022 7:23
8/8/2021,Suphan Buri,210,7016,836435,403512,432923,6542,6542,0,,,19/1/2022 7:23
8/8/2021,Surat Thani,104,4031,1071496,527024,544472,4790,4115,675,64,25,19/1/2022 7:23
8/8/2021,Surin,301,6173,1376723,684837,691886,8153,8131,22,,,19/1/2022 7:23
8/8/2021,Sukhothai,160,2932,585851,283686,302165,4868,4868,0,,,19/1/2022 7:23
8/8/2021,Nong Khai,66,1341,516896,256327,260569,6520,6513,7,37,14,19/1/2022 7:23
8/8/2021,Nong Bua Lam Phu,139,1698,508942,253805,255137,1487,1487,0,,,19/1/2022 7:23
8/8/2021,Amnat Charoen,81,1429,376228,187133,189095,1440,1440,0,,,19/1/2022 7:23
8/8/2021,Udon Thani,165,5782,1566940,776022,790918,9291,9282,9,,,19/1/2022 7:23
8/8/2021,Uttaradit,44,2055,447089,217944,229145,6329,6329,0,,,19/1/2022 7:23
8/8/2021,Uthai Thani,63,1485,325254,158926,166328,2279,2279,0,,,19/1/2022 7:23
8/8/2021,Ubon Ratchathani,282,7830,1867365,932174,935191,7252,7252,0,62,38,19/1/2022 7:23
8/8/2021,Ang Thong,275,4685,275476,131801,143675,962,962,0,,,19/1/2022 7:23
8/8/2021,Chiang Rai,67,2150,1297168,630483,666685,28142,27897,245,42,13,19/1/2022 7:23
8/8/2021,Chiang Mai,72,10250,1787281,863640,923641,68614,67650,964,61,33,19/1/2022 7:23
8/8/2021,Phetchaburi,108,12903,482600,232958,249642,12139,12096,43,,,19/1/2022 7:23
8/8/2021,Phetchabun,158,2893,979033,482878,496155,20292,20262,30,,,19/1/2022 7:23
8/8/2021,Loei,72,1551,638862,320119,318743,5789,5778,11,41,24,19/1/2022 7:23
8/8/2021,Phrae,38,835,435481,209872,225609,5872,5872,0,53,25,19/1/2022 7:23
8/8/2021,Mae Hong Son,3,201,285778,144757,141021,8861,8659,202,37,10,19/1/2022 7:23
8/8/2021,,0,153,,,,,,,,,19/1/2022 7:23
9/8/2021,Krabi,10,1230,478664,237717,240947,2096,1981,115,,,19/1/2022 7:23
9/8/2021,Bangkok,3114,212681,5544789,2601856,2942933,202959,181431,21528,56,29,19/1/2022 7:23
9/8/2021,Kanchanaburi,159,6030,893129,447919,445210,20185,20157,28,22,18,19/1/2022 7:23
9/8/2021,Kalasin,92,4601,976083,482351,493732,2306,2306,0,,,19/1/2022 7:23
9/8/2021,Kamphaeng Phet,142,3614,712600,351801,360799,6769,6769,0,,,19/1/2022 7:23
9/8/2021,Khon Kaen,312,6181,1791967,880624,911343,21098,21098,0,70,48,19/1/2022 7:23
9/8/2021,Chanthaburi,118,3352,536132,262097,274035,17881,17815,66,,,19/1/2022 7:23
9/8/2021,Chachoengsao,298,16827,722615,354177,368438,1995,1995,0,53,35,19/1/2022 7:23
9/8/2021,Chon Buri,1334,39640,1580389,771364,809025,30270,29695,575,47,27,19/1/2022 7:23
9/8/2021,Chai Nat,59,1278,321015,154292,166723,4171,4171,0,,,19/1/2022 7:23
9/8/2021,Chaiyaphum,281,4981,1122780,554646,568134,13695,13682,13,,,19/1/2022 7:23
9/8/2021,Chumphon,82,1616,509292,251346,257946,1644,1644,0,,,19/1/2022 7:23
9/8/2021,Trang,41,2929,639931,312837,327094,2469,2469,0,,,19/1/2022 7:23
9/8/2021,Trat,12,1289,228459,112922,115537,22368,22277,91,,,19/1/2022 7:23
9/8/2021,Tak,172,6571,674616,341111,333505,12606,12606,0,,,19/1/2022 7:23
9/8/2021,Nakhon Nayok,176,4165,259735,128303,131432,2679,2679,0,,,19/1/2022 7:23
9/8/2021,Nakhon Pathom,557,17739,921500,442584,478916,2714,2714,0,33,19,19/1/2022 7:23
9/8/2021,Nakhon Phanom,95,3062,717048,357194,359854,3548,3548,0,,,19/1/2022 7:23
9/8/2021,Nakhon Ratchasima,440,8587,2633733,1293977,1339756,88532,87939,593,66,33,19/1/2022 7:23
9/8/2021,Nakhon Si Thammarat,140,4848,1549496,764523,784973,7996,7996,0,,,19/1/2022 7:23
9/8/2021,Nakhon Sawan,157,5165,1036534,505545,530989,15946,15946,0,74,43,19/1/2022 7:23
9/8/2021,Nonthaburi,803,39099,1285013,597870,687143,2822,2815,7,33,15,19/1/2022 7:23
9/8/2021,Narathiwat,181,8216,808758,400002,408756,421,421,0,33,15,19/1/2022 7:23
9/8/2021,Nan,52,1478,475941,238073,237868,9832,9798,34,,,19/1/2022 7:23
9/8/2021,Bueng Kan,30,1037,421931,211488,210443,2114,2114,0,,,19/1/2022 7:23
9/8/2021,Buri Ram,139,5802,1579709,783665,796044,12087,12044,43,,,19/1/2022 7:23
9/8/2021,Pathum Thani,715,25818,1185082,561507,623575,1319,1306,13,47,26,19/1/2022 7:23
9/8/2021,Prachuap Khiri Khan,132,5819,552888,274321,278567,13974,13921,53,,,19/1/2022 7:23
9/8/2021,Prachin Buri,84,4362,494505,244150,250355,3143,3143,0,66,33,19/1/2022 7:23
9/8/2021,Pattani,349,11184,728801,359974,368827,517,517,0,,,19/1/2022 7:23
9/8/2021,Phra Nakhon Si Ayutthaya,344,11684,819892,393788,426104,17000,16958,42,58,46,19/1/2022 7:23
9/8/2021,Phayao,43,1142,465390,226498,238892,9277,9277,0,51,22,19/1/2022 7:23
9/8/2021,Phang-nga,26,785,268269,133881,134388,7037,5969,1068,,,19/1/2022 7:23
9/8/2021,Phatthalung,42,1896,522612,254531,268081,1598,1598,0,,,19/1/2022 7:23
9/8/2021,Phichit,70,1968,530258,258492,271766,6914,6914,0,,,19/1/2022 7:23
9/8/2021,Phitsanulok,28,2353,847684,414983,432701,25715,25564,151,,,19/1/2022 7:23
9/8/2021,Phuket,86,1787,418055,197662,220393,33530,18204,15326,48,19,19/1/2022 7:23
9/8/2021,Maha Sarakham,153,5819,949783,465624,484159,2772,2772,0,,,19/1/2022 7:23
9/8/2021,Mukdahan,59,1216,351259,175474,175785,5322,5322,0,,,19/1/2022 7:23
9/8/2021,Yala,227,8803,541494,269636,271858,438,438,0,50,15,19/1/2022 7:23
9/8/2021,Yasothon,112,2797,533506,266189,267317,1561,1561,0,,,19/1/2022 7:23
9/8/2021,Ranong,56,2944,194677,98263,96414,1369,1369,0,,,19/1/2022 7:23
9/8/2021,Rayong,408,10825,748943,367783,381160,18635,18409,226,43,26,19/1/2022 7:23
9/8/2021,Ratchaburi,273,7541,869099,422558,446541,7187,7187,0,,,19/1/2022 7:23
9/8/2021,Roi Et,357,6361,1296428,642234,654194,2700,2700,0,,,19/1/2022 7:23
9/8/2021,Lop Buri,254,6207,740487,369278,371209,7057,7028,29,,,19/1/2022 7:23
9/8/2021,Lampang,70,1620,726261,353817,372444,6862,6727,135,53,21,19/1/2022 7:23
9/8/2021,Lamphun,20,797,401525,192998,208527,7455,7381,74,,,19/1/2022 7:23
9/8/2021,Si Sa Ket,296,6525,1456985,725190,731795,3838,3838,0,,,19/1/2022 7:23
9/8/2021,Sakon Nakhon,186,3932,1146507,569654,576853,4675,4675,0,,,19/1/2022 7:23
9/8/2021,Songkhla,160,14897,1430543,696923,733620,1132,1132,0,56,21,19/1/2022 7:23
9/8/2021,Satun,25,904,324496,161423,163073,1183,1170,13,46,30,19/1/2022 7:23
9/8/2021,Samut Prakarn,1395,52177,1355823,645868,709955,1887,1860,27,,,19/1/2022 7:23
9/8/2021,Samut Songkhram,172,3933,191276,91338,99938,4546,4546,0,36,19,19/1/2022 7:23
9/8/2021,Samut Sakhon,1378,60128,585685,282240,303445,1338,1338,0,48,36,19/1/2022 7:23
9/8/2021,Saraburi,504,11384,643873,316304,327569,9794,9776,18,62,52,19/1/2022 7:23
9/8/2021,Sa kaeo,100,5452,561509,280362,281147,2377,2377,0,47,22,19/1/2022 7:23
9/8/2021,Sing Buri,83,1237,205088,97428,107660,3064,3064,0,,,19/1/2022 7:23
9/8/2021,Suphan Buri,153,7169,836435,403512,432923,6542,6542,0,,,19/1/2022 7:23
9/8/2021,Surat Thani,58,4089,1071496,527024,544472,4790,4115,675,67,24,19/1/2022 7:23
9/8/2021,Surin,338,6511,1376723,684837,691886,8153,8131,22,,,19/1/2022 7:23
9/8/2021,Sukhothai,105,3037,585851,283686,302165,4868,4868,0,,,19/1/2022 7:23
9/8/2021,Nong Khai,55,1396,516896,256327,260569,6520,6513,7,35,12,19/1/2022 7:23
9/8/2021,Nong Bua Lam Phu,93,1791,508942,253805,255137,1487,1487,0,,,19/1/2022 7:23
9/8/2021,Amnat Charoen,46,1475,376228,187133,189095,1440,1440,0,,,19/1/2022 7:23
9/8/2021,Udon Thani,174,5956,1566940,776022,790918,9291,9282,9,,,19/1/2022 7:23
9/8/2021,Uttaradit,40,2095,447089,217944,229145,6329,6329,0,,,19/1/2022 7:23
9/8/2021,Uthai Thani,52,1537,325254,158926,166328,2279,2279,0,,,19/1/2022 7:23
9/8/2021,Ubon Ratchathani,615,8445,1867365,932174,935191,7252,7252,0,74,36,19/1/2022 7:23
9/8/2021,Ang Thong,232,4917,275476,131801,143675,962,962,0,,,19/1/2022 7:23
9/8/2021,Chiang Rai,38,2188,1297168,630483,666685,28142,27897,245,41,11,19/1/2022 7:23
9/8/2021,Chiang Mai,36,10286,1787281,863640,923641,68614,67650,964,64,40,19/1/2022 7:23
9/8/2021,Phetchaburi,126,13029,482600,232958,249642,12139,12096,43,,,19/1/2022 7:23
9/8/2021,Phetchabun,130,3023,979033,482878,496155,20292,20262,30,,,19/1/2022 7:23
9/8/2021,Loei,57,1608,638862,320119,318743,5789,5778,11,46,24,19/1/2022 7:23
9/8/2021,Phrae,48,883,435481,209872,225609,5872,5872,0,55,25,19/1/2022 7:23
9/8/2021,Mae Hong Son,4,205,285778,144757,141021,8861,8659,202,41,12,19/1/2022 7:23
9/8/2021,,0,153,,,,,,,,,19/1/2022 7:23
10/8/2021,Krabi,14,1244,478664,237717,240947,2096,1981,115,,,19/1/2022 7:23
10/8/2021,Bangkok,4229,216910,5544789,2601856,2942933,202959,181431,21528,56,21,19/1/2022 7:23
10/8/2021,Kanchanaburi,323,6353,893129,447919,445210,20185,20157,28,36,15,19/1/2022 7:23
10/8/2021,Kalasin,126,4727,976083,482351,493732,2306,2306,0,,,19/1/2022 7:23
10/8/2021,Kamphaeng Phet,162,3776,712600,351801,360799,6769,6769,0,,,19/1/2022 7:23
10/8/2021,Khon Kaen,228,6409,1791967,880624,911343,21098,21098,0,80,42,19/1/2022 7:23
10/8/2021,Chanthaburi,55,3407,536132,262097,274035,17881,17815,66,,,19/1/2022 7:23
10/8/2021,Chachoengsao,342,17169,722615,354177,368438,1995,1995,0,59,31,19/1/2022 7:23
10/8/2021,Chon Buri,1070,40710,1580389,771364,809025,30270,29695,575,45,32,19/1/2022 7:23
10/8/2021,Chai Nat,35,1313,321015,154292,166723,4171,4171,0,,,19/1/2022 7:23
10/8/2021,Chaiyaphum,167,5148,1122780,554646,568134,13695,13682,13,,,19/1/2022 7:23
10/8/2021,Chumphon,98,1714,509292,251346,257946,1644,1644,0,,,19/1/2022 7:23
10/8/2021,Trang,64,2993,639931,312837,327094,2469,2469,0,,,19/1/2022 7:23
10/8/2021,Trat,13,1302,228459,112922,115537,22368,22277,91,,,19/1/2022 7:23
10/8/2021,Tak,111,6682,674616,341111,333505,12606,12606,0,,,19/1/2022 7:23
10/8/2021,Nakhon Nayok,252,4417,259735,128303,131432,2679,2679,0,,,19/1/2022 7:23
10/8/2021,Nakhon Pathom,509,18248,921500,442584,478916,2714,2714,0,43,17,19/1/2022 7:23
10/8/2021,Nakhon Phanom,124,3186,717048,357194,359854,3548,3548,0,,,19/1/2022 7:23
10/8/2021,Nakhon Ratchasima,191,8778,2633733,1293977,1339756,88532,87939,593,64,22,19/1/2022 7:23
10/8/2021,Nakhon Si Thammarat,100,4948,1549496,764523,784973,7996,7996,0,,,19/1/2022 7:23
10/8/2021,Nakhon Sawan,171,5336,1036534,505545,530989,15946,15946,0,87,45,19/1/2022 7:23
10/8/2021,Nonthaburi,959,40058,1285013,597870,687143,2822,2815,7,29,14,19/1/2022 7:23
10/8/2021,Narathiwat,178,8394,808758,400002,408756,421,421,0,30,15,19/1/2022 7:23
10/8/2021,Nan,70,1548,475941,238073,237868,9832,9798,34,,,19/1/2022 7:23
10/8/2021,Bueng Kan,64,1101,421931,211488,210443,2114,2114,0,,,19/1/2022 7:23
10/8/2021,Buri Ram,329,6131,1579709,783665,796044,12087,12044,43,,,19/1/2022 7:23
10/8/2021,Pathum Thani,528,26346,1185082,561507,623575,1319,1306,13,42,31,19/1/2022 7:23
10/8/2021,Prachuap Khiri Khan,80,5899,552888,274321,278567,13974,13921,53,,,19/1/2022 7:23
10/8/2021,Prachin Buri,100,4462,494505,244150,250355,3143,3143,0,61,23,19/1/2022 7:23
10/8/2021,Pattani,305,11489,728801,359974,368827,517,517,0,,,19/1/2022 7:23
10/8/2021,Phra Nakhon Si Ayutthaya,396,12080,819892,393788,426104,17000,16958,42,56,36,19/1/2022 7:23
10/8/2021,Phayao,35,1177,465390,226498,238892,9277,9277,0,43,19,19/1/2022 7:23
10/8/2021,Phang-nga,18,803,268269,133881,134388,7037,5969,1068,,,19/1/2022 7:23
10/8/2021,Phatthalung,30,1926,522612,254531,268081,1598,1598,0,,,19/1/2022 7:23
10/8/2021,Phichit,218,2186,530258,258492,271766,6914,6914,0,,,19/1/2022 7:23
10/8/2021,Phitsanulok,35,2388,847684,414983,432701,25715,25564,151,,,19/1/2022 7:23
10/8/2021,Phuket,64,1851,418055,197662,220393,33530,18204,15326,45,28,19/1/2022 7:23
10/8/2021,Maha Sarakham,155,5974,949783,465624,484159,2772,2772,0,,,19/1/2022 7:23
10/8/2021,Mukdahan,95,1311,351259,175474,175785,5322,5322,0,,,19/1/2022 7:23
10/8/2021,Yala,65,8868,541494,269636,271858,438,438,0,34,18,19/1/2022 7:23
10/8/2021,Yasothon,128,2925,533506,266189,267317,1561,1561,0,,,19/1/2022 7:23
10/8/2021,Ranong,83,3027,194677,98263,96414,1369,1369,0,,,19/1/2022 7:23
10/8/2021,Rayong,252,11077,748943,367783,381160,18635,18409,226,37,26,19/1/2022 7:23
10/8/2021,Ratchaburi,267,7808,869099,422558,446541,7187,7187,0,,,19/1/2022 7:23
10/8/2021,Roi Et,241,6602,1296428,642234,654194,2700,2700,0,,,19/1/2022 7:23
10/8/2021,Lop Buri,287,6494,740487,369278,371209,7057,7028,29,,,19/1/2022 7:23
10/8/2021,Lampang,38,1658,726261,353817,372444,6862,6727,135,62,18,19/1/2022 7:23
10/8/2021,Lamphun,19,816,401525,192998,208527,7455,7381,74,,,19/1/2022 7:23
10/8/2021,Si Sa Ket,290,6815,1456985,725190,731795,3838,3838,0,,,19/1/2022 7:23
10/8/2021,Sakon Nakhon,62,3994,1146507,569654,576853,4675,4675,0,,,19/1/2022 7:23
10/8/2021,Songkhla,174,15071,1430543,696923,733620,1132,1132,0,43,25,19/1/2022 7:23
10/8/2021,Satun,31,935,324496,161423,163073,1183,1170,13,46,22,19/1/2022 7:23
10/8/2021,Samut Prakarn,1012,53189,1355823,645868,709955,1887,1860,27,,,19/1/2022 7:23
10/8/2021,Samut Songkhram,360,4293,191276,91338,99938,4546,4546,0,35,15,19/1/2022 7:23
10/8/2021,Samut Sakhon,1639,61767,585685,282240,303445,1338,1338,0,61,36,19/1/2022 7:23
10/8/2021,Saraburi,374,11758,643873,316304,327569,9794,9776,18,80,49,19/1/2022 7:23
10/8/2021,Sa kaeo,122,5574,561509,280362,281147,2377,2377,0,42,14,19/1/2022 7:23
10/8/2021,Sing Buri,18,1255,205088,97428,107660,3064,3064,0,,,19/1/2022 7:23
10/8/2021,Suphan Buri,248,7417,836435,403512,432923,6542,6542,0,,,19/1/2022 7:23
10/8/2021,Surat Thani,101,4190,1071496,527024,544472,4790,4115,675,57,23,19/1/2022 7:23
10/8/2021,Surin,323,6834,1376723,684837,691886,8153,8131,22,,,19/1/2022 7:23
10/8/2021,Sukhothai,90,3127,585851,283686,302165,4868,4868,0,,,19/1/2022 7:23
10/8/2021,Nong Khai,39,1435,516896,256327,260569,6520,6513,7,31,13,19/1/2022 7:23
10/8/2021,Nong Bua Lam Phu,85,1876,508942,253805,255137,1487,1487,0,,,19/1/2022 7:23
10/8/2021,Amnat Charoen,95,1570,376228,187133,189095,1440,1440,0,,,19/1/2022 7:23
10/8/2021,Udon Thani,362,6318,1566940,776022,790918,9291,9282,9,,,19/1/2022 7:23
10/8/2021,Uttaradit,50,2145,447089,217944,229145,6329,6329,0,,,19/1/2022 7:23
10/8/2021,Uthai Thani,60,1597,325254,158926,166328,2279,2279,0,,,19/1/2022 7:23
10/8/2021,Ubon Ratchathani,387,8832,1867365,932174,935191,7252,7252,0,68,16,19/1/2022 7:23
10/8/2021,Ang Thong,157,5074,275476,131801,143675,962,962,0,,,19/1/2022 7:23
10/8/2021,Chiang Rai,44,2232,1297168,630483,666685,28142,27897,245,39,10,19/1/2022 7:23
10/8/2021,Chiang Mai,34,10320,1787281,863640,923641,68614,67650,964,74,30,19/1/2022 7:23
10/8/2021,Phetchaburi,78,13107,482600,232958,249642,12139,12096,43,,,19/1/2022 7:23
10/8/2021,Phetchabun,92,3115,979033,482878,496155,20292,20262,30,,,19/1/2022 7:23
10/8/2021,Loei,67,1675,638862,320119,318743,5789,5778,11,48,24,19/1/2022 7:23
10/8/2021,Phrae,16,899,435481,209872,225609,5872,5872,0,56,27,19/1/2022 7:23
10/8/2021,Mae Hong Son,10,215,285778,144757,141021,8861,8659,202,49,11,19/1/2022 7:23
10/8/2021,,0,153,,,,,,,,,19/1/2022 7:23
11/8/2021,Krabi,18,1262,478664,237717,240947,2096,1981,115,,,19/1/2022 7:23
11/8/2021,Bangkok,4552,221462,5544789,2601856,2942933,202959,181431,21528,42,18,19/1/2022 7:23
11/8/2021,Kanchanaburi,194,6547,893129,447919,445210,20185,20157,28,36,13,19/1/2022 7:23
11/8/2021,Kalasin,204,4931,976083,482351,493732,2306,2306,0,,,19/1/2022 7:23
11/8/2021,Kamphaeng Phet,68,3844,712600,351801,360799,6769,6769,0,,,19/1/2022 7:23
11/8/2021,Khon Kaen,119,6528,1791967,880624,911343,21098,21098,0,71,32,19/1/2022 7:23
11/8/2021,Chanthaburi,175,3582,536132,262097,274035,17881,17815,66,,,19/1/2022 7:23
11/8/2021,Chachoengsao,467,17636,722615,354177,368438,1995,1995,0,47,27,19/1/2022 7:23
11/8/2021,Chon Buri,1371,42081,1580389,771364,809025,30270,29695,575,38,21,19/1/2022 7:23
11/8/2021,Chai Nat,68,1381,321015,154292,166723,4171,4171,0,,,19/1/2022 7:23
11/8/2021,Chaiyaphum,90,5238,1122780,554646,568134,13695,13682,13,,,19/1/2022 7:23
11/8/2021,Chumphon,67,1781,509292,251346,257946,1644,1644,0,,,19/1/2022 7:23
11/8/2021,Trang,71,3064,639931,312837,327094,2469,2469,0,,,19/1/2022 7:23
11/8/2021,Trat,33,1335,228459,112922,115537,22368,22277,91,,,19/1/2022 7:23
11/8/2021,Tak,199,6881,674616,341111,333505,12606,12606,0,,,19/1/2022 7:23
11/8/2021,Nakhon Nayok,286,4703,259735,128303,131432,2679,2679,0,,,19/1/2022 7:23
11/8/2021,Nakhon Pathom,389,18637,921500,442584,478916,2714,2714,0,38,16,19/1/2022 7:23
11/8/2021,Nakhon Phanom,121,3307,717048,357194,359854,3548,3548,0,,,19/1/2022 7:23
11/8/2021,Nakhon Ratchasima,372,9150,2633733,1293977,1339756,88532,87939,593,56,16,19/1/2022 7:23
11/8/2021,Nakhon Si Thammarat,98,5046,1549496,764523,784973,7996,7996,0,,,19/1/2022 7:23
11/8/2021,Nakhon Sawan,163,5499,1036534,505545,530989,15946,15946,0,85,35,19/1/2022 7:23
11/8/2021,Nonthaburi,691,40749,1285013,597870,687143,2822,2815,7,34,9,19/1/2022 7:23
11/8/2021,Narathiwat,162,8556,808758,400002,408756,421,421,0,32,15,19/1/2022 7:23
11/8/2021,Nan,53,1601,475941,238073,237868,9832,9798,34,,,19/1/2022 7:23
11/8/2021,Bueng Kan,38,1139,421931,211488,210443,2114,2114,0,,,19/1/2022 7:23
11/8/2021,Buri Ram,267,6398,1579709,783665,796044,12087,12044,43,,,19/1/2022 7:23
11/8/2021,Pathum Thani,540,26886,1185082,561507,623575,1319,1306,13,47,23,19/1/2022 7:23
11/8/2021,Prachuap Khiri Khan,108,6007,552888,274321,278567,13974,13921,53,,,19/1/2022 7:23
11/8/2021,Prachin Buri,217,4679,494505,244150,250355,3143,3143,0,48,21,19/1/2022 7:23
11/8/2021,Pattani,334,11823,728801,359974,368827,517,517,0,,,19/1/2022 7:23
11/8/2021,Phra Nakhon Si Ayutthaya,580,12660,819892,393788,426104,17000,16958,42,37,31,19/1/2022 7:23
11/8/2021,Phayao,39,1216,465390,226498,238892,9277,9277,0,37,23,19/1/2022 7:23
11/8/2021,Phang-nga,5,808,268269,133881,134388,7037,5969,1068,,,19/1/2022 7:23
11/8/2021,Phatthalung,47,1973,522612,254531,268081,1598,1598,0,,,19/1/2022 7:23
11/8/2021,Phichit,39,2225,530258,258492,271766,6914,6914,0,,,19/1/2022 7:23
11/8/2021,Phitsanulok,105,2493,847684,414983,432701,25715,25564,151,,,19/1/2022 7:23
11/8/2021,Phuket,54,1905,418055,197662,220393,33530,18204,15326,53,25,19/1/2022 7:23
11/8/2021,Maha Sarakham,235,6209,949783,465624,484159,2772,2772,0,,,19/1/2022 7:23
11/8/2021,Mukdahan,36,1347,351259,175474,175785,5322,5322,0,,,19/1/2022 7:23
11/8/2021,Yala,79,8947,541494,269636,271858,438,438,0,42,23,19/1/2022 7:23
11/8/2021,Yasothon,112,3037,533506,266189,267317,1561,1561,0,,,19/1/2022 7:23
11/8/2021,Ranong,94,3121,194677,98263,96414,1369,1369,0,,,19/1/2022 7:23
11/8/2021,Rayong,310,11387,748943,367783,381160,18635,18409,226,36,23,19/1/2022 7:23
11/8/2021,Ratchaburi,399,8207,869099,422558,446541,7187,7187,0,,,19/1/2022 7:23
11/8/2021,Roi Et,205,6807,1296428,642234,654194,2700,2700,0,,,19/1/2022 7:23
11/8/2021,Lop Buri,254,6748,740487,369278,371209,7057,7028,29,,,19/1/2022 7:23
11/8/2021,Lampang,38,1696,726261,353817,372444,6862,6727,135,57,20,19/1/2022 7:23
11/8/2021,Lamphun,5,821,401525,192998,208527,7455,7381,74,,,19/1/2022 7:23
11/8/2021,Si Sa Ket,172,6987,1456985,725190,731795,3838,3838,0,,,19/1/2022 7:23
11/8/2021,Sakon Nakhon,150,4144,1146507,569654,576853,4675,4675,0,,,19/1/2022 7:23
11/8/2021,Songkhla,272,15343,1430543,696923,733620,1132,1132,0,49,31,19/1/2022 7:23
11/8/2021,Satun,6,941,324496,161423,163073,1183,1170,13,48,31,19/1/2022 7:23
11/8/2021,Samut Prakarn,1388,54577,1355823,645868,709955,1887,1860,27,,,19/1/2022 7:23
11/8/2021,Samut Songkhram,199,4492,191276,91338,99938,4546,4546,0,30,9,19/1/2022 7:23
11/8/2021,Samut Sakhon,1683,63450,585685,282240,303445,1338,1338,0,59,19,19/1/2022 7:23
11/8/2021,Saraburi,397,12155,643873,316304,327569,9794,9776,18,53,37,19/1/2022 7:23
11/8/2021,Sa kaeo,277,5851,561509,280362,281147,2377,2377,0,27,13,19/1/2022 7:23
11/8/2021,Sing Buri,97,1352,205088,97428,107660,3064,3064,0,,,19/1/2022 7:23
11/8/2021,Suphan Buri,108,7525,836435,403512,432923,6542,6542,0,,,19/1/2022 7:23
11/8/2021,Surat Thani,79,4269,1071496,527024,544472,4790,4115,675,59,23,19/1/2022 7:23
11/8/2021,Surin,302,7136,1376723,684837,691886,8153,8131,22,,,19/1/2022 7:23
11/8/2021,Sukhothai,158,3285,585851,283686,302165,4868,4868,0,,,19/1/2022 7:23
11/8/2021,Nong Khai,60,1495,516896,256327,260569,6520,6513,7,32,12,19/1/2022 7:23
11/8/2021,Nong Bua Lam Phu,101,1977,508942,253805,255137,1487,1487,0,,,19/1/2022 7:23
11/8/2021,Amnat Charoen,98,1668,376228,187133,189095,1440,1440,0,,,19/1/2022 7:23
11/8/2021,Udon Thani,151,6469,1566940,776022,790918,9291,9282,9,,,19/1/2022 7:23
11/8/2021,Uttaradit,88,2233,447089,217944,229145,6329,6329,0,,,19/1/2022 7:23
11/8/2021,Uthai Thani,161,1758,325254,158926,166328,2279,2279,0,,,19/1/2022 7:23
11/8/2021,Ubon Ratchathani,420,9252,1867365,932174,935191,7252,7252,0,33,12,19/1/2022 7:23
11/8/2021,Ang Thong,165,5239,275476,131801,143675,962,962,0,,,19/1/2022 7:23
11/8/2021,Chiang Rai,23,2255,1297168,630483,666685,28142,27897,245,37,10,19/1/2022 7:23
11/8/2021,Chiang Mai,52,10372,1787281,863640,923641,68614,67650,964,65,34,19/1/2022 7:23
11/8/2021,Phetchaburi,133,13240,482600,232958,249642,12139,12096,43,,,19/1/2022 7:23
11/8/2021,Phetchabun,36,3151,979033,482878,496155,20292,20262,30,,,19/1/2022 7:23
11/8/2021,Loei,51,1726,638862,320119,318743,5789,5778,11,47,19,19/1/2022 7:23
11/8/2021,Phrae,34,933,435481,209872,225609,5872,5872,0,60,26,19/1/2022 7:23
11/8/2021,Mae Hong Son,6,221,285778,144757,141021,8861,8659,202,44,10,19/1/2022 7:23
11/8/2021,,0,153,,,,,,,,,19/1/2022 7:23
12/8/2021,Krabi,35,1297,478664,237717,240947,2096,1981,115,,,19/1/2022 7:23
12/8/2021,Bangkok,4856,226318,5544789,2601856,2942933,202959,181431,21528,33,18,19/1/2022 7:23
12/8/2021,Kanchanaburi,236,6783,893129,447919,445210,20185,20157,28,34,8,19/1/2022 7:23
12/8/2021,Kalasin,151,5082,976083,482351,493732,2306,2306,0,,,19/1/2022 7:23
12/8/2021,Kamphaeng Phet,73,3917,712600,351801,360799,6769,6769,0,,,19/1/2022 7:23
12/8/2021,Khon Kaen,234,6762,1791967,880624,911343,21098,21098,0,66,33,19/1/2022 7:23
12/8/2021,Chanthaburi,150,3732,536132,262097,274035,17881,17815,66,,,19/1/2022 7:23
12/8/2021,Chachoengsao,364,18000,722615,354177,368438,1995,1995,0,37,26,19/1/2022 7:23
12/8/2021,Chon Buri,1739,43820,1580389,771364,809025,30270,29695,575,34,27,19/1/2022 7:23
12/8/2021,Chai Nat,57,1438,321015,154292,166723,4171,4171,0,,,19/1/2022 7:23
12/8/2021,Chaiyaphum,85,5323,1122780,554646,568134,13695,13682,13,,,19/1/2022 7:23
12/8/2021,Chumphon,87,1868,509292,251346,257946,1644,1644,0,,,19/1/2022 7:23
12/8/2021,Trang,49,3113,639931,312837,327094,2469,2469,0,,,19/1/2022 7:23
12/8/2021,Trat,19,1354,228459,112922,115537,22368,22277,91,,,19/1/2022 7:23
12/8/2021,Tak,193,7074,674616,341111,333505,12606,12606,0,,,19/1/2022 7:23
12/8/2021,Nakhon Nayok,298,5001,259735,128303,131432,2679,2679,0,,,19/1/2022 7:23
12/8/2021,Nakhon Pathom,621,19258,921500,442584,478916,2714,2714,0,36,9,19/1/2022 7:23
12/8/2021,Nakhon Phanom,99,3406,717048,357194,359854,3548,3548,0,,,19/1/2022 7:23
12/8/2021,Nakhon Ratchasima,320,9470,2633733,1293977,1339756,88532,87939,593,44,19,19/1/2022 7:23
12/8/2021,Nakhon Si Thammarat,147,5193,1549496,764523,784973,7996,7996,0,,,19/1/2022 7:23
12/8/2021,Nakhon Sawan,175,5674,1036534,505545,530989,15946,15946,0,68,26,19/1/2022 7:23
12/8/2021,Nonthaburi,729,41478,1285013,597870,687143,2822,2815,7,14,10,19/1/2022 7:23
12/8/2021,Narathiwat,252,8808,808758,400002,408756,421,421,0,41,19,19/1/2022 7:23
12/8/2021,Nan,30,1631,475941,238073,237868,9832,9798,34,,,19/1/2022 7:23
12/8/2021,Bueng Kan,30,1169,421931,211488,210443,2114,2114,0,,,19/1/2022 7:23
12/8/2021,Buri Ram,441,6839,1579709,783665,796044,12087,12044,43,,,19/1/2022 7:23
12/8/2021,Pathum Thani,342,27228,1185082,561507,623575,1319,1306,13,39,17,19/1/2022 7:23
12/8/2021,Prachuap Khiri Khan,81,6088,552888,274321,278567,13974,13921,53,,,19/1/2022 7:23
12/8/2021,Prachin Buri,136,4815,494505,244150,250355,3143,3143,0,48,21,19/1/2022 7:23
12/8/2021,Pattani,322,12145,728801,359974,368827,517,517,0,,,19/1/2022 7:23
12/8/2021,Phra Nakhon Si Ayutthaya,504,13164,819892,393788,426104,17000,16958,42,26,32,19/1/2022 7:23
12/8/2021,Phayao,27,1243,465390,226498,238892,9277,9277,0,44,16,19/1/2022 7:23
12/8/2021,Phang-nga,2,810,268269,133881,134388,7037,5969,1068,,,19/1/2022 7:23
12/8/2021,Phatthalung,46,2019,522612,254531,268081,1598,1598,0,,,19/1/2022 7:23
12/8/2021,Phichit,45,2270,530258,258492,271766,6914,6914,0,,,19/1/2022 7:23
12/8/2021,Phitsanulok,87,2580,847684,414983,432701,25715,25564,151,,,19/1/2022 7:23
12/8/2021,Phuket,106,2011,418055,197662,220393,33530,18204,15326,74,25,19/1/2022 7:23
12/8/2021,Maha Sarakham,255,6464,949783,465624,484159,2772,2772,0,,,19/1/2022 7:23
12/8/2021,Mukdahan,55,1402,351259,175474,175785,5322,5322,0,,,19/1/2022 7:23
12/8/2021,Yala,166,9113,541494,269636,271858,438,438,0,51,26,19/1/2022 7:23
12/8/2021,Yasothon,95,3132,533506,266189,267317,1561,1561,0,,,19/1/2022 7:23
12/8/2021,Ranong,100,3221,194677,98263,96414,1369,1369,0,,,19/1/2022 7:23
12/8/2021,Rayong,346,11733,748943,367783,381160,18635,18409,226,26,22,19/1/2022 7:23
12/8/2021,Ratchaburi,388,8595,869099,422558,446541,7187,7187,0,,,19/1/2022 7:23
12/8/2021,Roi Et,185,6992,1296428,642234,654194,2700,2700,0,,,19/1/2022 7:23
12/8/2021,Lop Buri,194,6942,740487,369278,371209,7057,7028,29,,,19/1/2022 7:23
12/8/2021,Lampang,21,1717,726261,353817,372444,6862,6727,135,62,14,19/1/2022 7:23
12/8/2021,Lamphun,7,828,401525,192998,208527,7455,7381,74,,,19/1/2022 7:23
12/8/2021,Si Sa Ket,623,7610,1456985,725190,731795,3838,3838,0,,,19/1/2022 7:23
12/8/2021,Sakon Nakhon,254,4398,1146507,569654,576853,4675,4675,0,,,19/1/2022 7:23
12/8/2021,Songkhla,312,15655,1430543,696923,733620,1132,1132,0,60,32,19/1/2022 7:23
12/8/2021,Satun,30,971,324496,161423,163073,1183,1170,13,52,28,19/1/2022 7:23
12/8/2021,Samut Prakarn,1736,56313,1355823,645868,709955,1887,1860,27,,,19/1/2022 7:23
12/8/2021,Samut Songkhram,174,4666,191276,91338,99938,4546,4546,0,17,10,19/1/2022 7:23
12/8/2021,Samut Sakhon,1779,65229,585685,282240,303445,1338,1338,0,36,28,19/1/2022 7:23
12/8/2021,Saraburi,380,12535,643873,316304,327569,9794,9776,18,40,35,19/1/2022 7:23
12/8/2021,Sa kaeo,73,5924,561509,280362,281147,2377,2377,0,23,15,19/1/2022 7:23
12/8/2021,Sing Buri,49,1401,205088,97428,107660,3064,3064,0,,,19/1/2022 7:23
12/8/2021,Suphan Buri,204,7729,836435,403512,432923,6542,6542,0,,,19/1/2022 7:23
12/8/2021,Surat Thani,87,4356,1071496,527024,544472,4790,4115,675,51,24,19/1/2022 7:23
12/8/2021,Surin,314,7450,1376723,684837,691886,8153,8131,22,,,19/1/2022 7:23
12/8/2021,Sukhothai,83,3368,585851,283686,302165,4868,4868,0,,,19/1/2022 7:23
12/8/2021,Nong Khai,65,1560,516896,256327,260569,6520,6513,7,31,13,19/1/2022 7:23
12/8/2021,Nong Bua Lam Phu,72,2049,508942,253805,255137,1487,1487,0,,,19/1/2022 7:23
12/8/2021,Amnat Charoen,95,1763,376228,187133,189095,1440,1440,0,,,19/1/2022 7:23
12/8/2021,Udon Thani,188,6657,1566940,776022,790918,9291,9282,9,,,19/1/2022 7:23
12/8/2021,Uttaradit,54,2287,447089,217944,229145,6329,6329,0,,,19/1/2022 7:23
12/8/2021,Uthai Thani,55,1813,325254,158926,166328,2279,2279,0,,,19/1/2022 7:23
12/8/2021,Ubon Ratchathani,526,9778,1867365,932174,935191,7252,7252,0,27,15,19/1/2022 7:23
12/8/2021,Ang Thong,185,5424,275476,131801,143675,962,962,0,,,19/1/2022 7:23
12/8/2021,Chiang Rai,34,2289,1297168,630483,666685,28142,27897,245,34,13,19/1/2022 7:23
12/8/2021,Chiang Mai,65,10437,1787281,863640,923641,68614,67650,964,63,28,19/1/2022 7:23
12/8/2021,Phetchaburi,110,13350,482600,232958,249642,12139,12096,43,,,19/1/2022 7:23
12/8/2021,Phetchabun,127,3278,979033,482878,496155,20292,20262,30,,,19/1/2022 7:23
12/8/2021,Loei,63,1789,638862,320119,318743,5789,5778,11,41,17,19/1/2022 7:23
12/8/2021,Phrae,56,989,435481,209872,225609,5872,5872,0,59,18,19/1/2022 7:23
12/8/2021,Mae Hong Son,9,230,285778,144757,141021,8861,8659,202,41,9,19/1/2022 7:23
12/8/2021,,0,153,,,,,,,,,19/1/2022 7:23
13/8/2021,Krabi,7,1304,478664,237717,240947,2096,1981,115,,,19/1/2022 7:23
13/8/2021,Bangkok,5161,231479,5544789,2601856,2942933,202959,181431,21528,37,23,19/1/2022 7:23
13/8/2021,Kanchanaburi,265,7048,893129,447919,445210,20185,20157,28,29,9,19/1/2022 7:23
13/8/2021,Kalasin,215,5297,976083,482351,493732,2306,2306,0,,,19/1/2022 7:23
13/8/2021,Kamphaeng Phet,146,4063,712600,351801,360799,6769,6769,0,,,19/1/2022 7:23
13/8/2021,Khon Kaen,135,6897,1791967,880624,911343,21098,21098,0,59,22,19/1/2022 7:23
13/8/2021,Chanthaburi,168,3900,536132,262097,274035,17881,17815,66,,,19/1/2022 7:23
13/8/2021,Chachoengsao,478,18478,722615,354177,368438,1995,1995,0,41,27,19/1/2022 7:23
13/8/2021,Chon Buri,1424,45244,1580389,771364,809025,30270,29695,575,37,28,19/1/2022 7:23
13/8/2021,Chai Nat,27,1465,321015,154292,166723,4171,4171,0,,,19/1/2022 7:23
13/8/2021,Chaiyaphum,84,5407,1122780,554646,568134,13695,13682,13,,,19/1/2022 7:23
13/8/2021,Chumphon,109,1977,509292,251346,257946,1644,1644,0,,,19/1/2022 7:23
13/8/2021,Trang,66,3179,639931,312837,327094,2469,2469,0,,,19/1/2022 7:23
13/8/2021,Trat,14,1368,228459,112922,115537,22368,22277,91,,,19/1/2022 7:23
13/8/2021,Tak,182,7256,674616,341111,333505,12606,12606,0,,,19/1/2022 7:23
13/8/2021,Nakhon Nayok,201,5202,259735,128303,131432,2679,2679,0,,,19/1/2022 7:23
13/8/2021,Nakhon Pathom,533,19791,921500,442584,478916,2714,2714,0,23,16,19/1/2022 7:23
13/8/2021,Nakhon Phanom,99,3505,717048,357194,359854,3548,3548,0,,,19/1/2022 7:23
13/8/2021,Nakhon Ratchasima,327,9797,2633733,1293977,1339756,88532,87939,593,46,15,19/1/2022 7:23
13/8/2021,Nakhon Si Thammarat,104,5297,1549496,764523,784973,7996,7996,0,,,19/1/2022 7:23
13/8/2021,Nakhon Sawan,173,5847,1036534,505545,530989,15946,15946,0,49,26,19/1/2022 7:23
13/8/2021,Nonthaburi,765,42243,1285013,597870,687143,2822,2815,7,17,12,19/1/2022 7:23
13/8/2021,Narathiwat,202,9010,808758,400002,408756,421,421,0,44,16,19/1/2022 7:23
13/8/2021,Nan,56,1687,475941,238073,237868,9832,9798,34,,,19/1/2022 7:23
13/8/2021,Bueng Kan,46,1215,421931,211488,210443,2114,2114,0,,,19/1/2022 7:23
13/8/2021,Buri Ram,530,7369,1579709,783665,796044,12087,12044,43,,,19/1/2022 7:23
13/8/2021,Pathum Thani,463,27691,1185082,561507,623575,1319,1306,13,31,30,19/1/2022 7:23
13/8/2021,Prachuap Khiri Khan,240,6328,552888,274321,278567,13974,13921,53,,,19/1/2022 7:23
13/8/2021,Prachin Buri,202,5017,494505,244150,250355,3143,3143,0,48,18,19/1/2022 7:23
13/8/2021,Pattani,221,12366,728801,359974,368827,517,517,0,,,19/1/2022 7:23
13/8/2021,Phra Nakhon Si Ayutthaya,530,13694,819892,393788,426104,17000,16958,42,30,33,19/1/2022 7:23
13/8/2021,Phayao,31,1274,465390,226498,238892,9277,9277,0,40,11,19/1/2022 7:23
13/8/2021,Phang-nga,0,810,268269,133881,134388,7037,5969,1068,,,19/1/2022 7:23
13/8/2021,Phatthalung,20,2039,522612,254531,268081,1598,1598,0,,,19/1/2022 7:23
13/8/2021,Phichit,70,2340,530258,258492,271766,6914,6914,0,,,19/1/2022 7:23
13/8/2021,Phitsanulok,72,2652,847684,414983,432701,25715,25564,151,,,19/1/2022 7:23
13/8/2021,Phuket,38,2049,418055,197662,220393,33530,18204,15326,50,23,19/1/2022 7:23
13/8/2021,Maha Sarakham,202,6666,949783,465624,484159,2772,2772,0,,,19/1/2022 7:23
13/8/2021,Mukdahan,45,1447,351259,175474,175785,5322,5322,0,,,19/1/2022 7:23
13/8/2021,Yala,226,9339,541494,269636,271858,438,438,0,53,20,19/1/2022 7:23
13/8/2021,Yasothon,95,3227,533506,266189,267317,1561,1561,0,,,19/1/2022 7:23
13/8/2021,Ranong,108,3329,194677,98263,96414,1369,1369,0,,,19/1/2022 7:23
13/8/2021,Rayong,406,12139,748943,367783,381160,18635,18409,226,31,22,19/1/2022 7:23
13/8/2021,Ratchaburi,300,8895,869099,422558,446541,7187,7187,0,,,19/1/2022 7:23
13/8/2021,Roi Et,357,7349,1296428,642234,654194,2700,2700,0,,,19/1/2022 7:23
13/8/2021,Lop Buri,201,7143,740487,369278,371209,7057,7028,29,,,19/1/2022 7:23
13/8/2021,Lampang,31,1748,726261,353817,372444,6862,6727,135,48,14,19/1/2022 7:23
13/8/2021,Lamphun,9,837,401525,192998,208527,7455,7381,74,,,19/1/2022 7:23
13/8/2021,Si Sa Ket,190,7800,1456985,725190,731795,3838,3838,0,,,19/1/2022 7:23
13/8/2021,Sakon Nakhon,190,4588,1146507,569654,576853,4675,4675,0,,,19/1/2022 7:23
13/8/2021,Songkhla,388,16043,1430543,696923,733620,1132,1132,0,70,34,19/1/2022 7:23
13/8/2021,Satun,17,988,324496,161423,163073,1183,1170,13,46,36,19/1/2022 7:23
13/8/2021,Samut Prakarn,1936,58249,1355823,645868,709955,1887,1860,27,,,19/1/2022 7:23
13/8/2021,Samut Songkhram,165,4831,191276,91338,99938,4546,4546,0,18,12,19/1/2022 7:23
13/8/2021,Samut Sakhon,1847,67076,585685,282240,303445,1338,1338,0,54,32,19/1/2022 7:23
13/8/2021,Saraburi,487,13022,643873,316304,327569,9794,9776,18,45,52,19/1/2022 7:23
13/8/2021,Sa kaeo,87,6011,561509,280362,281147,2377,2377,0,25,14,19/1/2022 7:23
13/8/2021,Sing Buri,50,1451,205088,97428,107660,3064,3064,0,,,19/1/2022 7:23
13/8/2021,Suphan Buri,246,7975,836435,403512,432923,6542,6542,0,,,19/1/2022 7:23
13/8/2021,Surat Thani,78,4434,1071496,527024,544472,4790,4115,675,61,25,19/1/2022 7:23
13/8/2021,Surin,252,7702,1376723,684837,691886,8153,8131,22,,,19/1/2022 7:23
13/8/2021,Sukhothai,87,3455,585851,283686,302165,4868,4868,0,,,19/1/2022 7:23
13/8/2021,Nong Khai,84,1644,516896,256327,260569,6520,6513,7,34,14,19/1/2022 7:23
13/8/2021,Nong Bua Lam Phu,109,2158,508942,253805,255137,1487,1487,0,,,19/1/2022 7:23
13/8/2021,Amnat Charoen,46,1809,376228,187133,189095,1440,1440,0,,,19/1/2022 7:23
13/8/2021,Udon Thani,228,6885,1566940,776022,790918,9291,9282,9,,,19/1/2022 7:23
13/8/2021,Uttaradit,49,2336,447089,217944,229145,6329,6329,0,,,19/1/2022 7:23
13/8/2021,Uthai Thani,94,1907,325254,158926,166328,2279,2279,0,,,19/1/2022 7:23
13/8/2021,Ubon Ratchathani,538,10316,1867365,932174,935191,7252,7252,0,34,12,19/1/2022 7:23
13/8/2021,Ang Thong,270,5694,275476,131801,143675,962,962,0,,,19/1/2022 7:23
13/8/2021,Chiang Rai,41,2330,1297168,630483,666685,28142,27897,245,42,7,19/1/2022 7:23
13/8/2021,Chiang Mai,64,10501,1787281,863640,923641,68614,67650,964,56,19,19/1/2022 7:23
13/8/2021,Phetchaburi,153,13503,482600,232958,249642,12139,12096,43,,,19/1/2022 7:23
13/8/2021,Phetchabun,159,3437,979033,482878,496155,20292,20262,30,,,19/1/2022 7:23
13/8/2021,Loei,138,1927,638862,320119,318743,5789,5778,11,37,15,19/1/2022 7:23
13/8/2021,Phrae,40,1029,435481,209872,225609,5872,5872,0,52,12,19/1/2022 7:23
13/8/2021,Mae Hong Son,1,231,285778,144757,141021,8861,8659,202,36,4,19/1/2022 7:23
13/8/2021,,0,153,,,,,,,,,19/1/2022 7:23
14/8/2021,Krabi,19,1323,478664,237717,240947,2096,1981,115,,,19/1/2022 7:23
14/8/2021,Bangkok,5093,236572,5544789,2601856,2942933,202959,181431,21528,43,17,19/1/2022 7:23
14/8/2021,Kanchanaburi,347,7395,893129,447919,445210,20185,20157,28,24,10,19/1/2022 7:23
14/8/2021,Kalasin,94,5391,976083,482351,493732,2306,2306,0,,,19/1/2022 7:23
14/8/2021,Kamphaeng Phet,139,4202,712600,351801,360799,6769,6769,0,,,19/1/2022 7:23
14/8/2021,Khon Kaen,217,7114,1791967,880624,911343,21098,21098,0,52,24,19/1/2022 7:23
14/8/2021,Chanthaburi,123,4023,536132,262097,274035,17881,17815,66,,,19/1/2022 7:23
14/8/2021,Chachoengsao,366,18844,722615,354177,368438,1995,1995,0,45,27,19/1/2022 7:23
14/8/2021,Chon Buri,1258,46502,1580389,771364,809025,30270,29695,575,36,24,19/1/2022 7:23
14/8/2021,Chai Nat,41,1506,321015,154292,166723,4171,4171,0,,,19/1/2022 7:23
14/8/2021,Chaiyaphum,250,5657,1122780,554646,568134,13695,13682,13,,,19/1/2022 7:23
14/8/2021,Chumphon,87,2064,509292,251346,257946,1644,1644,0,,,19/1/2022 7:23
14/8/2021,Trang,79,3258,639931,312837,327094,2469,2469,0,,,19/1/2022 7:23
14/8/2021,Trat,10,1378,228459,112922,115537,22368,22277,91,,,19/1/2022 7:23
14/8/2021,Tak,104,7360,674616,341111,333505,12606,12606,0,,,19/1/2022 7:23
14/8/2021,Nakhon Nayok,266,5468,259735,128303,131432,2679,2679,0,,,19/1/2022 7:23
14/8/2021,Nakhon Pathom,724,20515,921500,442584,478916,2714,2714,0,36,13,19/1/2022 7:23
14/8/2021,Nakhon Phanom,97,3602,717048,357194,359854,3548,3548,0,,,19/1/2022 7:23
14/8/2021,Nakhon Ratchasima,120,9917,2633733,1293977,1339756,88532,87939,593,36,14,19/1/2022 7:23
14/8/2021,Nakhon Si Thammarat,138,5435,1549496,764523,784973,7996,7996,0,,,19/1/2022 7:23
14/8/2021,Nakhon Sawan,171,6018,1036534,505545,530989,15946,15946,0,50,26,19/1/2022 7:23
14/8/2021,Nonthaburi,870,43113,1285013,597870,687143,2822,2815,7,28,9,19/1/2022 7:23
14/8/2021,Narathiwat,239,9249,808758,400002,408756,421,421,0,37,21,19/1/2022 7:23
14/8/2021,Nan,56,1743,475941,238073,237868,9832,9798,34,,,19/1/2022 7:23
14/8/2021,Bueng Kan,40,1255,421931,211488,210443,2114,2114,0,,,19/1/2022 7:23
14/8/2021,Buri Ram,313,7682,1579709,783665,796044,12087,12044,43,,,19/1/2022 7:23
14/8/2021,Pathum Thani,319,28010,1185082,561507,623575,1319,1306,13,48,19,19/1/2022 7:23
14/8/2021,Prachuap Khiri Khan,70,6398,552888,274321,278567,13974,13921,53,,,19/1/2022 7:23
14/8/2021,Prachin Buri,162,5179,494505,244150,250355,3143,3143,0,43,16,19/1/2022 7:23
14/8/2021,Pattani,199,12565,728801,359974,368827,517,517,0,,,19/1/2022 7:23
14/8/2021,Phra Nakhon Si Ayutthaya,379,14073,819892,393788,426104,17000,16958,42,30,34,19/1/2022 7:23
14/8/2021,Phayao,37,1311,465390,226498,238892,9277,9277,0,24,10,19/1/2022 7:23
14/8/2021,Phang-nga,12,822,268269,133881,134388,7037,5969,1068,,,19/1/2022 7:23
14/8/2021,Phatthalung,31,2070,522612,254531,268081,1598,1598,0,,,19/1/2022 7:23
14/8/2021,Phichit,140,2480,530258,258492,271766,6914,6914,0,,,19/1/2022 7:23
14/8/2021,Phitsanulok,115,2767,847684,414983,432701,25715,25564,151,,,19/1/2022 7:23
14/8/2021,Phuket,84,2133,418055,197662,220393,33530,18204,15326,47,18,19/1/2022 7:23
14/8/2021,Maha Sarakham,121,6787,949783,465624,484159,2772,2772,0,,,19/1/2022 7:23
14/8/2021,Mukdahan,33,1480,351259,175474,175785,5322,5322,0,,,19/1/2022 7:23
14/8/2021,Yala,100,9439,541494,269636,271858,438,438,0,46,24,19/1/2022 7:23
14/8/2021,Yasothon,121,3348,533506,266189,267317,1561,1561,0,,,19/1/2022 7:23
14/8/2021,Ranong,134,3463,194677,98263,96414,1369,1369,0,,,19/1/2022 7:23
14/8/2021,Rayong,297,12436,748943,367783,381160,18635,18409,226,29,24,19/1/2022 7:23
14/8/2021,Ratchaburi,311,9206,869099,422558,446541,7187,7187,0,,,19/1/2022 7:23
14/8/2021,Roi Et,268,7617,1296428,642234,654194,2700,2700,0,,,19/1/2022 7:23
14/8/2021,Lop Buri,259,7402,740487,369278,371209,7057,7028,29,,,19/1/2022 7:23
14/8/2021,Lampang,29,1777,726261,353817,372444,6862,6727,135,41,11,19/1/2022 7:23
14/8/2021,Lamphun,4,841,401525,192998,208527,7455,7381,74,,,19/1/2022 7:23
14/8/2021,Si Sa Ket,311,8111,1456985,725190,731795,3838,3838,0,,,19/1/2022 7:23
14/8/2021,Sakon Nakhon,137,4725,1146507,569654,576853,4675,4675,0,,,19/1/2022 7:23
14/8/2021,Songkhla,278,16321,1430543,696923,733620,1132,1132,0,67,31,19/1/2022 7:23
14/8/2021,Satun,4,992,324496,161423,163073,1183,1170,13,54,25,19/1/2022 7:23
14/8/2021,Samut Prakarn,1598,59847,1355823,645868,709955,1887,1860,27,,,19/1/2022 7:23
14/8/2021,Samut Songkhram,198,5029,191276,91338,99938,4546,4546,0,24,10,19/1/2022 7:23
14/8/2021,Samut Sakhon,1819,68895,585685,282240,303445,1338,1338,0,61,25,19/1/2022 7:23
14/8/2021,Saraburi,686,13708,643873,316304,327569,9794,9776,18,47,35,19/1/2022 7:23
14/8/2021,Sa kaeo,303,6314,561509,280362,281147,2377,2377,0,25,12,19/1/2022 7:23
14/8/2021,Sing Buri,45,1496,205088,97428,107660,3064,3064,0,,,19/1/2022 7:23
14/8/2021,Suphan Buri,260,8235,836435,403512,432923,6542,6542,0,,,19/1/2022 7:23
14/8/2021,Surat Thani,59,4493,1071496,527024,544472,4790,4115,675,59,24,19/1/2022 7:23
14/8/2021,Surin,240,7942,1376723,684837,691886,8153,8131,22,,,19/1/2022 7:23
14/8/2021,Sukhothai,68,3523,585851,283686,302165,4868,4868,0,,,19/1/2022 7:23
14/8/2021,Nong Khai,50,1694,516896,256327,260569,6520,6513,7,36,15,19/1/2022 7:23
14/8/2021,Nong Bua Lam Phu,138,2296,508942,253805,255137,1487,1487,0,,,19/1/2022 7:23
14/8/2021,Amnat Charoen,83,1892,376228,187133,189095,1440,1440,0,,,19/1/2022 7:23
14/8/2021,Udon Thani,200,7085,1566940,776022,790918,9291,9282,9,,,19/1/2022 7:23
14/8/2021,Uttaradit,70,2406,447089,217944,229145,6329,6329,0,,,19/1/2022 7:23
14/8/2021,Uthai Thani,38,1945,325254,158926,166328,2279,2279,0,,,19/1/2022 7:23
14/8/2021,Ubon Ratchathani,397,10713,1867365,932174,935191,7252,7252,0,29,12,19/1/2022 7:23
14/8/2021,Ang Thong,238,5932,275476,131801,143675,962,962,0,,,19/1/2022 7:23
14/8/2021,Chiang Rai,38,2368,1297168,630483,666685,28142,27897,245,27,5,19/1/2022 7:23
14/8/2021,Chiang Mai,62,10563,1787281,863640,923641,68614,67650,964,49,20,19/1/2022 7:23
14/8/2021,Phetchaburi,65,13568,482600,232958,249642,12139,12096,43,,,19/1/2022 7:23
14/8/2021,Phetchabun,119,3556,979033,482878,496155,20292,20262,30,,,19/1/2022 7:23
14/8/2021,Loei,59,1986,638862,320119,318743,5789,5778,11,29,12,19/1/2022 7:23
14/8/2021,Phrae,33,1062,435481,209872,225609,5872,5872,0,36,10,19/1/2022 7:23
14/8/2021,Mae Hong Son,4,235,285778,144757,141021,8861,8659,202,16,2,19/1/2022 7:23
14/8/2021,,0,153,,,,,,,,,19/1/2022 7:23
15/8/2021,Krabi,25,1348,478664,237717,240947,2096,1981,115,,,19/1/2022 7:23
15/8/2021,Bangkok,4217,240789,5544789,2601856,2942933,202959,181431,21528,37,16,19/1/2022 7:23
15/8/2021,Kanchanaburi,259,7654,893129,447919,445210,20185,20157,28,30,8,19/1/2022 7:23
15/8/2021,Kalasin,203,5594,976083,482351,493732,2306,2306,0,,,19/1/2022 7:23
15/8/2021,Kamphaeng Phet,172,4374,712600,351801,360799,6769,6769,0,,,19/1/2022 7:23
15/8/2021,Khon Kaen,236,7350,1791967,880624,911343,21098,21098,0,53,25,19/1/2022 7:23
15/8/2021,Chanthaburi,127,4150,536132,262097,274035,17881,17815,66,,,19/1/2022 7:23
15/8/2021,Chachoengsao,434,19278,722615,354177,368438,1995,1995,0,49,24,19/1/2022 7:23
15/8/2021,Chon Buri,1530,48032,1580389,771364,809025,30270,29695,575,38,21,19/1/2022 7:23
15/8/2021,Chai Nat,47,1553,321015,154292,166723,4171,4171,0,,,19/1/2022 7:23
15/8/2021,Chaiyaphum,117,5774,1122780,554646,568134,13695,13682,13,,,19/1/2022 7:23
15/8/2021,Chumphon,84,2148,509292,251346,257946,1644,1644,0,,,19/1/2022 7:23
15/8/2021,Trang,77,3335,639931,312837,327094,2469,2469,0,,,19/1/2022 7:23
15/8/2021,Trat,20,1398,228459,112922,115537,22368,22277,91,,,19/1/2022 7:23
15/8/2021,Tak,228,7588,674616,341111,333505,12606,12606,0,,,19/1/2022 7:23
15/8/2021,Nakhon Nayok,251,5719,259735,128303,131432,2679,2679,0,,,19/1/2022 7:23
15/8/2021,Nakhon Pathom,479,20994,921500,442584,478916,2714,2714,0,31,13,19/1/2022 7:23
15/8/2021,Nakhon Phanom,72,3674,717048,357194,359854,3548,3548,0,,,19/1/2022 7:23
15/8/2021,Nakhon Ratchasima,445,10362,2633733,1293977,1339756,88532,87939,593,40,16,19/1/2022 7:23
15/8/2021,Nakhon Si Thammarat,65,5500,1549496,764523,784973,7996,7996,0,,,19/1/2022 7:23
15/8/2021,Nakhon Sawan,148,6166,1036534,505545,530989,15946,15946,0,50,24,19/1/2022 7:23
15/8/2021,Nonthaburi,650,43763,1285013,597870,687143,2822,2815,7,23,10,19/1/2022 7:23
15/8/2021,Narathiwat,236,9485,808758,400002,408756,421,421,0,48,15,19/1/2022 7:23
15/8/2021,Nan,57,1800,475941,238073,237868,9832,9798,34,,,19/1/2022 7:23
15/8/2021,Bueng Kan,40,1295,421931,211488,210443,2114,2114,0,,,19/1/2022 7:23
15/8/2021,Buri Ram,317,7999,1579709,783665,796044,12087,12044,43,,,19/1/2022 7:23
15/8/2021,Pathum Thani,435,28445,1185082,561507,623575,1319,1306,13,35,29,19/1/2022 7:23
15/8/2021,Prachuap Khiri Khan,75,6473,552888,274321,278567,13974,13921,53,,,19/1/2022 7:23
15/8/2021,Prachin Buri,178,5357,494505,244150,250355,3143,3143,0,46,20,19/1/2022 7:23
15/8/2021,Pattani,275,12840,728801,359974,368827,517,517,0,,,19/1/2022 7:23
15/8/2021,Phra Nakhon Si Ayutthaya,559,14632,819892,393788,426104,17000,16958,42,25,34,19/1/2022 7:23
15/8/2021,Phayao,34,1345,465390,226498,238892,9277,9277,0,23,11,19/1/2022 7:23
15/8/2021,Phang-nga,20,842,268269,133881,134388,7037,5969,1068,,,19/1/2022 7:23
15/8/2021,Phatthalung,27,2097,522612,254531,268081,1598,1598,0,,,19/1/2022 7:23
15/8/2021,Phichit,74,2554,530258,258492,271766,6914,6914,0,,,19/1/2022 7:23
15/8/2021,Phitsanulok,70,2837,847684,414983,432701,25715,25564,151,,,19/1/2022 7:23
15/8/2021,Phuket,109,2242,418055,197662,220393,33530,18204,15326,46,22,19/1/2022 7:23
15/8/2021,Maha Sarakham,220,7007,949783,465624,484159,2772,2772,0,,,19/1/2022 7:23
15/8/2021,Mukdahan,68,1548,351259,175474,175785,5322,5322,0,,,19/1/2022 7:23
15/8/2021,Yala,157,9596,541494,269636,271858,438,438,0,53,24,19/1/2022 7:23
15/8/2021,Yasothon,87,3435,533506,266189,267317,1561,1561,0,,,19/1/2022 7:23
15/8/2021,Ranong,127,3590,194677,98263,96414,1369,1369,0,,,19/1/2022 7:23
15/8/2021,Rayong,390,12826,748943,367783,381160,18635,18409,226,40,23,19/1/2022 7:23
15/8/2021,Ratchaburi,358,9564,869099,422558,446541,7187,7187,0,,,19/1/2022 7:23
15/8/2021,Roi Et,269,7886,1296428,642234,654194,2700,2700,0,,,19/1/2022 7:23
15/8/2021,Lop Buri,220,7622,740487,369278,371209,7057,7028,29,,,19/1/2022 7:23
15/8/2021,Lampang,15,1792,726261,353817,372444,6862,6727,135,36,14,19/1/2022 7:23
15/8/2021,Lamphun,9,850,401525,192998,208527,7455,7381,74,,,19/1/2022 7:23
15/8/2021,Si Sa Ket,385,8496,1456985,725190,731795,3838,3838,0,,,19/1/2022 7:23
15/8/2021,Sakon Nakhon,135,4860,1146507,569654,576853,4675,4675,0,,,19/1/2022 7:23
15/8/2021,Songkhla,276,16597,1430543,696923,733620,1132,1132,0,65,26,19/1/2022 7:23
15/8/2021,Satun,4,996,324496,161423,163073,1183,1170,13,44,27,19/1/2022 7:23
15/8/2021,Samut Prakarn,1523,61370,1355823,645868,709955,1887,1860,27,,,19/1/2022 7:23
15/8/2021,Samut Songkhram,265,5294,191276,91338,99938,4546,4546,0,22,11,19/1/2022 7:23
15/8/2021,Samut Sakhon,1851,70746,585685,282240,303445,1338,1338,0,47,27,19/1/2022 7:23
15/8/2021,Saraburi,565,14273,643873,316304,327569,9794,9776,18,43,53,19/1/2022 7:23
15/8/2021,Sa kaeo,231,6545,561509,280362,281147,2377,2377,0,27,13,19/1/2022 7:23
15/8/2021,Sing Buri,47,1543,205088,97428,107660,3064,3064,0,,,19/1/2022 7:23
15/8/2021,Suphan Buri,181,8416,836435,403512,432923,6542,6542,0,,,19/1/2022 7:23
15/8/2021,Surat Thani,133,4626,1071496,527024,544472,4790,4115,675,68,22,19/1/2022 7:23
15/8/2021,Surin,318,8260,1376723,684837,691886,8153,8131,22,,,19/1/2022 7:23
15/8/2021,Sukhothai,91,3614,585851,283686,302165,4868,4868,0,,,19/1/2022 7:23
15/8/2021,Nong Khai,92,1786,516896,256327,260569,6520,6513,7,37,15,19/1/2022 7:23
15/8/2021,Nong Bua Lam Phu,46,2342,508942,253805,255137,1487,1487,0,,,19/1/2022 7:23
15/8/2021,Amnat Charoen,58,1950,376228,187133,189095,1440,1440,0,,,19/1/2022 7:23
15/8/2021,Udon Thani,198,7283,1566940,776022,790918,9291,9282,9,,,19/1/2022 7:23
15/8/2021,Uttaradit,61,2467,447089,217944,229145,6329,6329,0,,,19/1/2022 7:23
15/8/2021,Uthai Thani,53,1998,325254,158926,166328,2279,2279,0,,,19/1/2022 7:23
15/8/2021,Ubon Ratchathani,303,11016,1867365,932174,935191,7252,7252,0,27,17,19/1/2022 7:23
15/8/2021,Ang Thong,220,6152,275476,131801,143675,962,962,0,,,19/1/2022 7:23
15/8/2021,Chiang Rai,56,2424,1297168,630483,666685,28142,27897,245,21,5,19/1/2022 7:23
15/8/2021,Chiang Mai,62,10625,1787281,863640,923641,68614,67650,964,48,20,19/1/2022 7:23
15/8/2021,Phetchaburi,132,13700,482600,232958,249642,12139,12096,43,,,19/1/2022 7:23
15/8/2021,Phetchabun,196,3752,979033,482878,496155,20292,20262,30,,,19/1/2022 7:23
15/8/2021,Loei,33,2019,638862,320119,318743,5789,5778,11,26,12,19/1/2022 7:23
15/8/2021,Phrae,53,1115,435481,209872,225609,5872,5872,0,31,11,19/1/2022 7:23
15/8/2021,Mae Hong Son,2,237,285778,144757,141021,8861,8659,202,12,2,19/1/2022 7:23
15/8/2021,,0,153,,,,,,,,,19/1/2022 7:23
16/8/2021,Krabi,11,1359,478664,237717,240947,2096,1981,115,,,19/1/2022 7:23
16/8/2021,Bangkok,4337,245126,5544789,2601856,2942933,202959,181431,21528,32,28,19/1/2022 7:23
16/8/2021,Kanchanaburi,344,7998,893129,447919,445210,20185,20157,28,24,11,19/1/2022 7:23
16/8/2021,Kalasin,81,5675,976083,482351,493732,2306,2306,0,,,19/1/2022 7:23
16/8/2021,Kamphaeng Phet,153,4527,712600,351801,360799,6769,6769,0,,,19/1/2022 7:23
16/8/2021,Khon Kaen,260,7610,1791967,880624,911343,21098,21098,0,52,32,19/1/2022 7:23
16/8/2021,Chanthaburi,147,4297,536132,262097,274035,17881,17815,66,,,19/1/2022 7:23
16/8/2021,Chachoengsao,541,19819,722615,354177,368438,1995,1995,0,33,32,19/1/2022 7:23
16/8/2021,Chon Buri,1224,49256,1580389,771364,809025,30270,29695,575,36,26,19/1/2022 7:23
16/8/2021,Chai Nat,17,1570,321015,154292,166723,4171,4171,0,,,19/1/2022 7:23
16/8/2021,Chaiyaphum,250,6024,1122780,554646,568134,13695,13682,13,,,19/1/2022 7:23
16/8/2021,Chumphon,145,2293,509292,251346,257946,1644,1644,0,,,19/1/2022 7:23
16/8/2021,Trang,55,3390,639931,312837,327094,2469,2469,0,,,19/1/2022 7:23
16/8/2021,Trat,18,1416,228459,112922,115537,22368,22277,91,,,19/1/2022 7:23
16/8/2021,Tak,239,7827,674616,341111,333505,12606,12606,0,,,19/1/2022 7:23
16/8/2021,Nakhon Nayok,235,5954,259735,128303,131432,2679,2679,0,,,19/1/2022 7:23
16/8/2021,Nakhon Pathom,450,21444,921500,442584,478916,2714,2714,0,31,21,19/1/2022 7:23
16/8/2021,Nakhon Phanom,69,3743,717048,357194,359854,3548,3548,0,,,19/1/2022 7:23
16/8/2021,Nakhon Ratchasima,547,10909,2633733,1293977,1339756,88532,87939,593,44,22,19/1/2022 7:23
16/8/2021,Nakhon Si Thammarat,100,5600,1549496,764523,784973,7996,7996,0,,,19/1/2022 7:23
16/8/2021,Nakhon Sawan,309,6475,1036534,505545,530989,15946,15946,0,45,26,19/1/2022 7:23
16/8/2021,Nonthaburi,790,44553,1285013,597870,687143,2822,2815,7,21,15,19/1/2022 7:23
16/8/2021,Narathiwat,179,9664,808758,400002,408756,421,421,0,31,22,19/1/2022 7:23
16/8/2021,Nan,33,1833,475941,238073,237868,9832,9798,34,,,19/1/2022 7:23
16/8/2021,Bueng Kan,20,1315,421931,211488,210443,2114,2114,0,,,19/1/2022 7:23
16/8/2021,Buri Ram,319,8318,1579709,783665,796044,12087,12044,43,,,19/1/2022 7:23
16/8/2021,Pathum Thani,363,28808,1185082,561507,623575,1319,1306,13,52,25,19/1/2022 7:23
16/8/2021,Prachuap Khiri Khan,95,6568,552888,274321,278567,13974,13921,53,,,19/1/2022 7:23
16/8/2021,Prachin Buri,157,5514,494505,244150,250355,3143,3143,0,41,32,19/1/2022 7:23
16/8/2021,Pattani,117,12957,728801,359974,368827,517,517,0,,,19/1/2022 7:23
16/8/2021,Phra Nakhon Si Ayutthaya,421,15053,819892,393788,426104,17000,16958,42,30,36,19/1/2022 7:23
16/8/2021,Phayao,18,1363,465390,226498,238892,9277,9277,0,32,13,19/1/2022 7:23
16/8/2021,Phang-nga,2,844,268269,133881,134388,7037,5969,1068,,,19/1/2022 7:23
16/8/2021,Phatthalung,10,2107,522612,254531,268081,1598,1598,0,,,19/1/2022 7:23
16/8/2021,Phichit,96,2650,530258,258492,271766,6914,6914,0,,,19/1/2022 7:23
16/8/2021,Phitsanulok,48,2885,847684,414983,432701,25715,25564,151,,,19/1/2022 7:23
16/8/2021,Phuket,50,2292,418055,197662,220393,33530,18204,15326,53,22,19/1/2022 7:23
16/8/2021,Maha Sarakham,124,7131,949783,465624,484159,2772,2772,0,,,19/1/2022 7:23
16/8/2021,Mukdahan,37,1585,351259,175474,175785,5322,5322,0,,,19/1/2022 7:23
16/8/2021,Yala,117,9713,541494,269636,271858,438,438,0,47,23,19/1/2022 7:23
16/8/2021,Yasothon,134,3569,533506,266189,267317,1561,1561,0,,,19/1/2022 7:23
16/8/2021,Ranong,309,3899,194677,98263,96414,1369,1369,0,,,19/1/2022 7:23
16/8/2021,Rayong,340,13166,748943,367783,381160,18635,18409,226,37,27,19/1/2022 7:23
16/8/2021,Ratchaburi,322,9886,869099,422558,446541,7187,7187,0,,,19/1/2022 7:23
16/8/2021,Roi Et,399,8285,1296428,642234,654194,2700,2700,0,,,19/1/2022 7:23
16/8/2021,Lop Buri,451,8073,740487,369278,371209,7057,7028,29,,,19/1/2022 7:23
16/8/2021,Lampang,14,1806,726261,353817,372444,6862,6727,135,43,15,19/1/2022 7:23
16/8/2021,Lamphun,14,864,401525,192998,208527,7455,7381,74,,,19/1/2022 7:23
16/8/2021,Si Sa Ket,347,8843,1456985,725190,731795,3838,3838,0,,,19/1/2022 7:23
16/8/2021,Sakon Nakhon,57,4917,1146507,569654,576853,4675,4675,0,,,19/1/2022 7:23
16/8/2021,Songkhla,306,16903,1430543,696923,733620,1132,1132,0,55,27,19/1/2022 7:23
16/8/2021,Satun,21,1017,324496,161423,163073,1183,1170,13,50,23,19/1/2022 7:23
16/8/2021,Samut Prakarn,1147,62517,1355823,645868,709955,1887,1860,27,,,19/1/2022 7:23
16/8/2021,Samut Songkhram,221,5515,191276,91338,99938,4546,4546,0,18,14,19/1/2022 7:23
16/8/2021,Samut Sakhon,1870,72616,585685,282240,303445,1338,1338,0,49,33,19/1/2022 7:23
16/8/2021,Saraburi,470,14743,643873,316304,327569,9794,9776,18,57,69,19/1/2022 7:23
16/8/2021,Sa kaeo,262,6807,561509,280362,281147,2377,2377,0,30,16,19/1/2022 7:23
16/8/2021,Sing Buri,40,1583,205088,97428,107660,3064,3064,0,,,19/1/2022 7:23
16/8/2021,Suphan Buri,167,8583,836435,403512,432923,6542,6542,0,,,19/1/2022 7:23
16/8/2021,Surat Thani,72,4698,1071496,527024,544472,4790,4115,675,59,24,19/1/2022 7:23
16/8/2021,Surin,269,8529,1376723,684837,691886,8153,8131,22,,,19/1/2022 7:23
16/8/2021,Sukhothai,67,3681,585851,283686,302165,4868,4868,0,,,19/1/2022 7:23
16/8/2021,Nong Khai,30,1816,516896,256327,260569,6520,6513,7,37,14,19/1/2022 7:23
16/8/2021,Nong Bua Lam Phu,130,2472,508942,253805,255137,1487,1487,0,,,19/1/2022 7:23
16/8/2021,Amnat Charoen,36,1986,376228,187133,189095,1440,1440,0,,,19/1/2022 7:23
16/8/2021,Udon Thani,210,7493,1566940,776022,790918,9291,9282,9,,,19/1/2022 7:23
16/8/2021,Uttaradit,67,2534,447089,217944,229145,6329,6329,0,,,19/1/2022 7:23
16/8/2021,Uthai Thani,63,2061,325254,158926,166328,2279,2279,0,,,19/1/2022 7:23
16/8/2021,Ubon Ratchathani,266,11282,1867365,932174,935191,7252,7252,0,36,29,19/1/2022 7:23
16/8/2021,Ang Thong,215,6367,275476,131801,143675,962,962,0,,,19/1/2022 7:23
16/8/2021,Chiang Rai,22,2446,1297168,630483,666685,28142,27897,245,21,6,19/1/2022 7:23
16/8/2021,Chiang Mai,41,10666,1787281,863640,923641,68614,67650,964,45,22,19/1/2022 7:23
16/8/2021,Phetchaburi,67,13767,482600,232958,249642,12139,12096,43,,,19/1/2022 7:23
16/8/2021,Phetchabun,94,3846,979033,482878,496155,20292,20262,30,,,19/1/2022 7:23
16/8/2021,Loei,66,2085,638862,320119,318743,5789,5778,11,21,14,19/1/2022 7:23
16/8/2021,Phrae,22,1137,435481,209872,225609,5872,5872,0,34,12,19/1/2022 7:23
16/8/2021,Mae Hong Son,1,238,285778,144757,141021,8861,8659,202,10,3,19/1/2022 7:23
16/8/2021,,0,153,,,,,,,,,19/1/2022 7:23
17/8/2021,Krabi,2,1361,478664,237717,240947,2096,1981,115,,,19/1/2022 7:23
17/8/2021,Bangkok,4404,249530,5544789,2601856,2942933,202959,181431,21528,60,26,19/1/2022 7:23
17/8/2021,Kanchanaburi,384,8382,893129,447919,445210,20185,20157,28,29,12,19/1/2022 7:23
17/8/2021,Kalasin,83,5758,976083,482351,493732,2306,2306,0,,,19/1/2022 7:23
17/8/2021,Kamphaeng Phet,202,4729,712600,351801,360799,6769,6769,0,,,19/1/2022 7:23
17/8/2021,Khon Kaen,341,7951,1791967,880624,911343,21098,21098,0,65,36,19/1/2022 7:23
17/8/2021,Chanthaburi,121,4418,536132,262097,274035,17881,17815,66,,,19/1/2022 7:23
17/8/2021,Chachoengsao,403,20222,722615,354177,368438,1995,1995,0,53,34,19/1/2022 7:23
17/8/2021,Chon Buri,1183,50439,1580389,771364,809025,30270,29695,575,44,33,19/1/2022 7:23
17/8/2021,Chai Nat,30,1600,321015,154292,166723,4171,4171,0,,,19/1/2022 7:23
17/8/2021,Chaiyaphum,216,6240,1122780,554646,568134,13695,13682,13,,,19/1/2022 7:23
17/8/2021,Chumphon,139,2432,509292,251346,257946,1644,1644,0,,,19/1/2022 7:23
17/8/2021,Trang,40,3430,639931,312837,327094,2469,2469,0,,,19/1/2022 7:23
17/8/2021,Trat,10,1426,228459,112922,115537,22368,22277,91,,,19/1/2022 7:23
17/8/2021,Tak,122,7949,674616,341111,333505,12606,12606,0,,,19/1/2022 7:23
17/8/2021,Nakhon Nayok,183,6137,259735,128303,131432,2679,2679,0,,,19/1/2022 7:23
17/8/2021,Nakhon Pathom,344,21788,921500,442584,478916,2714,2714,0,46,15,19/1/2022 7:23
17/8/2021,Nakhon Phanom,82,3825,717048,357194,359854,3548,3548,0,,,19/1/2022 7:23
17/8/2021,Nakhon Ratchasima,354,11263,2633733,1293977,1339756,88532,87939,593,52,29,19/1/2022 7:23
17/8/2021,Nakhon Si Thammarat,116,5716,1549496,764523,784973,7996,7996,0,,,19/1/2022 7:23
17/8/2021,Nakhon Sawan,107,6582,1036534,505545,530989,15946,15946,0,48,30,19/1/2022 7:23
17/8/2021,Nonthaburi,984,45537,1285013,597870,687143,2822,2815,7,33,14,19/1/2022 7:23
17/8/2021,Narathiwat,231,9895,808758,400002,408756,421,421,0,39,20,19/1/2022 7:23
17/8/2021,Nan,33,1866,475941,238073,237868,9832,9798,34,,,19/1/2022 7:23
17/8/2021,Bueng Kan,16,1331,421931,211488,210443,2114,2114,0,,,19/1/2022 7:23
17/8/2021,Buri Ram,315,8633,1579709,783665,796044,12087,12044,43,,,19/1/2022 7:23
17/8/2021,Pathum Thani,303,29111,1185082,561507,623575,1319,1306,13,53,24,19/1/2022 7:23
17/8/2021,Prachuap Khiri Khan,66,6634,552888,274321,278567,13974,13921,53,,,19/1/2022 7:23
17/8/2021,Prachin Buri,148,5662,494505,244150,250355,3143,3143,0,68,33,19/1/2022 7:23
17/8/2021,Pattani,226,13183,728801,359974,368827,517,517,0,,,19/1/2022 7:23
17/8/2021,Phra Nakhon Si Ayutthaya,507,15560,819892,393788,426104,17000,16958,42,33,42,19/1/2022 7:23
17/8/2021,Phayao,17,1380,465390,226498,238892,9277,9277,0,28,13,19/1/2022 7:23
17/8/2021,Phang-nga,4,848,268269,133881,134388,7037,5969,1068,,,19/1/2022 7:23
17/8/2021,Phatthalung,23,2130,522612,254531,268081,1598,1598,0,,,19/1/2022 7:23
17/8/2021,Phichit,66,2716,530258,258492,271766,6914,6914,0,,,19/1/2022 7:23
17/8/2021,Phitsanulok,41,2926,847684,414983,432701,25715,25564,151,,,19/1/2022 7:23
17/8/2021,Phuket,52,2344,418055,197662,220393,33530,18204,15326,54,23,19/1/2022 7:23
17/8/2021,Maha Sarakham,75,7206,949783,465624,484159,2772,2772,0,,,19/1/2022 7:23
17/8/2021,Mukdahan,19,1604,351259,175474,175785,5322,5322,0,,,19/1/2022 7:23
17/8/2021,Yala,66,9779,541494,269636,271858,438,438,0,46,22,19/1/2022 7:23
17/8/2021,Yasothon,65,3634,533506,266189,267317,1561,1561,0,,,19/1/2022 7:23
17/8/2021,Ranong,134,4033,194677,98263,96414,1369,1369,0,,,19/1/2022 7:23
17/8/2021,Rayong,201,13367,748943,367783,381160,18635,18409,226,47,28,19/1/2022 7:23
17/8/2021,Ratchaburi,398,10284,869099,422558,446541,7187,7187,0,,,19/1/2022 7:23
17/8/2021,Roi Et,424,8709,1296428,642234,654194,2700,2700,0,,,19/1/2022 7:23
17/8/2021,Lop Buri,277,8350,740487,369278,371209,7057,7028,29,,,19/1/2022 7:23
17/8/2021,Lampang,37,1843,726261,353817,372444,6862,6727,135,47,16,19/1/2022 7:23
17/8/2021,Lamphun,23,887,401525,192998,208527,7455,7381,74,,,19/1/2022 7:23
17/8/2021,Si Sa Ket,397,9240,1456985,725190,731795,3838,3838,0,,,19/1/2022 7:23
17/8/2021,Sakon Nakhon,120,5037,1146507,569654,576853,4675,4675,0,,,19/1/2022 7:23
17/8/2021,Songkhla,183,17086,1430543,696923,733620,1132,1132,0,52,31,19/1/2022 7:23
17/8/2021,Satun,13,1030,324496,161423,163073,1183,1170,13,43,28,19/1/2022 7:23
17/8/2021,Samut Prakarn,1200,63717,1355823,645868,709955,1887,1860,27,,,19/1/2022 7:23
17/8/2021,Samut Songkhram,194,5709,191276,91338,99938,4546,4546,0,29,17,19/1/2022 7:23
17/8/2021,Samut Sakhon,1843,74459,585685,282240,303445,1338,1338,0,60,29,19/1/2022 7:23
17/8/2021,Saraburi,398,15141,643873,316304,327569,9794,9776,18,80,85,19/1/2022 7:23
17/8/2021,Sa kaeo,220,7027,561509,280362,281147,2377,2377,0,38,21,19/1/2022 7:23
17/8/2021,Sing Buri,44,1627,205088,97428,107660,3064,3064,0,,,19/1/2022 7:23
17/8/2021,Suphan Buri,142,8725,836435,403512,432923,6542,6542,0,,,19/1/2022 7:23
17/8/2021,Surat Thani,94,4792,1071496,527024,544472,4790,4115,675,50,26,19/1/2022 7:23
17/8/2021,Surin,302,8831,1376723,684837,691886,8153,8131,22,,,19/1/2022 7:23
17/8/2021,Sukhothai,95,3776,585851,283686,302165,4868,4868,0,,,19/1/2022 7:23
17/8/2021,Nong Khai,33,1849,516896,256327,260569,6520,6513,7,35,15,19/1/2022 7:23
17/8/2021,Nong Bua Lam Phu,62,2534,508942,253805,255137,1487,1487,0,,,19/1/2022 7:23
17/8/2021,Amnat Charoen,57,2043,376228,187133,189095,1440,1440,0,,,19/1/2022 7:23
17/8/2021,Udon Thani,178,7671,1566940,776022,790918,9291,9282,9,,,19/1/2022 7:23
17/8/2021,Uttaradit,35,2569,447089,217944,229145,6329,6329,0,,,19/1/2022 7:23
17/8/2021,Uthai Thani,35,2096,325254,158926,166328,2279,2279,0,,,19/1/2022 7:23
17/8/2021,Ubon Ratchathani,283,11565,1867365,932174,935191,7252,7252,0,62,27,19/1/2022 7:23
17/8/2021,Ang Thong,195,6562,275476,131801,143675,962,962,0,,,19/1/2022 7:23
17/8/2021,Chiang Rai,38,2484,1297168,630483,666685,28142,27897,245,22,6,19/1/2022 7:23
17/8/2021,Chiang Mai,53,10719,1787281,863640,923641,68614,67650,964,51,24,19/1/2022 7:23
17/8/2021,Phetchaburi,81,13848,482600,232958,249642,12139,12096,43,,,19/1/2022 7:23
17/8/2021,Phetchabun,139,3985,979033,482878,496155,20292,20262,30,,,19/1/2022 7:23
17/8/2021,Loei,62,2147,638862,320119,318743,5789,5778,11,30,17,19/1/2022 7:23
17/8/2021,Phrae,15,1152,435481,209872,225609,5872,5872,0,32,18,19/1/2022 7:23
17/8/2021,Mae Hong Son,0,238,285778,144757,141021,8861,8659,202,15,3,19/1/2022 7:23
17/8/2021,,0,153,,,,,,,,,19/1/2022 7:23
18/8/2021,Krabi,18,1379,478664,237717,240947,2096,1981,115,,,19/1/2022 7:23
18/8/2021,Bangkok,4165,253695,5544789,2601856,2942933,202959,181431,21528,54,26,19/1/2022 7:23
18/8/2021,Kanchanaburi,263,8645,893129,447919,445210,20185,20157,28,39,14,19/1/2022 7:23
18/8/2021,Kalasin,145,5903,976083,482351,493732,2306,2306,0,,,19/1/2022 7:23
18/8/2021,Kamphaeng Phet,87,4816,712600,351801,360799,6769,6769,0,,,19/1/2022 7:23
18/8/2021,Khon Kaen,242,8193,1791967,880624,911343,21098,21098,0,70,39,19/1/2022 7:23
18/8/2021,Chanthaburi,174,4592,536132,262097,274035,17881,17815,66,,,19/1/2022 7:23
18/8/2021,Chachoengsao,632,20854,722615,354177,368438,1995,1995,0,70,38,19/1/2022 7:23
18/8/2021,Chon Buri,1209,51648,1580389,771364,809025,30270,29695,575,57,34,19/1/2022 7:23
18/8/2021,Chai Nat,19,1619,321015,154292,166723,4171,4171,0,,,19/1/2022 7:23
18/8/2021,Chaiyaphum,158,6398,1122780,554646,568134,13695,13682,13,,,19/1/2022 7:23
18/8/2021,Chumphon,101,2533,509292,251346,257946,1644,1644,0,,,19/1/2022 7:23
18/8/2021,Trang,39,3469,639931,312837,327094,2469,2469,0,,,19/1/2022 7:23
18/8/2021,Trat,20,1446,228459,112922,115537,22368,22277,91,,,19/1/2022 7:23
18/8/2021,Tak,207,8156,674616,341111,333505,12606,12606,0,,,19/1/2022 7:23
18/8/2021,Nakhon Nayok,256,6393,259735,128303,131432,2679,2679,0,,,19/1/2022 7:23
18/8/2021,Nakhon Pathom,468,22256,921500,442584,478916,2714,2714,0,35,17,19/1/2022 7:23
18/8/2021,Nakhon Phanom,59,3884,717048,357194,359854,3548,3548,0,,,19/1/2022 7:23
18/8/2021,Nakhon Ratchasima,719,11982,2633733,1293977,1339756,88532,87939,593,59,26,19/1/2022 7:23
18/8/2021,Nakhon Si Thammarat,68,5784,1549496,764523,784973,7996,7996,0,,,19/1/2022 7:23
18/8/2021,Nakhon Sawan,277,6859,1036534,505545,530989,15946,15946,0,59,31,19/1/2022 7:23
18/8/2021,Nonthaburi,756,46293,1285013,597870,687143,2822,2815,7,31,37,19/1/2022 7:23
18/8/2021,Narathiwat,294,10189,808758,400002,408756,421,421,0,34,22,19/1/2022 7:23
18/8/2021,Nan,26,1892,475941,238073,237868,9832,9798,34,,,19/1/2022 7:23
18/8/2021,Bueng Kan,45,1376,421931,211488,210443,2114,2114,0,,,19/1/2022 7:23
18/8/2021,Buri Ram,304,8937,1579709,783665,796044,12087,12044,43,,,19/1/2022 7:23
18/8/2021,Pathum Thani,429,29540,1185082,561507,623575,1319,1306,13,46,27,19/1/2022 7:23
18/8/2021,Prachuap Khiri Khan,70,6704,552888,274321,278567,13974,13921,53,,,19/1/2022 7:23
18/8/2021,Prachin Buri,264,5926,494505,244150,250355,3143,3143,0,73,41,19/1/2022 7:23
18/8/2021,Pattani,239,13422,728801,359974,368827,517,517,0,,,19/1/2022 7:23
18/8/2021,Phra Nakhon Si Ayutthaya,439,15999,819892,393788,426104,17000,16958,42,53,45,19/1/2022 7:23
18/8/2021,Phayao,17,1397,465390,226498,238892,9277,9277,0,24,13,19/1/2022 7:23
18/8/2021,Phang-nga,26,874,268269,133881,134388,7037,5969,1068,,,19/1/2022 7:23
18/8/2021,Phatthalung,38,2168,522612,254531,268081,1598,1598,0,,,19/1/2022 7:23
18/8/2021,Phichit,53,2769,530258,258492,271766,6914,6914,0,,,19/1/2022 7:23
18/8/2021,Phitsanulok,72,2998,847684,414983,432701,25715,25564,151,,,19/1/2022 7:23
18/8/2021,Phuket,43,2387,418055,197662,220393,33530,18204,15326,52,23,19/1/2022 7:23
18/8/2021,Maha Sarakham,229,7435,949783,465624,484159,2772,2772,0,,,19/1/2022 7:23
18/8/2021,Mukdahan,17,1621,351259,175474,175785,5322,5322,0,,,19/1/2022 7:23
18/8/2021,Yala,160,9939,541494,269636,271858,438,438,0,45,22,19/1/2022 7:23
18/8/2021,Yasothon,105,3739,533506,266189,267317,1561,1561,0,,,19/1/2022 7:23
18/8/2021,Ranong,135,4168,194677,98263,96414,1369,1369,0,,,19/1/2022 7:23
18/8/2021,Rayong,333,13700,748943,367783,381160,18635,18409,226,55,34,19/1/2022 7:23
18/8/2021,Ratchaburi,397,10681,869099,422558,446541,7187,7187,0,,,19/1/2022 7:23
18/8/2021,Roi Et,283,8992,1296428,642234,654194,2700,2700,0,,,19/1/2022 7:23
18/8/2021,Lop Buri,170,8520,740487,369278,371209,7057,7028,29,,,19/1/2022 7:23
18/8/2021,Lampang,20,1863,726261,353817,372444,6862,6727,135,46,18,19/1/2022 7:23
18/8/2021,Lamphun,24,911,401525,192998,208527,7455,7381,74,,,19/1/2022 7:23
18/8/2021,Si Sa Ket,471,9711,1456985,725190,731795,3838,3838,0,,,19/1/2022 7:23
18/8/2021,Sakon Nakhon,126,5163,1146507,569654,576853,4675,4675,0,,,19/1/2022 7:23
18/8/2021,Songkhla,230,17316,1430543,696923,733620,1132,1132,0,61,30,19/1/2022 7:23
18/8/2021,Satun,8,1038,324496,161423,163073,1183,1170,13,45,25,19/1/2022 7:23
18/8/2021,Samut Prakarn,1335,65052,1355823,645868,709955,1887,1860,27,,,19/1/2022 7:23
18/8/2021,Samut Songkhram,199,5908,191276,91338,99938,4546,4546,0,24,17,19/1/2022 7:23
18/8/2021,Samut Sakhon,1820,76279,585685,282240,303445,1338,1338,0,51,36,19/1/2022 7:23
18/8/2021,Saraburi,204,15345,643873,316304,327569,9794,9776,18,102,63,19/1/2022 7:23
18/8/2021,Sa kaeo,216,7243,561509,280362,281147,2377,2377,0,51,23,19/1/2022 7:23
18/8/2021,Sing Buri,32,1659,205088,97428,107660,3064,3064,0,,,19/1/2022 7:23
18/8/2021,Suphan Buri,106,8831,836435,403512,432923,6542,6542,0,,,19/1/2022 7:23
18/8/2021,Surat Thani,116,4908,1071496,527024,544472,4790,4115,675,65,29,19/1/2022 7:23
18/8/2021,Surin,212,9043,1376723,684837,691886,8153,8131,22,,,19/1/2022 7:23
18/8/2021,Sukhothai,90,3866,585851,283686,302165,4868,4868,0,,,19/1/2022 7:23
18/8/2021,Nong Khai,33,1882,516896,256327,260569,6520,6513,7,38,15,19/1/2022 7:23
18/8/2021,Nong Bua Lam Phu,69,2603,508942,253805,255137,1487,1487,0,,,19/1/2022 7:23
18/8/2021,Amnat Charoen,29,2072,376228,187133,189095,1440,1440,0,,,19/1/2022 7:23
18/8/2021,Udon Thani,72,7743,1566940,776022,790918,9291,9282,9,,,19/1/2022 7:23
18/8/2021,Uttaradit,51,2620,447089,217944,229145,6329,6329,0,,,19/1/2022 7:23
18/8/2021,Uthai Thani,45,2141,325254,158926,166328,2279,2279,0,,,19/1/2022 7:23
18/8/2021,Ubon Ratchathani,234,11799,1867365,932174,935191,7252,7252,0,61,18,19/1/2022 7:23
18/8/2021,Ang Thong,94,6656,275476,131801,143675,962,962,0,,,19/1/2022 7:23
18/8/2021,Chiang Rai,40,2524,1297168,630483,666685,28142,27897,245,23,5,19/1/2022 7:23
18/8/2021,Chiang Mai,34,10753,1787281,863640,923641,68614,67650,964,57,26,19/1/2022 7:23
18/8/2021,Phetchaburi,110,13958,482600,232958,249642,12139,12096,43,,,19/1/2022 7:23
18/8/2021,Phetchabun,181,4166,979033,482878,496155,20292,20262,30,,,19/1/2022 7:23
18/8/2021,Loei,33,2180,638862,320119,318743,5789,5778,11,38,20,19/1/2022 7:23
18/8/2021,Phrae,10,1162,435481,209872,225609,5872,5872,0,43,15,19/1/2022 7:23
18/8/2021,Mae Hong Son,1,239,285778,144757,141021,8861,8659,202,13,4,19/1/2022 7:23
18/8/2021,,0,153,,,,,,,,,19/1/2022 7:23
19/8/2021,Krabi,13,1392,478664,237717,240947,2096,1981,115,,,19/1/2022 7:23
19/8/2021,Bangkok,4410,258105,5544789,2601856,2942933,202959,181431,21528,49,30,19/1/2022 7:23
19/8/2021,Kanchanaburi,244,8889,893129,447919,445210,20185,20157,28,32,18,19/1/2022 7:23
19/8/2021,Kalasin,101,6004,976083,482351,493732,2306,2306,0,,,19/1/2022 7:23
19/8/2021,Kamphaeng Phet,89,4905,712600,351801,360799,6769,6769,0,,,19/1/2022 7:23
19/8/2021,Khon Kaen,221,8414,1791967,880624,911343,21098,21098,0,74,38,19/1/2022 7:23
19/8/2021,Chanthaburi,116,4708,536132,262097,274035,17881,17815,66,,,19/1/2022 7:23
19/8/2021,Chachoengsao,472,21326,722615,354177,368438,1995,1995,0,69,35,19/1/2022 7:23
19/8/2021,Chon Buri,1339,52987,1580389,771364,809025,30270,29695,575,60,33,19/1/2022 7:23
19/8/2021,Chai Nat,40,1659,321015,154292,166723,4171,4171,0,,,19/1/2022 7:23
19/8/2021,Chaiyaphum,111,6509,1122780,554646,568134,13695,13682,13,,,19/1/2022 7:23
19/8/2021,Chumphon,124,2657,509292,251346,257946,1644,1644,0,,,19/1/2022 7:23
19/8/2021,Trang,97,3566,639931,312837,327094,2469,2469,0,,,19/1/2022 7:23
19/8/2021,Trat,18,1464,228459,112922,115537,22368,22277,91,,,19/1/2022 7:23
19/8/2021,Tak,291,8447,674616,341111,333505,12606,12606,0,,,19/1/2022 7:23
19/8/2021,Nakhon Nayok,219,6612,259735,128303,131432,2679,2679,0,,,19/1/2022 7:23
19/8/2021,Nakhon Pathom,644,22900,921500,442584,478916,2714,2714,0,37,29,19/1/2022 7:23
19/8/2021,Nakhon Phanom,63,3947,717048,357194,359854,3548,3548,0,,,19/1/2022 7:23
19/8/2021,Nakhon Ratchasima,639,12621,2633733,1293977,1339756,88532,87939,593,62,31,19/1/2022 7:23
19/8/2021,Nakhon Si Thammarat,170,5954,1549496,764523,784973,7996,7996,0,,,19/1/2022 7:23
19/8/2021,Nakhon Sawan,101,6960,1036534,505545,530989,15946,15946,0,61,32,19/1/2022 7:23
19/8/2021,Nonthaburi,503,46796,1285013,597870,687143,2822,2815,7,44,20,19/1/2022 7:23
19/8/2021,Narathiwat,228,10417,808758,400002,408756,421,421,0,39,24,19/1/2022 7:23
19/8/2021,Nan,36,1928,475941,238073,237868,9832,9798,34,,,19/1/2022 7:23
19/8/2021,Bueng Kan,30,1406,421931,211488,210443,2114,2114,0,,,19/1/2022 7:23
19/8/2021,Buri Ram,314,9251,1579709,783665,796044,12087,12044,43,,,19/1/2022 7:23
19/8/2021,Pathum Thani,459,29999,1185082,561507,623575,1319,1306,13,52,43,19/1/2022 7:23
19/8/2021,Prachuap Khiri Khan,74,6778,552888,274321,278567,13974,13921,53,,,19/1/2022 7:23
19/8/2021,Prachin Buri,233,6159,494505,244150,250355,3143,3143,0,76,37,19/1/2022 7:23
19/8/2021,Pattani,136,13558,728801,359974,368827,517,517,0,,,19/1/2022 7:23
19/8/2021,Phra Nakhon Si Ayutthaya,424,16423,819892,393788,426104,17000,16958,42,58,57,19/1/2022 7:23
19/8/2021,Phayao,13,1410,465390,226498,238892,9277,9277,0,28,13,19/1/2022 7:23
19/8/2021,Phang-nga,51,925,268269,133881,134388,7037,5969,1068,,,19/1/2022 7:23
19/8/2021,Phatthalung,40,2208,522612,254531,268081,1598,1598,0,,,19/1/2022 7:23
19/8/2021,Phichit,54,2823,530258,258492,271766,6914,6914,0,,,19/1/2022 7:23
19/8/2021,Phitsanulok,171,3169,847684,414983,432701,25715,25564,151,,,19/1/2022 7:23
19/8/2021,Phuket,91,2478,418055,197662,220393,33530,18204,15326,53,23,19/1/2022 7:23
19/8/2021,Maha Sarakham,194,7629,949783,465624,484159,2772,2772,0,,,19/1/2022 7:23
19/8/2021,Mukdahan,40,1661,351259,175474,175785,5322,5322,0,,,19/1/2022 7:23
19/8/2021,Yala,170,10109,541494,269636,271858,438,438,0,43,18,19/1/2022 7:23
19/8/2021,Yasothon,46,3785,533506,266189,267317,1561,1561,0,,,19/1/2022 7:23
19/8/2021,Ranong,180,4348,194677,98263,96414,1369,1369,0,,,19/1/2022 7:23
19/8/2021,Rayong,338,14038,748943,367783,381160,18635,18409,226,63,32,19/1/2022 7:23
19/8/2021,Ratchaburi,585,11266,869099,422558,446541,7187,7187,0,,,19/1/2022 7:23
19/8/2021,Roi Et,249,9241,1296428,642234,654194,2700,2700,0,,,19/1/2022 7:23
19/8/2021,Lop Buri,232,8752,740487,369278,371209,7057,7028,29,,,19/1/2022 7:23
19/8/2021,Lampang,25,1888,726261,353817,372444,6862,6727,135,55,16,19/1/2022 7:23
19/8/2021,Lamphun,31,942,401525,192998,208527,7455,7381,74,,,19/1/2022 7:23
19/8/2021,Si Sa Ket,374,10085,1456985,725190,731795,3838,3838,0,,,19/1/2022 7:23
19/8/2021,Sakon Nakhon,192,5355,1146507,569654,576853,4675,4675,0,,,19/1/2022 7:23
19/8/2021,Songkhla,222,17538,1430543,696923,733620,1132,1132,0,58,26,19/1/2022 7:23
19/8/2021,Satun,27,1065,324496,161423,163073,1183,1170,13,46,27,19/1/2022 7:23
19/8/2021,Samut Prakarn,937,65989,1355823,645868,709955,1887,1860,27,,,19/1/2022 7:23
19/8/2021,Samut Songkhram,218,6126,191276,91338,99938,4546,4546,0,34,18,19/1/2022 7:23
19/8/2021,Samut Sakhon,1739,78018,585685,282240,303445,1338,1338,0,67,43,19/1/2022 7:23
19/8/2021,Saraburi,481,15826,643873,316304,327569,9794,9776,18,83,80,19/1/2022 7:23
19/8/2021,Sa kaeo,258,7501,561509,280362,281147,2377,2377,0,56,19,19/1/2022 7:23
19/8/2021,Sing Buri,54,1713,205088,97428,107660,3064,3064,0,,,19/1/2022 7:23
19/8/2021,Suphan Buri,118,8949,836435,403512,432923,6542,6542,0,,,19/1/2022 7:23
19/8/2021,Surat Thani,132,5040,1071496,527024,544472,4790,4115,675,72,25,19/1/2022 7:23
19/8/2021,Surin,258,9301,1376723,684837,691886,8153,8131,22,,,19/1/2022 7:23
19/8/2021,Sukhothai,65,3931,585851,283686,302165,4868,4868,0,,,19/1/2022 7:23
19/8/2021,Nong Khai,45,1927,516896,256327,260569,6520,6513,7,36,15,19/1/2022 7:23
19/8/2021,Nong Bua Lam Phu,75,2678,508942,253805,255137,1487,1487,0,,,19/1/2022 7:23
19/8/2021,Amnat Charoen,63,2135,376228,187133,189095,1440,1440,0,,,19/1/2022 7:23
19/8/2021,Udon Thani,155,7898,1566940,776022,790918,9291,9282,9,,,19/1/2022 7:23
19/8/2021,Uttaradit,56,2676,447089,217944,229145,6329,6329,0,,,19/1/2022 7:23
19/8/2021,Uthai Thani,47,2188,325254,158926,166328,2279,2279,0,,,19/1/2022 7:23
19/8/2021,Ubon Ratchathani,246,12045,1867365,932174,935191,7252,7252,0,41,28,19/1/2022 7:23
19/8/2021,Ang Thong,270,6926,275476,131801,143675,962,962,0,,,19/1/2022 7:23
19/8/2021,Chiang Rai,38,2562,1297168,630483,666685,28142,27897,245,20,7,19/1/2022 7:23
19/8/2021,Chiang Mai,37,10790,1787281,863640,923641,68614,67650,964,54,24,19/1/2022 7:23
19/8/2021,Phetchaburi,80,14038,482600,232958,249642,12139,12096,43,,,19/1/2022 7:23
19/8/2021,Phetchabun,142,4308,979033,482878,496155,20292,20262,30,,,19/1/2022 7:23
19/8/2021,Loei,52,2232,638862,320119,318743,5789,5778,11,39,19,19/1/2022 7:23
19/8/2021,Phrae,36,1198,435481,209872,225609,5872,5872,0,46,13,19/1/2022 7:23
19/8/2021,Mae Hong Son,16,255,285778,144757,141021,8861,8659,202,15,4,19/1/2022 7:23
19/8/2021,,0,153,,,,,,,,,19/1/2022 7:23
20/8/2021,Krabi,15,1407,478664,237717,240947,2096,1981,115,,,19/1/2022 7:23
20/8/2021,Bangkok,4193,262298,5544789,2601856,2942933,202959,181431,21528,61,27,19/1/2022 7:23
20/8/2021,Kanchanaburi,238,9127,893129,447919,445210,20185,20157,28,39,23,19/1/2022 7:23
20/8/2021,Kalasin,111,6115,976083,482351,493732,2306,2306,0,,,19/1/2022 7:23
20/8/2021,Kamphaeng Phet,209,5114,712600,351801,360799,6769,6769,0,,,19/1/2022 7:23
20/8/2021,Khon Kaen,238,8652,1791967,880624,911343,21098,21098,0,66,39,19/1/2022 7:23
20/8/2021,Chanthaburi,106,4814,536132,262097,274035,17881,17815,66,,,19/1/2022 7:23
20/8/2021,Chachoengsao,364,21690,722615,354177,368438,1995,1995,0,65,29,19/1/2022 7:23
20/8/2021,Chon Buri,1494,54481,1580389,771364,809025,30270,29695,575,57,33,19/1/2022 7:23
20/8/2021,Chai Nat,20,1679,321015,154292,166723,4171,4171,0,,,19/1/2022 7:23
20/8/2021,Chaiyaphum,163,6672,1122780,554646,568134,13695,13682,13,,,19/1/2022 7:23
20/8/2021,Chumphon,138,2795,509292,251346,257946,1644,1644,0,,,19/1/2022 7:23
20/8/2021,Trang,55,3621,639931,312837,327094,2469,2469,0,,,19/1/2022 7:23
20/8/2021,Trat,27,1491,228459,112922,115537,22368,22277,91,,,19/1/2022 7:23
20/8/2021,Tak,261,8708,674616,341111,333505,12606,12606,0,,,19/1/2022 7:23
20/8/2021,Nakhon Nayok,139,6751,259735,128303,131432,2679,2679,0,,,19/1/2022 7:23
20/8/2021,Nakhon Pathom,460,23360,921500,442584,478916,2714,2714,0,59,30,19/1/2022 7:23
20/8/2021,Nakhon Phanom,36,3983,717048,357194,359854,3548,3548,0,,,19/1/2022 7:23
20/8/2021,Nakhon Ratchasima,575,13196,2633733,1293977,1339756,88532,87939,593,66,34,19/1/2022 7:23
20/8/2021,Nakhon Si Thammarat,105,6059,1549496,764523,784973,7996,7996,0,,,19/1/2022 7:23
20/8/2021,Nakhon Sawan,116,7076,1036534,505545,530989,15946,15946,0,63,43,19/1/2022 7:23
20/8/2021,Nonthaburi,355,47151,1285013,597870,687143,2822,2815,7,41,18,19/1/2022 7:23
20/8/2021,Narathiwat,220,10637,808758,400002,408756,421,421,0,47,17,19/1/2022 7:23
20/8/2021,Nan,27,1955,475941,238073,237868,9832,9798,34,,,19/1/2022 7:23
20/8/2021,Bueng Kan,14,1420,421931,211488,210443,2114,2114,0,,,19/1/2022 7:23
20/8/2021,Buri Ram,305,9556,1579709,783665,796044,12087,12044,43,,,19/1/2022 7:23
20/8/2021,Pathum Thani,462,30461,1185082,561507,623575,1319,1306,13,81,29,19/1/2022 7:23
20/8/2021,Prachuap Khiri Khan,71,6849,552888,274321,278567,13974,13921,53,,,19/1/2022 7:23
20/8/2021,Prachin Buri,280,6439,494505,244150,250355,3143,3143,0,76,26,19/1/2022 7:23
20/8/2021,Pattani,149,13707,728801,359974,368827,517,517,0,,,19/1/2022 7:23
20/8/2021,Phra Nakhon Si Ayutthaya,453,16876,819892,393788,426104,17000,16958,42,85,48,19/1/2022 7:23
20/8/2021,Phayao,15,1425,465390,226498,238892,9277,9277,0,27,17,19/1/2022 7:23
20/8/2021,Phang-nga,18,943,268269,133881,134388,7037,5969,1068,,,19/1/2022 7:23
20/8/2021,Phatthalung,30,2238,522612,254531,268081,1598,1598,0,,,19/1/2022 7:23
20/8/2021,Phichit,63,2886,530258,258492,271766,6914,6914,0,,,19/1/2022 7:23
20/8/2021,Phitsanulok,69,3238,847684,414983,432701,25715,25564,151,,,19/1/2022 7:23
20/8/2021,Phuket,131,2609,418055,197662,220393,33530,18204,15326,50,21,19/1/2022 7:23
20/8/2021,Maha Sarakham,124,7753,949783,465624,484159,2772,2772,0,,,19/1/2022 7:23
20/8/2021,Mukdahan,17,1678,351259,175474,175785,5322,5322,0,,,19/1/2022 7:23
20/8/2021,Yala,160,10269,541494,269636,271858,438,438,0,37,18,19/1/2022 7:23
20/8/2021,Yasothon,47,3832,533506,266189,267317,1561,1561,0,,,19/1/2022 7:23
20/8/2021,Ranong,137,4485,194677,98263,96414,1369,1369,0,,,19/1/2022 7:23
20/8/2021,Rayong,414,14452,748943,367783,381160,18635,18409,226,50,28,19/1/2022 7:23
20/8/2021,Ratchaburi,401,11667,869099,422558,446541,7187,7187,0,,,19/1/2022 7:23
20/8/2021,Roi Et,259,9500,1296428,642234,654194,2700,2700,0,,,19/1/2022 7:23
20/8/2021,Lop Buri,248,9000,740487,369278,371209,7057,7028,29,,,19/1/2022 7:23
20/8/2021,Lampang,13,1901,726261,353817,372444,6862,6727,135,50,19,19/1/2022 7:23
20/8/2021,Lamphun,18,960,401525,192998,208527,7455,7381,74,,,19/1/2022 7:23
20/8/2021,Si Sa Ket,369,10454,1456985,725190,731795,3838,3838,0,,,19/1/2022 7:23
20/8/2021,Sakon Nakhon,86,5441,1146507,569654,576853,4675,4675,0,,,19/1/2022 7:23
20/8/2021,Songkhla,322,17860,1430543,696923,733620,1132,1132,0,54,33,19/1/2022 7:23
20/8/2021,Satun,14,1079,324496,161423,163073,1183,1170,13,49,23,19/1/2022 7:23
20/8/2021,Samut Prakarn,1055,67044,1355823,645868,709955,1887,1860,27,,,19/1/2022 7:23
20/8/2021,Samut Songkhram,237,6363,191276,91338,99938,4546,4546,0,40,15,19/1/2022 7:23
20/8/2021,Samut Sakhon,1562,79580,585685,282240,303445,1338,1338,0,75,37,19/1/2022 7:23
20/8/2021,Saraburi,494,16320,643873,316304,327569,9794,9776,18,88,63,19/1/2022 7:23
20/8/2021,Sa kaeo,156,7657,561509,280362,281147,2377,2377,0,44,16,19/1/2022 7:23
20/8/2021,Sing Buri,45,1758,205088,97428,107660,3064,3064,0,,,19/1/2022 7:23
20/8/2021,Suphan Buri,147,9096,836435,403512,432923,6542,6542,0,,,19/1/2022 7:23
20/8/2021,Surat Thani,132,5172,1071496,527024,544472,4790,4115,675,64,24,19/1/2022 7:23
20/8/2021,Surin,291,9592,1376723,684837,691886,8153,8131,22,,,19/1/2022 7:23
20/8/2021,Sukhothai,69,4000,585851,283686,302165,4868,4868,0,,,19/1/2022 7:23
20/8/2021,Nong Khai,74,2001,516896,256327,260569,6520,6513,7,38,16,19/1/2022 7:23
20/8/2021,Nong Bua Lam Phu,45,2723,508942,253805,255137,1487,1487,0,,,19/1/2022 7:23
20/8/2021,Amnat Charoen,40,2175,376228,187133,189095,1440,1440,0,,,19/1/2022 7:23
20/8/2021,Udon Thani,186,8084,1566940,776022,790918,9291,9282,9,,,19/1/2022 7:23
20/8/2021,Uttaradit,43,2719,447089,217944,229145,6329,6329,0,,,19/1/2022 7:23
20/8/2021,Uthai Thani,95,2283,325254,158926,166328,2279,2279,0,,,19/1/2022 7:23
20/8/2021,Ubon Ratchathani,170,12215,1867365,932174,935191,7252,7252,0,63,20,19/1/2022 7:23
20/8/2021,Ang Thong,207,7133,275476,131801,143675,962,962,0,,,19/1/2022 7:23
20/8/2021,Chiang Rai,50,2612,1297168,630483,666685,28142,27897,245,24,11,19/1/2022 7:23
20/8/2021,Chiang Mai,41,10831,1787281,863640,923641,68614,67650,964,51,26,19/1/2022 7:23
20/8/2021,Phetchaburi,119,14157,482600,232958,249642,12139,12096,43,,,19/1/2022 7:23
20/8/2021,Phetchabun,166,4474,979033,482878,496155,20292,20262,30,,,19/1/2022 7:23
20/8/2021,Loei,41,2273,638862,320119,318743,5789,5778,11,41,21,19/1/2022 7:23
20/8/2021,Phrae,31,1229,435481,209872,225609,5872,5872,0,34,20,19/1/2022 7:23
20/8/2021,Mae Hong Son,1,256,285778,144757,141021,8861,8659,202,20,6,19/1/2022 7:23
20/8/2021,,0,153,,,,,,,,,19/1/2022 7:23
21/8/2021,Krabi,7,1414,478664,237717,240947,2096,1981,115,,,19/1/2022 7:23
21/8/2021,Bangkok,4370,266668,5544789,2601856,2942933,202959,181431,21528,55,25,19/1/2022 7:23
21/8/2021,Kanchanaburi,436,9563,893129,447919,445210,20185,20157,28,48,12,19/1/2022 7:23
21/8/2021,Kalasin,111,6226,976083,482351,493732,2306,2306,0,,,19/1/2022 7:23
21/8/2021,Kamphaeng Phet,77,5191,712600,351801,360799,6769,6769,0,,,19/1/2022 7:23
21/8/2021,Khon Kaen,273,8925,1791967,880624,911343,21098,21098,0,73,42,19/1/2022 7:23
21/8/2021,Chanthaburi,129,4943,536132,262097,274035,17881,17815,66,,,19/1/2022 7:23
21/8/2021,Chachoengsao,587,22277,722615,354177,368438,1995,1995,0,60,28,19/1/2022 7:23
21/8/2021,Chon Buri,1239,55720,1580389,771364,809025,30270,29695,575,56,24,19/1/2022 7:23
21/8/2021,Chai Nat,31,1710,321015,154292,166723,4171,4171,0,,,19/1/2022 7:23
21/8/2021,Chaiyaphum,203,6875,1122780,554646,568134,13695,13682,13,,,19/1/2022 7:23
21/8/2021,Chumphon,195,2990,509292,251346,257946,1644,1644,0,,,19/1/2022 7:23
21/8/2021,Trang,43,3664,639931,312837,327094,2469,2469,0,,,19/1/2022 7:23
21/8/2021,Trat,27,1518,228459,112922,115537,22368,22277,91,,,19/1/2022 7:23
21/8/2021,Tak,221,8929,674616,341111,333505,12606,12606,0,,,19/1/2022 7:23
21/8/2021,Nakhon Nayok,158,6909,259735,128303,131432,2679,2679,0,,,19/1/2022 7:23
21/8/2021,Nakhon Pathom,590,23950,921500,442584,478916,2714,2714,0,64,16,19/1/2022 7:23
21/8/2021,Nakhon Phanom,75,4058,717048,357194,359854,3548,3548,0,,,19/1/2022 7:23
21/8/2021,Nakhon Ratchasima,613,13809,2633733,1293977,1339756,88532,87939,593,78,24,19/1/2022 7:23
21/8/2021,Nakhon Si Thammarat,142,6201,1549496,764523,784973,7996,7996,0,,,19/1/2022 7:23
21/8/2021,Nakhon Sawan,110,7186,1036534,505545,530989,15946,15946,0,81,34,19/1/2022 7:23
21/8/2021,Nonthaburi,325,47476,1285013,597870,687143,2822,2815,7,39,16,19/1/2022 7:23
21/8/2021,Narathiwat,365,11002,808758,400002,408756,421,421,0,29,15,19/1/2022 7:23
21/8/2021,Nan,47,2002,475941,238073,237868,9832,9798,34,,,19/1/2022 7:23
21/8/2021,Bueng Kan,55,1475,421931,211488,210443,2114,2114,0,,,19/1/2022 7:23
21/8/2021,Buri Ram,450,10006,1579709,783665,796044,12087,12044,43,,,19/1/2022 7:23
21/8/2021,Pathum Thani,326,30787,1185082,561507,623575,1319,1306,13,60,28,19/1/2022 7:23
21/8/2021,Prachuap Khiri Khan,167,7016,552888,274321,278567,13974,13921,53,,,19/1/2022 7:23
21/8/2021,Prachin Buri,202,6641,494505,244150,250355,3143,3143,0,58,21,19/1/2022 7:23
21/8/2021,Pattani,181,13888,728801,359974,368827,517,517,0,,,19/1/2022 7:23
21/8/2021,Phra Nakhon Si Ayutthaya,409,17285,819892,393788,426104,17000,16958,42,73,43,19/1/2022 7:23
21/8/2021,Phayao,16,1441,465390,226498,238892,9277,9277,0,37,17,19/1/2022 7:23
21/8/2021,Phang-nga,12,955,268269,133881,134388,7037,5969,1068,,,19/1/2022 7:23
21/8/2021,Phatthalung,57,2295,522612,254531,268081,1598,1598,0,,,19/1/2022 7:23
21/8/2021,Phichit,44,2930,530258,258492,271766,6914,6914,0,,,19/1/2022 7:23
21/8/2021,Phitsanulok,66,3304,847684,414983,432701,25715,25564,151,,,19/1/2022 7:23
21/8/2021,Phuket,103,2712,418055,197662,220393,33530,18204,15326,46,20,19/1/2022 7:23
21/8/2021,Maha Sarakham,103,7856,949783,465624,484159,2772,2772,0,,,19/1/2022 7:23
21/8/2021,Mukdahan,14,1692,351259,175474,175785,5322,5322,0,,,19/1/2022 7:23
21/8/2021,Yala,145,10414,541494,269636,271858,438,438,0,38,16,19/1/2022 7:23
21/8/2021,Yasothon,85,3917,533506,266189,267317,1561,1561,0,,,19/1/2022 7:23
21/8/2021,Ranong,130,4615,194677,98263,96414,1369,1369,0,,,19/1/2022 7:23
21/8/2021,Rayong,247,14699,748943,367783,381160,18635,18409,226,35,29,19/1/2022 7:23
21/8/2021,Ratchaburi,541,12208,869099,422558,446541,7187,7187,0,,,19/1/2022 7:23
21/8/2021,Roi Et,249,9749,1296428,642234,654194,2700,2700,0,,,19/1/2022 7:23
21/8/2021,Lop Buri,193,9193,740487,369278,371209,7057,7028,29,,,19/1/2022 7:23
21/8/2021,Lampang,14,1915,726261,353817,372444,6862,6727,135,56,18,19/1/2022 7:23
21/8/2021,Lamphun,24,984,401525,192998,208527,7455,7381,74,,,19/1/2022 7:23
21/8/2021,Si Sa Ket,300,10754,1456985,725190,731795,3838,3838,0,,,19/1/2022 7:23
21/8/2021,Sakon Nakhon,104,5545,1146507,569654,576853,4675,4675,0,,,19/1/2022 7:23
21/8/2021,Songkhla,242,18102,1430543,696923,733620,1132,1132,0,77,24,19/1/2022 7:23
21/8/2021,Satun,21,1100,324496,161423,163073,1183,1170,13,44,25,19/1/2022 7:23
21/8/2021,Samut Prakarn,1584,68628,1355823,645868,709955,1887,1860,27,,,19/1/2022 7:23
21/8/2021,Samut Songkhram,154,6517,191276,91338,99938,4546,4546,0,35,18,19/1/2022 7:23
21/8/2021,Samut Sakhon,1449,81029,585685,282240,303445,1338,1338,0,65,30,19/1/2022 7:23
21/8/2021,Saraburi,385,16705,643873,316304,327569,9794,9776,18,83,55,19/1/2022 7:23
21/8/2021,Sa kaeo,230,7887,561509,280362,281147,2377,2377,0,34,14,19/1/2022 7:23
21/8/2021,Sing Buri,25,1783,205088,97428,107660,3064,3064,0,,,19/1/2022 7:23
21/8/2021,Suphan Buri,132,9228,836435,403512,432923,6542,6542,0,,,19/1/2022 7:23
21/8/2021,Surat Thani,155,5327,1071496,527024,544472,4790,4115,675,62,22,19/1/2022 7:23
21/8/2021,Surin,269,9861,1376723,684837,691886,8153,8131,22,,,19/1/2022 7:23
21/8/2021,Sukhothai,61,4061,585851,283686,302165,4868,4868,0,,,19/1/2022 7:23
21/8/2021,Nong Khai,27,2028,516896,256327,260569,6520,6513,7,41,13,19/1/2022 7:23
21/8/2021,Nong Bua Lam Phu,103,2826,508942,253805,255137,1487,1487,0,,,19/1/2022 7:23
21/8/2021,Amnat Charoen,33,2208,376228,187133,189095,1440,1440,0,,,19/1/2022 7:23
21/8/2021,Udon Thani,241,8325,1566940,776022,790918,9291,9282,9,,,19/1/2022 7:23
21/8/2021,Uttaradit,49,2768,447089,217944,229145,6329,6329,0,,,19/1/2022 7:23
21/8/2021,Uthai Thani,38,2321,325254,158926,166328,2279,2279,0,,,19/1/2022 7:23
21/8/2021,Ubon Ratchathani,212,12427,1867365,932174,935191,7252,7252,0,47,25,19/1/2022 7:23
21/8/2021,Ang Thong,155,7288,275476,131801,143675,962,962,0,,,19/1/2022 7:23
21/8/2021,Chiang Rai,55,2667,1297168,630483,666685,28142,27897,245,39,10,19/1/2022 7:23
21/8/2021,Chiang Mai,51,10882,1787281,863640,923641,68614,67650,964,55,25,19/1/2022 7:23
21/8/2021,Phetchaburi,108,14265,482600,232958,249642,12139,12096,43,,,19/1/2022 7:23
21/8/2021,Phetchabun,133,4607,979033,482878,496155,20292,20262,30,,,19/1/2022 7:23
21/8/2021,Loei,23,2296,638862,320119,318743,5789,5778,11,49,23,19/1/2022 7:23
21/8/2021,Phrae,23,1252,435481,209872,225609,5872,5872,0,52,25,19/1/2022 7:23
21/8/2021,Mae Hong Son,2,258,285778,144757,141021,8861,8659,202,24,10,19/1/2022 7:23
21/8/2021,,0,153,,,,,,,,,19/1/2022 7:23
22/8/2021,Krabi,22,1436,478664,237717,240947,2096,1981,115,,,19/1/2022 7:23
22/8/2021,Bangkok,4405,271073,5544789,2601856,2942933,202959,181431,21528,55,21,19/1/2022 7:23
22/8/2021,Kanchanaburi,223,9786,893129,447919,445210,20185,20157,28,33,10,19/1/2022 7:23
22/8/2021,Kalasin,114,6340,976083,482351,493732,2306,2306,0,,,19/1/2022 7:23
22/8/2021,Kamphaeng Phet,71,5262,712600,351801,360799,6769,6769,0,,,19/1/2022 7:23
22/8/2021,Khon Kaen,142,9067,1791967,880624,911343,21098,21098,0,81,41,19/1/2022 7:23
22/8/2021,Chanthaburi,119,5062,536132,262097,274035,17881,17815,66,,,19/1/2022 7:23
22/8/2021,Chachoengsao,488,22765,722615,354177,368438,1995,1995,0,50,30,19/1/2022 7:23
22/8/2021,Chon Buri,1095,56815,1580389,771364,809025,30270,29695,575,52,24,19/1/2022 7:23
22/8/2021,Chai Nat,37,1747,321015,154292,166723,4171,4171,0,,,19/1/2022 7:23
22/8/2021,Chaiyaphum,122,6997,1122780,554646,568134,13695,13682,13,,,19/1/2022 7:23
22/8/2021,Chumphon,184,3174,509292,251346,257946,1644,1644,0,,,19/1/2022 7:23
22/8/2021,Trang,22,3686,639931,312837,327094,2469,2469,0,,,19/1/2022 7:23
22/8/2021,Trat,29,1547,228459,112922,115537,22368,22277,91,,,19/1/2022 7:23
22/8/2021,Tak,164,9093,674616,341111,333505,12606,12606,0,,,19/1/2022 7:23
22/8/2021,Nakhon Nayok,132,7041,259735,128303,131432,2679,2679,0,,,19/1/2022 7:23
22/8/2021,Nakhon Pathom,638,24588,921500,442584,478916,2714,2714,0,41,13,19/1/2022 7:23
22/8/2021,Nakhon Phanom,52,4110,717048,357194,359854,3548,3548,0,,,19/1/2022 7:23
22/8/2021,Nakhon Ratchasima,484,14293,2633733,1293977,1339756,88532,87939,593,63,25,19/1/2022 7:23
22/8/2021,Nakhon Si Thammarat,168,6369,1549496,764523,784973,7996,7996,0,,,19/1/2022 7:23
22/8/2021,Nakhon Sawan,90,7276,1036534,505545,530989,15946,15946,0,67,34,19/1/2022 7:23
22/8/2021,Nonthaburi,696,48172,1285013,597870,687143,2822,2815,7,29,13,19/1/2022 7:23
22/8/2021,Narathiwat,305,11307,808758,400002,408756,421,421,0,29,21,19/1/2022 7:23
22/8/2021,Nan,15,2017,475941,238073,237868,9832,9798,34,,,19/1/2022 7:23
22/8/2021,Bueng Kan,9,1484,421931,211488,210443,2114,2114,0,,,19/1/2022 7:23
22/8/2021,Buri Ram,374,10380,1579709,783665,796044,12087,12044,43,,,19/1/2022 7:23
22/8/2021,Pathum Thani,385,31172,1185082,561507,623575,1319,1306,13,57,18,19/1/2022 7:23
22/8/2021,Prachuap Khiri Khan,75,7091,552888,274321,278567,13974,13921,53,,,19/1/2022 7:23
22/8/2021,Prachin Buri,209,6850,494505,244150,250355,3143,3143,0,55,27,19/1/2022 7:23
22/8/2021,Pattani,156,14044,728801,359974,368827,517,517,0,,,19/1/2022 7:23
22/8/2021,Phra Nakhon Si Ayutthaya,389,17674,819892,393788,426104,17000,16958,42,60,38,19/1/2022 7:23
22/8/2021,Phayao,25,1466,465390,226498,238892,9277,9277,0,42,18,19/1/2022 7:23
22/8/2021,Phang-nga,13,968,268269,133881,134388,7037,5969,1068,,,19/1/2022 7:23
22/8/2021,Phatthalung,17,2312,522612,254531,268081,1598,1598,0,,,19/1/2022 7:23
22/8/2021,Phichit,75,3005,530258,258492,271766,6914,6914,0,,,19/1/2022 7:23
22/8/2021,Phitsanulok,31,3335,847684,414983,432701,25715,25564,151,,,19/1/2022 7:23
22/8/2021,Phuket,129,2841,418055,197662,220393,33530,18204,15326,47,19,19/1/2022 7:23
22/8/2021,Maha Sarakham,141,7997,949783,465624,484159,2772,2772,0,,,19/1/2022 7:23
22/8/2021,Mukdahan,25,1717,351259,175474,175785,5322,5322,0,,,19/1/2022 7:23
22/8/2021,Yala,152,10566,541494,269636,271858,438,438,0,35,16,19/1/2022 7:23
22/8/2021,Yasothon,48,3965,533506,266189,267317,1561,1561,0,,,19/1/2022 7:23
22/8/2021,Ranong,150,4765,194677,98263,96414,1369,1369,0,,,19/1/2022 7:23
22/8/2021,Rayong,307,15006,748943,367783,381160,18635,18409,226,38,26,19/1/2022 7:23
22/8/2021,Ratchaburi,560,12768,869099,422558,446541,7187,7187,0,,,19/1/2022 7:23
22/8/2021,Roi Et,285,10034,1296428,642234,654194,2700,2700,0,,,19/1/2022 7:23
22/8/2021,Lop Buri,213,9406,740487,369278,371209,7057,7028,29,,,19/1/2022 7:23
22/8/2021,Lampang,9,1924,726261,353817,372444,6862,6727,135,53,17,19/1/2022 7:23
22/8/2021,Lamphun,32,1016,401525,192998,208527,7455,7381,74,,,19/1/2022 7:23
22/8/2021,Si Sa Ket,320,11074,1456985,725190,731795,3838,3838,0,,,19/1/2022 7:23
22/8/2021,Sakon Nakhon,68,5613,1146507,569654,576853,4675,4675,0,,,19/1/2022 7:23
22/8/2021,Songkhla,240,18342,1430543,696923,733620,1132,1132,0,48,27,19/1/2022 7:23
22/8/2021,Satun,37,1137,324496,161423,163073,1183,1170,13,44,21,19/1/2022 7:23
22/8/2021,Samut Prakarn,749,69377,1355823,645868,709955,1887,1860,27,,,19/1/2022 7:23
22/8/2021,Samut Songkhram,148,6665,191276,91338,99938,4546,4546,0,36,13,19/1/2022 7:23
22/8/2021,Samut Sakhon,1499,82528,585685,282240,303445,1338,1338,0,61,33,19/1/2022 7:23
22/8/2021,Saraburi,390,17095,643873,316304,327569,9794,9776,18,68,51,19/1/2022 7:23
22/8/2021,Sa kaeo,97,7984,561509,280362,281147,2377,2377,0,36,15,19/1/2022 7:23
22/8/2021,Sing Buri,24,1807,205088,97428,107660,3064,3064,0,,,19/1/2022 7:23
22/8/2021,Suphan Buri,178,9406,836435,403512,432923,6542,6542,0,,,19/1/2022 7:23
22/8/2021,Surat Thani,155,5482,1071496,527024,544472,4790,4115,675,58,23,19/1/2022 7:23
22/8/2021,Surin,328,10189,1376723,684837,691886,8153,8131,22,,,19/1/2022 7:23
22/8/2021,Sukhothai,65,4126,585851,283686,302165,4868,4868,0,,,19/1/2022 7:23
22/8/2021,Nong Khai,40,2068,516896,256327,260569,6520,6513,7,32,11,19/1/2022 7:23
22/8/2021,Nong Bua Lam Phu,75,2901,508942,253805,255137,1487,1487,0,,,19/1/2022 7:23
22/8/2021,Amnat Charoen,35,2243,376228,187133,189095,1440,1440,0,,,19/1/2022 7:23
22/8/2021,Udon Thani,98,8423,1566940,776022,790918,9291,9282,9,,,19/1/2022 7:23
22/8/2021,Uttaradit,39,2807,447089,217944,229145,6329,6329,0,,,19/1/2022 7:23
22/8/2021,Uthai Thani,57,2378,325254,158926,166328,2279,2279,0,,,19/1/2022 7:23
22/8/2021,Ubon Ratchathani,247,12674,1867365,932174,935191,7252,7252,0,62,23,19/1/2022 7:23
22/8/2021,Ang Thong,87,7375,275476,131801,143675,962,962,0,,,19/1/2022 7:23
22/8/2021,Chiang Rai,40,2707,1297168,630483,666685,28142,27897,245,34,10,19/1/2022 7:23
22/8/2021,Chiang Mai,35,10917,1787281,863640,923641,68614,67650,964,51,27,19/1/2022 7:23
22/8/2021,Phetchaburi,111,14376,482600,232958,249642,12139,12096,43,,,19/1/2022 7:23
22/8/2021,Phetchabun,172,4779,979033,482878,496155,20292,20262,30,,,19/1/2022 7:23
22/8/2021,Loei,43,2339,638862,320119,318743,5789,5778,11,57,26,19/1/2022 7:23
22/8/2021,Phrae,10,1262,435481,209872,225609,5872,5872,0,63,22,19/1/2022 7:23
22/8/2021,Mae Hong Son,1,259,285778,144757,141021,8861,8659,202,35,9,19/1/2022 7:23
22/8/2021,,0,153,,,,,,,,,19/1/2022 7:23
23/8/2021,Krabi,15,1451,478664,237717,240947,2096,1981,115,,,19/1/2022 7:23
23/8/2021,Bangkok,3497,274570,5544789,2601856,2942933,202959,181431,21528,42,22,19/1/2022 7:23
23/8/2021,Kanchanaburi,277,10063,893129,447919,445210,20185,20157,28,37,8,19/1/2022 7:23
23/8/2021,Kalasin,60,6400,976083,482351,493732,2306,2306,0,,,19/1/2022 7:23
23/8/2021,Kamphaeng Phet,175,5437,712600,351801,360799,6769,6769,0,,,19/1/2022 7:23
23/8/2021,Khon Kaen,141,9208,1791967,880624,911343,21098,21098,0,77,37,19/1/2022 7:23
23/8/2021,Chanthaburi,70,5132,536132,262097,274035,17881,17815,66,,,19/1/2022 7:23
23/8/2021,Chachoengsao,310,23075,722615,354177,368438,1995,1995,0,49,27,19/1/2022 7:23
23/8/2021,Chon Buri,1025,57840,1580389,771364,809025,30270,29695,575,40, ,19/1/2022 7:23
23/8/2021,Chai Nat,13,1760,321015,154292,166723,4171,4171,0,,,19/1/2022 7:23
23/8/2021,Chaiyaphum,169,7166,1122780,554646,568134,13695,13682,13,,,19/1/2022 7:23
23/8/2021,Chumphon,115,3289,509292,251346,257946,1644,1644,0,,,19/1/2022 7:23
23/8/2021,Trang,38,3724,639931,312837,327094,2469,2469,0,,,19/1/2022 7:23
23/8/2021,Trat,42,1589,228459,112922,115537,22368,22277,91,,,19/1/2022 7:23
23/8/2021,Tak,161,9254,674616,341111,333505,12606,12606,0,,,19/1/2022 7:23
23/8/2021,Nakhon Nayok,323,7364,259735,128303,131432,2679,2679,0,,,19/1/2022 7:23
23/8/2021,Nakhon Pathom,413,25001,921500,442584,478916,2714,2714,0,30,13,19/1/2022 7:23
23/8/2021,Nakhon Phanom,25,4135,717048,357194,359854,3548,3548,0,,,19/1/2022 7:23
23/8/2021,Nakhon Ratchasima,325,14618,2633733,1293977,1339756,88532,87939,593,58,26,19/1/2022 7:23
23/8/2021,Nakhon Si Thammarat,155,6524,1549496,764523,784973,7996,7996,0,,,19/1/2022 7:23
23/8/2021,Nakhon Sawan,85,7361,1036534,505545,530989,15946,15946,0,66,37,19/1/2022 7:23
23/8/2021,Nonthaburi,781,48953,1285013,597870,687143,2822,2815,7,21,12,19/1/2022 7:23
23/8/2021,Narathiwat,246,11553,808758,400002,408756,421,421,0,49,26,19/1/2022 7:23
23/8/2021,Nan,26,2043,475941,238073,237868,9832,9798,34,,,19/1/2022 7:23
23/8/2021,Bueng Kan,25,1509,421931,211488,210443,2114,2114,0,,,19/1/2022 7:23
23/8/2021,Buri Ram,309,10689,1579709,783665,796044,12087,12044,43,,,19/1/2022 7:23
23/8/2021,Pathum Thani,214,31386,1185082,561507,623575,1319,1306,13,40,17,19/1/2022 7:23
23/8/2021,Prachuap Khiri Khan,97,7188,552888,274321,278567,13974,13921,53,,,19/1/2022 7:23
23/8/2021,Prachin Buri,139,6989,494505,244150,250355,3143,3143,0,62,29,19/1/2022 7:23
23/8/2021,Pattani,110,14154,728801,359974,368827,517,517,0,,,19/1/2022 7:23
23/8/2021,Phra Nakhon Si Ayutthaya,406,18080,819892,393788,426104,17000,16958,42,43,38,19/1/2022 7:23
23/8/2021,Phayao,19,1485,465390,226498,238892,9277,9277,0,40,11,19/1/2022 7:23
23/8/2021,Phang-nga,12,980,268269,133881,134388,7037,5969,1068,,,19/1/2022 7:23
23/8/2021,Phatthalung,49,2361,522612,254531,268081,1598,1598,0,,,19/1/2022 7:23
23/8/2021,Phichit,42,3047,530258,258492,271766,6914,6914,0,,,19/1/2022 7:23
23/8/2021,Phitsanulok,56,3391,847684,414983,432701,25715,25564,151,,,19/1/2022 7:23
23/8/2021,Phuket,125,2966,418055,197662,220393,33530,18204,15326,44,19,19/1/2022 7:23
23/8/2021,Maha Sarakham,64,8061,949783,465624,484159,2772,2772,0,,,19/1/2022 7:23
23/8/2021,Mukdahan,12,1729,351259,175474,175785,5322,5322,0,,,19/1/2022 7:23
23/8/2021,Yala,108,10674,541494,269636,271858,438,438,0,40,16,19/1/2022 7:23
23/8/2021,Yasothon,60,4025,533506,266189,267317,1561,1561,0,,,19/1/2022 7:23
23/8/2021,Ranong,140,4905,194677,98263,96414,1369,1369,0,,,19/1/2022 7:23
23/8/2021,Rayong,292,15298,748943,367783,381160,18635,18409,226,34,22,19/1/2022 7:23
23/8/2021,Ratchaburi,566,13334,869099,422558,446541,7187,7187,0,,,19/1/2022 7:23
23/8/2021,Roi Et,246,10280,1296428,642234,654194,2700,2700,0,,,19/1/2022 7:23
23/8/2021,Lop Buri,228,9634,740487,369278,371209,7057,7028,29,,,19/1/2022 7:23
23/8/2021,Lampang,8,1932,726261,353817,372444,6862,6727,135,50,16,19/1/2022 7:23
23/8/2021,Lamphun,28,1044,401525,192998,208527,7455,7381,74,,,19/1/2022 7:23
23/8/2021,Si Sa Ket,201,11275,1456985,725190,731795,3838,3838,0,,,19/1/2022 7:23
23/8/2021,Sakon Nakhon,62,5675,1146507,569654,576853,4675,4675,0,,,19/1/2022 7:23
23/8/2021,Songkhla,272,18614,1430543,696923,733620,1132,1132,0,50,26,19/1/2022 7:23
23/8/2021,Satun,21,1158,324496,161423,163073,1183,1170,13,45,20,19/1/2022 7:23
23/8/2021,Samut Prakarn,1296,70673,1355823,645868,709955,1887,1860,27,,,19/1/2022 7:23
23/8/2021,Samut Songkhram,75,6740,191276,91338,99938,4546,4546,0,29,14,19/1/2022 7:23
23/8/2021,Samut Sakhon,1396,83924,585685,282240,303445,1338,1338,0,53,29,19/1/2022 7:23
23/8/2021,Saraburi,345,17440,643873,316304,327569,9794,9776,18,68,49,19/1/2022 7:23
23/8/2021,Sa kaeo,293,8277,561509,280362,281147,2377,2377,0,38,14,19/1/2022 7:23
23/8/2021,Sing Buri,43,1850,205088,97428,107660,3064,3064,0,,,19/1/2022 7:23
23/8/2021,Suphan Buri,91,9497,836435,403512,432923,6542,6542,0,,,19/1/2022 7:23
23/8/2021,Surat Thani,82,5564,1071496,527024,544472,4790,4115,675,55,29,19/1/2022 7:23
23/8/2021,Surin,322,10511,1376723,684837,691886,8153,8131,22,,,19/1/2022 7:23
23/8/2021,Sukhothai,35,4161,585851,283686,302165,4868,4868,0,,,19/1/2022 7:23
23/8/2021,Nong Khai,25,2093,516896,256327,260569,6520,6513,7,29,12,19/1/2022 7:23
23/8/2021,Nong Bua Lam Phu,66,2967,508942,253805,255137,1487,1487,0,,,19/1/2022 7:23
23/8/2021,Amnat Charoen,37,2280,376228,187133,189095,1440,1440,0,,,19/1/2022 7:23
23/8/2021,Udon Thani,136,8559,1566940,776022,790918,9291,9282,9,,,19/1/2022 7:23
23/8/2021,Uttaradit,46,2853,447089,217944,229145,6329,6329,0,,,19/1/2022 7:23
23/8/2021,Uthai Thani,64,2442,325254,158926,166328,2279,2279,0,,,19/1/2022 7:23
23/8/2021,Ubon Ratchathani,197,12871,1867365,932174,935191,7252,7252,0,52,19,19/1/2022 7:23
23/8/2021,Ang Thong,206,7581,275476,131801,143675,962,962,0,,,19/1/2022 7:23
23/8/2021,Chiang Rai,32,2739,1297168,630483,666685,28142,27897,245,38,4,19/1/2022 7:23
23/8/2021,Chiang Mai,36,10953,1787281,863640,923641,68614,67650,964,55,25,19/1/2022 7:23
23/8/2021,Phetchaburi,66,14442,482600,232958,249642,12139,12096,43,,,19/1/2022 7:23
23/8/2021,Phetchabun,118,4897,979033,482878,496155,20292,20262,30,,,19/1/2022 7:23
23/8/2021,Loei,63,2402,638862,320119,318743,5789,5778,11,59,19,19/1/2022 7:23
23/8/2021,Phrae,22,1284,435481,209872,225609,5872,5872,0,51,20,19/1/2022 7:23
23/8/2021,Mae Hong Son,1,260,285778,144757,141021,8861,8659,202,31,10,19/1/2022 7:23
23/8/2021,,0,153,,,,,,,,,19/1/2022 7:23
24/8/2021,Krabi,18,1469,478664,237717,240947,2096,1981,115,,,19/1/2022 7:23
24/8/2021,Bangkok,4053,278623,5544789,2601856,2942933,202959,181431,21528,45,25,19/1/2022 7:23
24/8/2021,Kanchanaburi,274,10337,893129,447919,445210,20185,20157,28,19,7,19/1/2022 7:23
24/8/2021,Kalasin,100,6500,976083,482351,493732,2306,2306,0,,,19/1/2022 7:23
24/8/2021,Kamphaeng Phet,63,5500,712600,351801,360799,6769,6769,0,,,19/1/2022 7:23
24/8/2021,Khon Kaen,109,9317,1791967,880624,911343,21098,21098,0,71,32,19/1/2022 7:23
24/8/2021,Chanthaburi,65,5197,536132,262097,274035,17881,17815,66,,,19/1/2022 7:23
24/8/2021,Chachoengsao,376,23451,722615,354177,368438,1995,1995,0,40,24,19/1/2022 7:23
24/8/2021,Chon Buri,829,58669,1580389,771364,809025,30270,29695,575,,,19/1/2022 7:23
24/8/2021,Chai Nat,20,1780,321015,154292,166723,4171,4171,0,,,19/1/2022 7:23
24/8/2021,Chaiyaphum,110,7276,1122780,554646,568134,13695,13682,13,,,19/1/2022 7:23
24/8/2021,Chumphon,79,3368,509292,251346,257946,1644,1644,0,,,19/1/2022 7:23
24/8/2021,Trang,39,3763,639931,312837,327094,2469,2469,0,,,19/1/2022 7:23
24/8/2021,Trat,237,1826,228459,112922,115537,22368,22277,91,,,19/1/2022 7:23
24/8/2021,Tak,111,9365,674616,341111,333505,12606,12606,0,,,19/1/2022 7:23
24/8/2021,Nakhon Nayok,38,7402,259735,128303,131432,2679,2679,0,,,19/1/2022 7:23
24/8/2021,Nakhon Pathom,278,25279,921500,442584,478916,2714,2714,0,36,11,19/1/2022 7:23
24/8/2021,Nakhon Phanom,30,4165,717048,357194,359854,3548,3548,0,,,19/1/2022 7:23
24/8/2021,Nakhon Ratchasima,445,15063,2633733,1293977,1339756,88532,87939,593,63,19,19/1/2022 7:23
24/8/2021,Nakhon Si Thammarat,163,6687,1549496,764523,784973,7996,7996,0,,,19/1/2022 7:23
24/8/2021,Nakhon Sawan,105,7466,1036534,505545,530989,15946,15946,0,72,29,19/1/2022 7:23
24/8/2021,Nonthaburi,368,49321,1285013,597870,687143,2822,2815,7,21,14,19/1/2022 7:23
24/8/2021,Narathiwat,316,11869,808758,400002,408756,421,421,0,51,18,19/1/2022 7:23
24/8/2021,Nan,12,2055,475941,238073,237868,9832,9798,34,,,19/1/2022 7:23
24/8/2021,Bueng Kan,26,1535,421931,211488,210443,2114,2114,0,,,19/1/2022 7:23
24/8/2021,Buri Ram,331,11020,1579709,783665,796044,12087,12044,43,,,19/1/2022 7:23
24/8/2021,Pathum Thani,330,31716,1185082,561507,623575,1319,1306,13,34,30,19/1/2022 7:23
24/8/2021,Prachuap Khiri Khan,39,7227,552888,274321,278567,13974,13921,53,,,19/1/2022 7:23
24/8/2021,Prachin Buri,146,7135,494505,244150,250355,3143,3143,0,64,15,19/1/2022 7:23
24/8/2021,Pattani,257,14411,728801,359974,368827,517,517,0,,,19/1/2022 7:23
24/8/2021,Phra Nakhon Si Ayutthaya,381,18461,819892,393788,426104,17000,16958,42,44,30,19/1/2022 7:23
24/8/2021,Phayao,9,1494,465390,226498,238892,9277,9277,0,32,15,19/1/2022 7:23
24/8/2021,Phang-nga,7,987,268269,133881,134388,7037,5969,1068,,,19/1/2022 7:23
24/8/2021,Phatthalung,44,2405,522612,254531,268081,1598,1598,0,,,19/1/2022 7:23
24/8/2021,Phichit,24,3071,530258,258492,271766,6914,6914,0,,,19/1/2022 7:23
24/8/2021,Phitsanulok,32,3423,847684,414983,432701,25715,25564,151,,,19/1/2022 7:23
24/8/2021,Phuket,74,3040,418055,197662,220393,33530,18204,15326,51,22,19/1/2022 7:23
24/8/2021,Maha Sarakham,52,8113,949783,465624,484159,2772,2772,0,,,19/1/2022 7:23
24/8/2021,Mukdahan,16,1745,351259,175474,175785,5322,5322,0,,,19/1/2022 7:23
24/8/2021,Yala,110,10784,541494,269636,271858,438,438,0,39,16,19/1/2022 7:23
24/8/2021,Yasothon,45,4070,533506,266189,267317,1561,1561,0,,,19/1/2022 7:23
24/8/2021,Ranong,121,5026,194677,98263,96414,1369,1369,0,,,19/1/2022 7:23
24/8/2021,Rayong,254,15552,748943,367783,381160,18635,18409,226,29,18,19/1/2022 7:23
24/8/2021,Ratchaburi,558,13892,869099,422558,446541,7187,7187,0,,,19/1/2022 7:23
24/8/2021,Roi Et,275,10555,1296428,642234,654194,2700,2700,0,,,19/1/2022 7:23
24/8/2021,Lop Buri,178,9812,740487,369278,371209,7057,7028,29,,,19/1/2022 7:23
24/8/2021,Lampang,11,1943,726261,353817,372444,6862,6727,135,50,14,19/1/2022 7:23
24/8/2021,Lamphun,20,1064,401525,192998,208527,7455,7381,74,,,19/1/2022 7:23
24/8/2021,Si Sa Ket,223,11498,1456985,725190,731795,3838,3838,0,,,19/1/2022 7:23
24/8/2021,Sakon Nakhon,75,5750,1146507,569654,576853,4675,4675,0,,,19/1/2022 7:23
24/8/2021,Songkhla,173,18787,1430543,696923,733620,1132,1132,0,51,28,19/1/2022 7:23
24/8/2021,Satun,15,1173,324496,161423,163073,1183,1170,13,46,24,19/1/2022 7:23
24/8/2021,Samut Prakarn,1731,72404,1355823,645868,709955,1887,1860,27,,,19/1/2022 7:23
24/8/2021,Samut Songkhram,215,6955,191276,91338,99938,4546,4546,0,24,12,19/1/2022 7:23
24/8/2021,Samut Sakhon,1288,85212,585685,282240,303445,1338,1338,0,46,34,19/1/2022 7:23
24/8/2021,Saraburi,274,17714,643873,316304,327569,9794,9776,18,55,59,19/1/2022 7:23
24/8/2021,Sa kaeo,109,8386,561509,280362,281147,2377,2377,0,36,11,19/1/2022 7:23
24/8/2021,Sing Buri,25,1875,205088,97428,107660,3064,3064,0,,,19/1/2022 7:23
24/8/2021,Suphan Buri,91,9588,836435,403512,432923,6542,6542,0,,,19/1/2022 7:23
24/8/2021,Surat Thani,211,5775,1071496,527024,544472,4790,4115,675,71,56,19/1/2022 7:23
24/8/2021,Surin,282,10793,1376723,684837,691886,8153,8131,22,,,19/1/2022 7:23
24/8/2021,Sukhothai,38,4199,585851,283686,302165,4868,4868,0,,,19/1/2022 7:23
24/8/2021,Nong Khai,18,2111,516896,256327,260569,6520,6513,7,29,12,19/1/2022 7:23
24/8/2021,Nong Bua Lam Phu,69,3036,508942,253805,255137,1487,1487,0,,,19/1/2022 7:23
24/8/2021,Amnat Charoen,27,2307,376228,187133,189095,1440,1440,0,,,19/1/2022 7:23
24/8/2021,Udon Thani,51,8610,1566940,776022,790918,9291,9282,9,,,19/1/2022 7:23
24/8/2021,Uttaradit,26,2879,447089,217944,229145,6329,6329,0,,,19/1/2022 7:23
24/8/2021,Uthai Thani,70,2512,325254,158926,166328,2279,2279,0,,,19/1/2022 7:23
24/8/2021,Ubon Ratchathani,211,13082,1867365,932174,935191,7252,7252,0,43,17,19/1/2022 7:23
24/8/2021,Ang Thong,74,7655,275476,131801,143675,962,962,0,,,19/1/2022 7:23
24/8/2021,Chiang Rai,21,2760,1297168,630483,666685,28142,27897,245,17,9,19/1/2022 7:23
24/8/2021,Chiang Mai,27,10980,1787281,863640,923641,68614,67650,964,53,19,19/1/2022 7:23
24/8/2021,Phetchaburi,50,14492,482600,232958,249642,12139,12096,43,,,19/1/2022 7:23
24/8/2021,Phetchabun,151,5048,979033,482878,496155,20292,20262,30,,,19/1/2022 7:23
24/8/2021,Loei,26,2428,638862,320119,318743,5789,5778,11,48,13,19/1/2022 7:23
24/8/2021,Phrae,9,1293,435481,209872,225609,5872,5872,0,54,12,19/1/2022 7:23
24/8/2021,Mae Hong Son,7,267,285778,144757,141021,8861,8659,202,36,4,19/1/2022 7:23
24/8/2021,,0,153,,,,,,,,,19/1/2022 7:23
25/8/2021,Krabi,14,1483,478664,237717,240947,2096,1981,115,,,19/1/2022 7:23
25/8/2021,Bangkok,4181,282804,5544789,2601856,2942933,202959,181431,21528,51,18,19/1/2022 7:23
25/8/2021,Kanchanaburi,392,10729,893129,447919,445210,20185,20157,28,27,8,19/1/2022 7:23
25/8/2021,Kalasin,68,6568,976083,482351,493732,2306,2306,0,,,19/1/2022 7:23
25/8/2021,Kamphaeng Phet,36,5536,712600,351801,360799,6769,6769,0,,,19/1/2022 7:23
25/8/2021,Khon Kaen,115,9432,1791967,880624,911343,21098,21098,0,63,25,19/1/2022 7:23
25/8/2021,Chanthaburi,95,5292,536132,262097,274035,17881,17815,66,,,19/1/2022 7:23
25/8/2021,Chachoengsao,575,24026,722615,354177,368438,1995,1995,0,42,22,19/1/2022 7:23
25/8/2021,Chon Buri,974,59643,1580389,771364,809025,30270,29695,575,,,19/1/2022 7:23
25/8/2021,Chai Nat,24,1804,321015,154292,166723,4171,4171,0,,,19/1/2022 7:23
25/8/2021,Chaiyaphum,88,7364,1122780,554646,568134,13695,13682,13,,,19/1/2022 7:23
25/8/2021,Chumphon,114,3482,509292,251346,257946,1644,1644,0,,,19/1/2022 7:23
25/8/2021,Trang,33,3796,639931,312837,327094,2469,2469,0,,,19/1/2022 7:23
25/8/2021,Trat,31,1857,228459,112922,115537,22368,22277,91,,,19/1/2022 7:23
25/8/2021,Tak,242,9607,674616,341111,333505,12606,12606,0,,,19/1/2022 7:23
25/8/2021,Nakhon Nayok,61,7463,259735,128303,131432,2679,2679,0,,,19/1/2022 7:23
25/8/2021,Nakhon Pathom,506,25785,921500,442584,478916,2714,2714,0,26,11,19/1/2022 7:23
25/8/2021,Nakhon Phanom,61,4226,717048,357194,359854,3548,3548,0,,,19/1/2022 7:23
25/8/2021,Nakhon Ratchasima,482,15545,2633733,1293977,1339756,88532,87939,593,54,18,19/1/2022 7:23
25/8/2021,Nakhon Si Thammarat,88,6775,1549496,764523,784973,7996,7996,0,,,19/1/2022 7:23
25/8/2021,Nakhon Sawan,97,7563,1036534,505545,530989,15946,15946,0,56,25,19/1/2022 7:23
25/8/2021,Nonthaburi,338,49659,1285013,597870,687143,2822,2815,7,23,23,19/1/2022 7:23
25/8/2021,Narathiwat,288,12157,808758,400002,408756,421,421,0,30,15,19/1/2022 7:23
25/8/2021,Nan,16,2071,475941,238073,237868,9832,9798,34,,,19/1/2022 7:23
25/8/2021,Bueng Kan,5,1540,421931,211488,210443,2114,2114,0,,,19/1/2022 7:23
25/8/2021,Buri Ram,445,11465,1579709,783665,796044,12087,12044,43,,,19/1/2022 7:23
25/8/2021,Pathum Thani,326,32042,1185082,561507,623575,1319,1306,13,54,24,19/1/2022 7:23
25/8/2021,Prachuap Khiri Khan,81,7308,552888,274321,278567,13974,13921,53,,,19/1/2022 7:23
25/8/2021,Prachin Buri,214,7349,494505,244150,250355,3143,3143,0,37,14,19/1/2022 7:23
25/8/2021,Pattani,182,14593,728801,359974,368827,517,517,0,,,19/1/2022 7:23
25/8/2021,Phra Nakhon Si Ayutthaya,298,18759,819892,393788,426104,17000,16958,42,22,30,19/1/2022 7:23
25/8/2021,Phayao,12,1506,465390,226498,238892,9277,9277,0,34,14,19/1/2022 7:23
25/8/2021,Phang-nga,14,1001,268269,133881,134388,7037,5969,1068,,,19/1/2022 7:23
25/8/2021,Phatthalung,39,2444,522612,254531,268081,1598,1598,0,,,19/1/2022 7:23
25/8/2021,Phichit,62,3133,530258,258492,271766,6914,6914,0,,,19/1/2022 7:23
25/8/2021,Phitsanulok,48,3471,847684,414983,432701,25715,25564,151,,,19/1/2022 7:23
25/8/2021,Phuket,158,3198,418055,197662,220393,33530,18204,15326,50,22,19/1/2022 7:23
25/8/2021,Maha Sarakham,115,8228,949783,465624,484159,2772,2772,0,,,19/1/2022 7:23
25/8/2021,Mukdahan,22,1767,351259,175474,175785,5322,5322,0,,,19/1/2022 7:23
25/8/2021,Yala,127,10911,541494,269636,271858,438,438,0,33,16,19/1/2022 7:23
25/8/2021,Yasothon,94,4164,533506,266189,267317,1561,1561,0,,,19/1/2022 7:23
25/8/2021,Ranong,122,5148,194677,98263,96414,1369,1369,0,,,19/1/2022 7:23
25/8/2021,Rayong,302,15854,748943,367783,381160,18635,18409,226,22,20,19/1/2022 7:23
25/8/2021,Ratchaburi,501,14393,869099,422558,446541,7187,7187,0,,,19/1/2022 7:23
25/8/2021,Roi Et,187,10742,1296428,642234,654194,2700,2700,0,,,19/1/2022 7:23
25/8/2021,Lop Buri,186,9998,740487,369278,371209,7057,7028,29,,,19/1/2022 7:23
25/8/2021,Lampang,14,1957,726261,353817,372444,6862,6727,135,43,15,19/1/2022 7:23
25/8/2021,Lamphun,24,1088,401525,192998,208527,7455,7381,74,,,19/1/2022 7:23
25/8/2021,Si Sa Ket,149,11647,1456985,725190,731795,3838,3838,0,,,19/1/2022 7:23
25/8/2021,Sakon Nakhon,67,5817,1146507,569654,576853,4675,4675,0,,,19/1/2022 7:23
25/8/2021,Songkhla,197,18984,1430543,696923,733620,1132,1132,0,53,25,19/1/2022 7:23
25/8/2021,Satun,35,1208,324496,161423,163073,1183,1170,13,42,21,19/1/2022 7:23
25/8/2021,Samut Prakarn,2237,74641,1355823,645868,709955,1887,1860,27,,,19/1/2022 7:23
25/8/2021,Samut Songkhram,167,7122,191276,91338,99938,4546,4546,0,21,9,19/1/2022 7:23
25/8/2021,Samut Sakhon,1132,86344,585685,282240,303445,1338,1338,0,56,32,19/1/2022 7:23
25/8/2021,Saraburi,220,17934,643873,316304,327569,9794,9776,18,61,43,19/1/2022 7:23
25/8/2021,Sa kaeo,79,8465,561509,280362,281147,2377,2377,0,20,9,19/1/2022 7:23
25/8/2021,Sing Buri,17,1892,205088,97428,107660,3064,3064,0,,,19/1/2022 7:23
25/8/2021,Suphan Buri,108,9696,836435,403512,432923,6542,6542,0,,,19/1/2022 7:23
25/8/2021,Surat Thani,129,5904,1071496,527024,544472,4790,4115,675,67,23,19/1/2022 7:23
25/8/2021,Surin,266,11059,1376723,684837,691886,8153,8131,22,,,19/1/2022 7:23
25/8/2021,Sukhothai,55,4254,585851,283686,302165,4868,4868,0,,,19/1/2022 7:23
25/8/2021,Nong Khai,33,2144,516896,256327,260569,6520,6513,7,32,11,19/1/2022 7:23
25/8/2021,Nong Bua Lam Phu,61,3097,508942,253805,255137,1487,1487,0,,,19/1/2022 7:23
25/8/2021,Amnat Charoen,62,2369,376228,187133,189095,1440,1440,0,,,19/1/2022 7:23
25/8/2021,Udon Thani,207,8817,1566940,776022,790918,9291,9282,9,,,19/1/2022 7:23
25/8/2021,Uttaradit,53,2932,447089,217944,229145,6329,6329,0,,,19/1/2022 7:23
25/8/2021,Uthai Thani,53,2565,325254,158926,166328,2279,2279,0,,,19/1/2022 7:23
25/8/2021,Ubon Ratchathani,211,13293,1867365,932174,935191,7252,7252,0,36,11,19/1/2022 7:23
25/8/2021,Ang Thong,68,7723,275476,131801,143675,962,962,0,,,19/1/2022 7:23
25/8/2021,Chiang Rai,52,2812,1297168,630483,666685,28142,27897,245,29,12,19/1/2022 7:23
25/8/2021,Chiang Mai,16,10996,1787281,863640,923641,68614,67650,964,44,24,19/1/2022 7:23
25/8/2021,Phetchaburi,99,14591,482600,232958,249642,12139,12096,43,,,19/1/2022 7:23
25/8/2021,Phetchabun,123,5171,979033,482878,496155,20292,20262,30,,,19/1/2022 7:23
25/8/2021,Loei,15,2443,638862,320119,318743,5789,5778,11,25,13,19/1/2022 7:23
25/8/2021,Phrae,7,1300,435481,209872,225609,5872,5872,0,30,14,19/1/2022 7:23
25/8/2021,Mae Hong Son,2,269,285778,144757,141021,8861,8659,202,18,7,19/1/2022 7:23
25/8/2021,,0,153,,,,,,,,,19/1/2022 7:23
26/8/2021,Krabi,13,1496,478664,237717,240947,2096,1981,115,,,19/1/2022 7:23
26/8/2021,Bangkok,4184,286988,5544789,2601856,2942933,202959,181431,21528,36,22,19/1/2022 7:23
26/8/2021,Kanchanaburi,426,11155,893129,447919,445210,20185,20157,28,21,7,19/1/2022 7:23
26/8/2021,Kalasin,72,6640,976083,482351,493732,2306,2306,0,,,19/1/2022 7:23
26/8/2021,Kamphaeng Phet,74,5610,712600,351801,360799,6769,6769,0,,,19/1/2022 7:23
26/8/2021,Khon Kaen,103,9535,1791967,880624,911343,21098,21098,0,50,24,19/1/2022 7:23
26/8/2021,Chanthaburi,134,5426,536132,262097,274035,17881,17815,66,,,19/1/2022 7:23
26/8/2021,Chachoengsao,462,24488,722615,354177,368438,1995,1995,0,37,23,19/1/2022 7:23
26/8/2021,Chon Buri,974,60617,1580389,771364,809025,30270,29695,575,,,19/1/2022 7:23
26/8/2021,Chai Nat,13,1817,321015,154292,166723,4171,4171,0,,,19/1/2022 7:23
26/8/2021,Chaiyaphum,82,7446,1122780,554646,568134,13695,13682,13,,,19/1/2022 7:23
26/8/2021,Chumphon,90,3572,509292,251346,257946,1644,1644,0,,,19/1/2022 7:23
26/8/2021,Trang,30,3826,639931,312837,327094,2469,2469,0,,,19/1/2022 7:23
26/8/2021,Trat,59,1916,228459,112922,115537,22368,22277,91,,,19/1/2022 7:23
26/8/2021,Tak,134,9741,674616,341111,333505,12606,12606,0,,,19/1/2022 7:23
26/8/2021,Nakhon Nayok,94,7557,259735,128303,131432,2679,2679,0,,,19/1/2022 7:23
26/8/2021,Nakhon Pathom,257,26042,921500,442584,478916,2714,2714,0,27,13,19/1/2022 7:23
26/8/2021,Nakhon Phanom,57,4283,717048,357194,359854,3548,3548,0,,,19/1/2022 7:23
26/8/2021,Nakhon Ratchasima,693,16238,2633733,1293977,1339756,88532,87939,593,46,14,19/1/2022 7:23
26/8/2021,Nakhon Si Thammarat,175,6950,1549496,764523,784973,7996,7996,0,,,19/1/2022 7:23
26/8/2021,Nakhon Sawan,129,7692,1036534,505545,530989,15946,15946,0,50,20,19/1/2022 7:23
26/8/2021,Nonthaburi,521,50180,1285013,597870,687143,2822,2815,7,27,15,19/1/2022 7:23
26/8/2021,Narathiwat,237,12394,808758,400002,408756,421,421,0,25,19,19/1/2022 7:23
26/8/2021,Nan,36,2107,475941,238073,237868,9832,9798,34,,,19/1/2022 7:23
26/8/2021,Bueng Kan,38,1578,421931,211488,210443,2114,2114,0,,,19/1/2022 7:23
26/8/2021,Buri Ram,432,11897,1579709,783665,796044,12087,12044,43,,,19/1/2022 7:23
26/8/2021,Pathum Thani,157,32199,1185082,561507,623575,1319,1306,13,47,22,19/1/2022 7:23
26/8/2021,Prachuap Khiri Khan,103,7411,552888,274321,278567,13974,13921,53,,,19/1/2022 7:23
26/8/2021,Prachin Buri,175,7524,494505,244150,250355,3143,3143,0,38,12,19/1/2022 7:23
26/8/2021,Pattani,76,14669,728801,359974,368827,517,517,0,,,19/1/2022 7:23
26/8/2021,Phra Nakhon Si Ayutthaya,310,19069,819892,393788,426104,17000,16958,42,24,29,19/1/2022 7:23
26/8/2021,Phayao,13,1519,465390,226498,238892,9277,9277,0,36,15,19/1/2022 7:23
26/8/2021,Phang-nga,12,1013,268269,133881,134388,7037,5969,1068,,,19/1/2022 7:23
26/8/2021,Phatthalung,49,2493,522612,254531,268081,1598,1598,0,,,19/1/2022 7:23
26/8/2021,Phichit,62,3195,530258,258492,271766,6914,6914,0,,,19/1/2022 7:23
26/8/2021,Phitsanulok,42,3513,847684,414983,432701,25715,25564,151,,,19/1/2022 7:23
26/8/2021,Phuket,192,3390,418055,197662,220393,33530,18204,15326,51,27,19/1/2022 7:23
26/8/2021,Maha Sarakham,95,8323,949783,465624,484159,2772,2772,0,,,19/1/2022 7:23
26/8/2021,Mukdahan,23,1790,351259,175474,175785,5322,5322,0,,,19/1/2022 7:23
26/8/2021,Yala,164,11075,541494,269636,271858,438,438,0,43,20,19/1/2022 7:23
26/8/2021,Yasothon,24,4188,533506,266189,267317,1561,1561,0,,,19/1/2022 7:23
26/8/2021,Ranong,152,5300,194677,98263,96414,1369,1369,0,,,19/1/2022 7:23
26/8/2021,Rayong,472,16326,748943,367783,381160,18635,18409,226,30,19,19/1/2022 7:23
26/8/2021,Ratchaburi,493,14886,869099,422558,446541,7187,7187,0,,,19/1/2022 7:23
26/8/2021,Roi Et,232,10974,1296428,642234,654194,2700,2700,0,,,19/1/2022 7:23
26/8/2021,Lop Buri,154,10152,740487,369278,371209,7057,7028,29,,,19/1/2022 7:23
26/8/2021,Lampang,24,1981,726261,353817,372444,6862,6727,135,47,16,19/1/2022 7:23
26/8/2021,Lamphun,10,1098,401525,192998,208527,7455,7381,74,,,19/1/2022 7:23
26/8/2021,Si Sa Ket,216,11863,1456985,725190,731795,3838,3838,0,,,19/1/2022 7:23
26/8/2021,Sakon Nakhon,83,5900,1146507,569654,576853,4675,4675,0,,,19/1/2022 7:23
26/8/2021,Songkhla,285,19269,1430543,696923,733620,1132,1132,0,46,33,19/1/2022 7:23
26/8/2021,Satun,39,1247,324496,161423,163073,1183,1170,13,44,30,19/1/2022 7:23
26/8/2021,Samut Prakarn,1887,76528,1355823,645868,709955,1887,1860,27,,,19/1/2022 7:23
26/8/2021,Samut Songkhram,146,7268,191276,91338,99938,4546,4546,0,15,12,19/1/2022 7:23
26/8/2021,Samut Sakhon,1011,87355,585685,282240,303445,1338,1338,0,56,31,19/1/2022 7:23
26/8/2021,Saraburi,413,18347,643873,316304,327569,9794,9776,18,42,56,19/1/2022 7:23
26/8/2021,Sa kaeo,226,8691,561509,280362,281147,2377,2377,0,14,9,19/1/2022 7:23
26/8/2021,Sing Buri,51,1943,205088,97428,107660,3064,3064,0,,,19/1/2022 7:23
26/8/2021,Suphan Buri,84,9780,836435,403512,432923,6542,6542,0,,,19/1/2022 7:23
26/8/2021,Surat Thani,118,6022,1071496,527024,544472,4790,4115,675,65,25,19/1/2022 7:23
26/8/2021,Surin,253,11312,1376723,684837,691886,8153,8131,22,,,19/1/2022 7:23
26/8/2021,Sukhothai,73,4327,585851,283686,302165,4868,4868,0,,,19/1/2022 7:23
26/8/2021,Nong Khai,29,2173,516896,256327,260569,6520,6513,7,27,10,19/1/2022 7:23
26/8/2021,Nong Bua Lam Phu,36,3133,508942,253805,255137,1487,1487,0,,,19/1/2022 7:23
26/8/2021,Amnat Charoen,39,2408,376228,187133,189095,1440,1440,0,,,19/1/2022 7:23
26/8/2021,Udon Thani,107,8924,1566940,776022,790918,9291,9282,9,,,19/1/2022 7:23
26/8/2021,Uttaradit,29,2961,447089,217944,229145,6329,6329,0,,,19/1/2022 7:23
26/8/2021,Uthai Thani,44,2609,325254,158926,166328,2279,2279,0,,,19/1/2022 7:23
26/8/2021,Ubon Ratchathani,184,13477,1867365,932174,935191,7252,7252,0,22,12,19/1/2022 7:23
26/8/2021,Ang Thong,156,7879,275476,131801,143675,962,962,0,,,19/1/2022 7:23
26/8/2021,Chiang Rai,54,2866,1297168,630483,666685,28142,27897,245,45,10,19/1/2022 7:23
26/8/2021,Chiang Mai,16,11012,1787281,863640,923641,68614,67650,964,51,22,19/1/2022 7:23
26/8/2021,Phetchaburi,190,14781,482600,232958,249642,12139,12096,43,,,19/1/2022 7:23
26/8/2021,Phetchabun,131,5302,979033,482878,496155,20292,20262,30,,,19/1/2022 7:23
26/8/2021,Loei,24,2467,638862,320119,318743,5789,5778,11,21,11,19/1/2022 7:23
26/8/2021,Phrae,16,1316,435481,209872,225609,5872,5872,0,34,14,19/1/2022 7:23
26/8/2021,Mae Hong Son,8,277,285778,144757,141021,8861,8659,202,26,10,19/1/2022 7:23
26/8/2021,,0,153,,,,,,,,,19/1/2022 7:23
27/8/2021,Krabi,23,1519,478664,237717,240947,2096,1981,115,,,19/1/2022 7:23
27/8/2021,Bangkok,4733,291721,5544789,2601856,2942933,202959,181431,21528,52,19,19/1/2022 7:23
27/8/2021,Kanchanaburi,310,11465,893129,447919,445210,20185,20157,28,21,9,19/1/2022 7:23
27/8/2021,Kalasin,57,6697,976083,482351,493732,2306,2306,0,,,19/1/2022 7:23
27/8/2021,Kamphaeng Phet,118,5728,712600,351801,360799,6769,6769,0,,,19/1/2022 7:23
27/8/2021,Khon Kaen,126,9661,1791967,880624,911343,21098,21098,0,48,26,19/1/2022 7:23
27/8/2021,Chanthaburi,83,5509,536132,262097,274035,17881,17815,66,,,19/1/2022 7:23
27/8/2021,Chachoengsao,323,24811,722615,354177,368438,1995,1995,0,24,22,19/1/2022 7:23
27/8/2021,Chon Buri,1064,61681,1580389,771364,809025,30270,29695,575,,,19/1/2022 7:23
27/8/2021,Chai Nat,25,1842,321015,154292,166723,4171,4171,0,,,19/1/2022 7:23
27/8/2021,Chaiyaphum,104,7550,1122780,554646,568134,13695,13682,13,,,19/1/2022 7:23
27/8/2021,Chumphon,108,3680,509292,251346,257946,1644,1644,0,,,19/1/2022 7:23
27/8/2021,Trang,44,3870,639931,312837,327094,2469,2469,0,,,19/1/2022 7:23
27/8/2021,Trat,55,1971,228459,112922,115537,22368,22277,91,,,19/1/2022 7:23
27/8/2021,Tak,320,10061,674616,341111,333505,12606,12606,0,,,19/1/2022 7:23
27/8/2021,Nakhon Nayok,178,7735,259735,128303,131432,2679,2679,0,,,19/1/2022 7:23
27/8/2021,Nakhon Pathom,338,26380,921500,442584,478916,2714,2714,0,34,15,19/1/2022 7:23
27/8/2021,Nakhon Phanom,40,4323,717048,357194,359854,3548,3548,0,,,19/1/2022 7:23
27/8/2021,Nakhon Ratchasima,498,16736,2633733,1293977,1339756,88532,87939,593,40,16,19/1/2022 7:23
27/8/2021,Nakhon Si Thammarat,216,7166,1549496,764523,784973,7996,7996,0,,,19/1/2022 7:23
27/8/2021,Nakhon Sawan,95,7787,1036534,505545,530989,15946,15946,0,40,23,19/1/2022 7:23
27/8/2021,Nonthaburi,587,50767,1285013,597870,687143,2822,2815,7,31,13,19/1/2022 7:23
27/8/2021,Narathiwat,263,12657,808758,400002,408756,421,421,0,34,24,19/1/2022 7:23
27/8/2021,Nan,23,2130,475941,238073,237868,9832,9798,34,,,19/1/2022 7:23
27/8/2021,Bueng Kan,32,1610,421931,211488,210443,2114,2114,0,,,19/1/2022 7:23
27/8/2021,Buri Ram,314,12211,1579709,783665,796044,12087,12044,43,,,19/1/2022 7:23
27/8/2021,Pathum Thani,562,32761,1185082,561507,623575,1319,1306,13,46,27,19/1/2022 7:23
27/8/2021,Prachuap Khiri Khan,210,7621,552888,274321,278567,13974,13921,53,,,19/1/2022 7:23
27/8/2021,Prachin Buri,216,7740,494505,244150,250355,3143,3143,0,41,15,19/1/2022 7:23
27/8/2021,Pattani,101,14770,728801,359974,368827,517,517,0,,,19/1/2022 7:23
27/8/2021,Phra Nakhon Si Ayutthaya,466,19535,819892,393788,426104,17000,16958,42,23,30,19/1/2022 7:23
27/8/2021,Phayao,14,1533,465390,226498,238892,9277,9277,0,38,14,19/1/2022 7:23
27/8/2021,Phang-nga,12,1025,268269,133881,134388,7037,5969,1068,,,19/1/2022 7:23
27/8/2021,Phatthalung,74,2567,522612,254531,268081,1598,1598,0,,,19/1/2022 7:23
27/8/2021,Phichit,49,3244,530258,258492,271766,6914,6914,0,,,19/1/2022 7:23
27/8/2021,Phitsanulok,48,3561,847684,414983,432701,25715,25564,151,,,19/1/2022 7:23
27/8/2021,Phuket,170,3560,418055,197662,220393,33530,18204,15326,54,29,19/1/2022 7:23
27/8/2021,Maha Sarakham,65,8388,949783,465624,484159,2772,2772,0,,,19/1/2022 7:23
27/8/2021,Mukdahan,11,1801,351259,175474,175785,5322,5322,0,,,19/1/2022 7:23
27/8/2021,Yala,194,11269,541494,269636,271858,438,438,0,48,25,19/1/2022 7:23
27/8/2021,Yasothon,42,4230,533506,266189,267317,1561,1561,0,,,19/1/2022 7:23
27/8/2021,Ranong,162,5462,194677,98263,96414,1369,1369,0,,,19/1/2022 7:23
27/8/2021,Rayong,475,16801,748943,367783,381160,18635,18409,226,27,24,19/1/2022 7:23
27/8/2021,Ratchaburi,486,15372,869099,422558,446541,7187,7187,0,,,19/1/2022 7:23
27/8/2021,Roi Et,149,11123,1296428,642234,654194,2700,2700,0,,,19/1/2022 7:23
27/8/2021,Lop Buri,158,10310,740487,369278,371209,7057,7028,29,,,19/1/2022 7:23
27/8/2021,Lampang,4,1985,726261,353817,372444,6862,6727,135,49,15,19/1/2022 7:23
27/8/2021,Lamphun,14,1112,401525,192998,208527,7455,7381,74,,,19/1/2022 7:23
27/8/2021,Si Sa Ket,154,12017,1456985,725190,731795,3838,3838,0,,,19/1/2022 7:23
27/8/2021,Sakon Nakhon,46,5946,1146507,569654,576853,4675,4675,0,,,19/1/2022 7:23
27/8/2021,Songkhla,333,19602,1430543,696923,733620,1132,1132,0,60,37,19/1/2022 7:23
27/8/2021,Satun,24,1271,324496,161423,163073,1183,1170,13,43,31,19/1/2022 7:23
27/8/2021,Samut Prakarn,1220,77748,1355823,645868,709955,1887,1860,27,,,19/1/2022 7:23
27/8/2021,Samut Songkhram,140,7408,191276,91338,99938,4546,4546,0,24,11,19/1/2022 7:23
27/8/2021,Samut Sakhon,896,88251,585685,282240,303445,1338,1338,0,55,27,19/1/2022 7:23
27/8/2021,Saraburi,318,18665,643873,316304,327569,9794,9776,18,48,46,19/1/2022 7:23
27/8/2021,Sa kaeo,108,8799,561509,280362,281147,2377,2377,0,16,13,19/1/2022 7:23
27/8/2021,Sing Buri,59,2002,205088,97428,107660,3064,3064,0,,,19/1/2022 7:23
27/8/2021,Suphan Buri,106,9886,836435,403512,432923,6542,6542,0,,,19/1/2022 7:23
27/8/2021,Surat Thani,152,6174,1071496,527024,544472,4790,4115,675,67,27,19/1/2022 7:23
27/8/2021,Surin,244,11556,1376723,684837,691886,8153,8131,22,,,19/1/2022 7:23
27/8/2021,Sukhothai,37,4364,585851,283686,302165,4868,4868,0,,,19/1/2022 7:23
27/8/2021,Nong Khai,27,2200,516896,256327,260569,6520,6513,7,24,9,19/1/2022 7:23
27/8/2021,Nong Bua Lam Phu,76,3209,508942,253805,255137,1487,1487,0,,,19/1/2022 7:23
27/8/2021,Amnat Charoen,44,2452,376228,187133,189095,1440,1440,0,,,19/1/2022 7:23
27/8/2021,Udon Thani,103,9027,1566940,776022,790918,9291,9282,9,,,19/1/2022 7:23
27/8/2021,Uttaradit,24,2985,447089,217944,229145,6329,6329,0,,,19/1/2022 7:23
27/8/2021,Uthai Thani,92,2701,325254,158926,166328,2279,2279,0,,,19/1/2022 7:23
27/8/2021,Ubon Ratchathani,176,13653,1867365,932174,935191,7252,7252,0,27,16,19/1/2022 7:23
27/8/2021,Ang Thong,185,8064,275476,131801,143675,962,962,0,,,19/1/2022 7:23
27/8/2021,Chiang Rai,27,2893,1297168,630483,666685,28142,27897,245,37,6,19/1/2022 7:23
27/8/2021,Chiang Mai,36,11048,1787281,863640,923641,68614,67650,964,44,21,19/1/2022 7:23
27/8/2021,Phetchaburi,118,14899,482600,232958,249642,12139,12096,43,,,19/1/2022 7:23
27/8/2021,Phetchabun,149,5451,979033,482878,496155,20292,20262,30,,,19/1/2022 7:23
27/8/2021,Loei,28,2495,638862,320119,318743,5789,5778,11,18,13,19/1/2022 7:23
27/8/2021,Phrae,21,1337,435481,209872,225609,5872,5872,0,38,13,19/1/2022 7:23
27/8/2021,Mae Hong Son,0,277,285778,144757,141021,8861,8659,202,42,7,19/1/2022 7:23
27/8/2021,,0,153,,,,,,,,,19/1/2022 7:23
28/8/2021,Krabi,31,1550,478664,237717,240947,2096,1981,115,,,19/1/2022 7:23
28/8/2021,Bangkok,4193,295914,5544789,2601856,2942933,202959,181431,21528,42,14,19/1/2022 7:23
28/8/2021,Kanchanaburi,377,11842,893129,447919,445210,20185,20157,28,18,11,19/1/2022 7:23
28/8/2021,Kalasin,75,6772,976083,482351,493732,2306,2306,0,,,19/1/2022 7:23
28/8/2021,Kamphaeng Phet,69,5797,712600,351801,360799,6769,6769,0,,,19/1/2022 7:23
28/8/2021,Khon Kaen,99,9760,1791967,880624,911343,21098,21098,0,53,23,19/1/2022 7:23
28/8/2021,Chanthaburi,100,5609,536132,262097,274035,17881,17815,66,,,19/1/2022 7:23
28/8/2021,Chachoengsao,343,25154,722615,354177,368438,1995,1995,0,30,23,19/1/2022 7:23
28/8/2021,Chon Buri,1073,62754,1580389,771364,809025,30270,29695,575,,,19/1/2022 7:23
28/8/2021,Chai Nat,36,1878,321015,154292,166723,4171,4171,0,,,19/1/2022 7:23
28/8/2021,Chaiyaphum,119,7669,1122780,554646,568134,13695,13682,13,,,19/1/2022 7:23
28/8/2021,Chumphon,125,3805,509292,251346,257946,1644,1644,0,,,19/1/2022 7:23
28/8/2021,Trang,83,3953,639931,312837,327094,2469,2469,0,,,19/1/2022 7:23
28/8/2021,Trat,93,2064,228459,112922,115537,22368,22277,91,,,19/1/2022 7:23
28/8/2021,Tak,228,10289,674616,341111,333505,12606,12606,0,,,19/1/2022 7:23
28/8/2021,Nakhon Nayok,136,7871,259735,128303,131432,2679,2679,0,,,19/1/2022 7:23
28/8/2021,Nakhon Pathom,316,26696,921500,442584,478916,2714,2714,0,39,13,19/1/2022 7:23
28/8/2021,Nakhon Phanom,26,4349,717048,357194,359854,3548,3548,0,,,19/1/2022 7:23
28/8/2021,Nakhon Ratchasima,566,17302,2633733,1293977,1339756,88532,87939,593,40,19,19/1/2022 7:23
28/8/2021,Nakhon Si Thammarat,186,7352,1549496,764523,784973,7996,7996,0,,,19/1/2022 7:23
28/8/2021,Nakhon Sawan,92,7879,1036534,505545,530989,15946,15946,0,44,20,19/1/2022 7:23
28/8/2021,Nonthaburi,448,51215,1285013,597870,687143,2822,2815,7,22,11,19/1/2022 7:23
28/8/2021,Narathiwat,264,12921,808758,400002,408756,421,421,0,53,22,19/1/2022 7:23
28/8/2021,Nan,26,2156,475941,238073,237868,9832,9798,34,,,19/1/2022 7:23
28/8/2021,Bueng Kan,13,1623,421931,211488,210443,2114,2114,0,,,19/1/2022 7:23
28/8/2021,Buri Ram,374,12585,1579709,783665,796044,12087,12044,43,,,19/1/2022 7:23
28/8/2021,Pathum Thani,462,33223,1185082,561507,623575,1319,1306,13,46,22,19/1/2022 7:23
28/8/2021,Prachuap Khiri Khan,220,7841,552888,274321,278567,13974,13921,53,,,19/1/2022 7:23
28/8/2021,Prachin Buri,140,7880,494505,244150,250355,3143,3143,0,40,17,19/1/2022 7:23
28/8/2021,Pattani,118,14888,728801,359974,368827,517,517,0,,,19/1/2022 7:23
28/8/2021,Phra Nakhon Si Ayutthaya,400,19935,819892,393788,426104,17000,16958,42,22,29,19/1/2022 7:23
28/8/2021,Phayao,11,1544,465390,226498,238892,9277,9277,0,28,15,19/1/2022 7:23
28/8/2021,Phang-nga,20,1045,268269,133881,134388,7037,5969,1068,,,19/1/2022 7:23
28/8/2021,Phatthalung,31,2598,522612,254531,268081,1598,1598,0,,,19/1/2022 7:23
28/8/2021,Phichit,34,3278,530258,258492,271766,6914,6914,0,,,19/1/2022 7:23
28/8/2021,Phitsanulok,25,3586,847684,414983,432701,25715,25564,151,,,19/1/2022 7:23
28/8/2021,Phuket,207,3767,418055,197662,220393,33530,18204,15326,59,26,19/1/2022 7:23
28/8/2021,Maha Sarakham,67,8455,949783,465624,484159,2772,2772,0,,,19/1/2022 7:23
28/8/2021,Mukdahan,11,1812,351259,175474,175785,5322,5322,0,,,19/1/2022 7:23
28/8/2021,Yala,179,11448,541494,269636,271858,438,438,0,54,24,19/1/2022 7:23
28/8/2021,Yasothon,20,4250,533506,266189,267317,1561,1561,0,,,19/1/2022 7:23
28/8/2021,Ranong,147,5609,194677,98263,96414,1369,1369,0,,,19/1/2022 7:23
28/8/2021,Rayong,449,17250,748943,367783,381160,18635,18409,226,37,25,19/1/2022 7:23
28/8/2021,Ratchaburi,469,15841,869099,422558,446541,7187,7187,0,,,19/1/2022 7:23
28/8/2021,Roi Et,109,11232,1296428,642234,654194,2700,2700,0,,,19/1/2022 7:23
28/8/2021,Lop Buri,289,10599,740487,369278,371209,7057,7028,29,,,19/1/2022 7:23
28/8/2021,Lampang,7,1992,726261,353817,372444,6862,6727,135,48,14,19/1/2022 7:23
28/8/2021,Lamphun,19,1131,401525,192998,208527,7455,7381,74,,,19/1/2022 7:23
28/8/2021,Si Sa Ket,179,12196,1456985,725190,731795,3838,3838,0,,,19/1/2022 7:23
28/8/2021,Sakon Nakhon,59,6005,1146507,569654,576853,4675,4675,0,,,19/1/2022 7:23
28/8/2021,Songkhla,187,19789,1430543,696923,733620,1132,1132,0,73,34,19/1/2022 7:23
28/8/2021,Satun,14,1285,324496,161423,163073,1183,1170,13,51,32,19/1/2022 7:23
28/8/2021,Samut Prakarn,1432,79180,1355823,645868,709955,1887,1860,27,,,19/1/2022 7:23
28/8/2021,Samut Songkhram,136,7544,191276,91338,99938,4546,4546,0,18,11,19/1/2022 7:23
28/8/2021,Samut Sakhon,910,89161,585685,282240,303445,1338,1338,0,55,181,19/1/2022 7:23
28/8/2021,Saraburi,428,19093,643873,316304,327569,9794,9776,18,43,45,19/1/2022 7:23
28/8/2021,Sa kaeo,229,9028,561509,280362,281147,2377,2377,0,15,15,19/1/2022 7:23
28/8/2021,Sing Buri,48,2050,205088,97428,107660,3064,3064,0,,,19/1/2022 7:23
28/8/2021,Suphan Buri,101,9987,836435,403512,432923,6542,6542,0,,,19/1/2022 7:23
28/8/2021,Surat Thani,122,6296,1071496,527024,544472,4790,4115,675,79,28,19/1/2022 7:23
28/8/2021,Surin,235,11791,1376723,684837,691886,8153,8131,22,,,19/1/2022 7:23
28/8/2021,Sukhothai,45,4409,585851,283686,302165,4868,4868,0,,,19/1/2022 7:23
28/8/2021,Nong Khai,16,2216,516896,256327,260569,6520,6513,7,22,12,19/1/2022 7:23
28/8/2021,Nong Bua Lam Phu,34,3243,508942,253805,255137,1487,1487,0,,,19/1/2022 7:23
28/8/2021,Amnat Charoen,31,2483,376228,187133,189095,1440,1440,0,,,19/1/2022 7:23
28/8/2021,Udon Thani,60,9087,1566940,776022,790918,9291,9282,9,,,19/1/2022 7:23
28/8/2021,Uttaradit,27,3012,447089,217944,229145,6329,6329,0,,,19/1/2022 7:23
28/8/2021,Uthai Thani,80,2781,325254,158926,166328,2279,2279,0,,,19/1/2022 7:23
28/8/2021,Ubon Ratchathani,151,13804,1867365,932174,935191,7252,7252,0,37,15,19/1/2022 7:23
28/8/2021,Ang Thong,170,8234,275476,131801,143675,962,962,0,,,19/1/2022 7:23
28/8/2021,Chiang Rai,33,2926,1297168,630483,666685,28142,27897,245,20,7,19/1/2022 7:23
28/8/2021,Chiang Mai,48,11096,1787281,863640,923641,68614,67650,964,50,20,19/1/2022 7:23
28/8/2021,Phetchaburi,113,15012,482600,232958,249642,12139,12096,43,,,19/1/2022 7:23
28/8/2021,Phetchabun,141,5592,979033,482878,496155,20292,20262,30,,,19/1/2022 7:23
28/8/2021,Loei,24,2519,638862,320119,318743,5789,5778,11,18,12,19/1/2022 7:23
28/8/2021,Phrae,5,1342,435481,209872,225609,5872,5872,0,34,14,19/1/2022 7:23
28/8/2021,Mae Hong Son,1,278,285778,144757,141021,8861,8659,202,33,4,19/1/2022 7:23
28/8/2021,,0,153,,,,,,,,,19/1/2022 7:23
29/8/2021,Krabi,26,1576,478664,237717,240947,2096,1981,115,,,19/1/2022 7:23
29/8/2021,Bangkok,3827,299741,5544789,2601856,2942933,202959,181431,21528,33,24,19/1/2022 7:23
29/8/2021,Kanchanaburi,285,12127,893129,447919,445210,20185,20157,28,29,17,19/1/2022 7:23
29/8/2021,Kalasin,54,6826,976083,482351,493732,2306,2306,0,,,19/1/2022 7:23
29/8/2021,Kamphaeng Phet,86,5883,712600,351801,360799,6769,6769,0,,,19/1/2022 7:23
29/8/2021,Khon Kaen,95,9855,1791967,880624,911343,21098,21098,0,55,28,19/1/2022 7:23
29/8/2021,Chanthaburi,130,5739,536132,262097,274035,17881,17815,66,,,19/1/2022 7:23
29/8/2021,Chachoengsao,357,25511,722615,354177,368438,1995,1995,0,28,28,19/1/2022 7:23
29/8/2021,Chon Buri,773,63527,1580389,771364,809025,30270,29695,575,,,19/1/2022 7:23
29/8/2021,Chai Nat,39,1917,321015,154292,166723,4171,4171,0,,,19/1/2022 7:23
29/8/2021,Chaiyaphum,102,7771,1122780,554646,568134,13695,13682,13,,,19/1/2022 7:23
29/8/2021,Chumphon,99,3904,509292,251346,257946,1644,1644,0,,,19/1/2022 7:23
29/8/2021,Trang,73,4026,639931,312837,327094,2469,2469,0,,,19/1/2022 7:23
29/8/2021,Trat,86,2150,228459,112922,115537,22368,22277,91,,,19/1/2022 7:23
29/8/2021,Tak,201,10490,674616,341111,333505,12606,12606,0,,,19/1/2022 7:23
29/8/2021,Nakhon Nayok,154,8025,259735,128303,131432,2679,2679,0,,,19/1/2022 7:23
29/8/2021,Nakhon Pathom,382,27078,921500,442584,478916,2714,2714,0,39,20,19/1/2022 7:23
29/8/2021,Nakhon Phanom,22,4371,717048,357194,359854,3548,3548,0,,,19/1/2022 7:23
29/8/2021,Nakhon Ratchasima,452,17754,2633733,1293977,1339756,88532,87939,593,50,22,19/1/2022 7:23
29/8/2021,Nakhon Si Thammarat,194,7546,1549496,764523,784973,7996,7996,0,,,19/1/2022 7:23
29/8/2021,Nakhon Sawan,114,7993,1036534,505545,530989,15946,15946,0,39,34,19/1/2022 7:23
29/8/2021,Nonthaburi,593,51808,1285013,597870,687143,2822,2815,7,18,18,19/1/2022 7:23
29/8/2021,Narathiwat,194,13115,808758,400002,408756,421,421,0,51,23,19/1/2022 7:23
29/8/2021,Nan,6,2162,475941,238073,237868,9832,9798,34,,,19/1/2022 7:23
29/8/2021,Bueng Kan,12,1635,421931,211488,210443,2114,2114,0,,,19/1/2022 7:23
29/8/2021,Buri Ram,243,12828,1579709,783665,796044,12087,12044,43,,,19/1/2022 7:23
29/8/2021,Pathum Thani,287,33510,1185082,561507,623575,1319,1306,13,41,25,19/1/2022 7:23
29/8/2021,Prachuap Khiri Khan,393,8234,552888,274321,278567,13974,13921,53,,,19/1/2022 7:23
29/8/2021,Prachin Buri,192,8072,494505,244150,250355,3143,3143,0,46,26,19/1/2022 7:23
29/8/2021,Pattani,300,15188,728801,359974,368827,517,517,0,,,19/1/2022 7:23
29/8/2021,Phra Nakhon Si Ayutthaya,376,20311,819892,393788,426104,17000,16958,42,20,36,19/1/2022 7:23
29/8/2021,Phayao,3,1547,465390,226498,238892,9277,9277,0,36,15,19/1/2022 7:23
29/8/2021,Phang-nga,5,1050,268269,133881,134388,7037,5969,1068,,,19/1/2022 7:23
29/8/2021,Phatthalung,75,2673,522612,254531,268081,1598,1598,0,,,19/1/2022 7:23
29/8/2021,Phichit,53,3331,530258,258492,271766,6914,6914,0,,,19/1/2022 7:23
29/8/2021,Phitsanulok,24,3610,847684,414983,432701,25715,25564,151,,,19/1/2022 7:23
29/8/2021,Phuket,212,3979,418055,197662,220393,33530,18204,15326,57,26,19/1/2022 7:23
29/8/2021,Maha Sarakham,73,8528,949783,465624,484159,2772,2772,0,,,19/1/2022 7:23
29/8/2021,Mukdahan,15,1827,351259,175474,175785,5322,5322,0,,,19/1/2022 7:23
29/8/2021,Yala,208,11656,541494,269636,271858,438,438,0,52,20,19/1/2022 7:23
29/8/2021,Yasothon,26,4276,533506,266189,267317,1561,1561,0,,,19/1/2022 7:23
29/8/2021,Ranong,158,5767,194677,98263,96414,1369,1369,0,,,19/1/2022 7:23
29/8/2021,Rayong,356,17606,748943,367783,381160,18635,18409,226,35,22,19/1/2022 7:23
29/8/2021,Ratchaburi,465,16306,869099,422558,446541,7187,7187,0,,,19/1/2022 7:23
29/8/2021,Roi Et,139,11371,1296428,642234,654194,2700,2700,0,,,19/1/2022 7:23
29/8/2021,Lop Buri,179,10778,740487,369278,371209,7057,7028,29,,,19/1/2022 7:23
29/8/2021,Lampang,8,2000,726261,353817,372444,6862,6727,135,44,17,19/1/2022 7:23
29/8/2021,Lamphun,8,1139,401525,192998,208527,7455,7381,74,,,19/1/2022 7:23
29/8/2021,Si Sa Ket,118,12314,1456985,725190,731795,3838,3838,0,,,19/1/2022 7:23
29/8/2021,Sakon Nakhon,44,6049,1146507,569654,576853,4675,4675,0,,,19/1/2022 7:23
29/8/2021,Songkhla,352,20141,1430543,696923,733620,1132,1132,0,73,31,19/1/2022 7:23
29/8/2021,Satun,27,1312,324496,161423,163073,1183,1170,13,53,28,19/1/2022 7:23
29/8/2021,Samut Prakarn,984,80164,1355823,645868,709955,1887,1860,27,,,19/1/2022 7:23
29/8/2021,Samut Songkhram,137,7681,191276,91338,99938,4546,4546,0,23,10,19/1/2022 7:23
29/8/2021,Samut Sakhon,872,90033,585685,282240,303445,1338,1338,0,32,24,19/1/2022 7:23
29/8/2021,Saraburi,247,19340,643873,316304,327569,9794,9776,18,41,75,19/1/2022 7:23
29/8/2021,Sa kaeo,199,9227,561509,280362,281147,2377,2377,0,18,16,19/1/2022 7:23
29/8/2021,Sing Buri,14,2064,205088,97428,107660,3064,3064,0,,,19/1/2022 7:23
29/8/2021,Suphan Buri,92,10079,836435,403512,432923,6542,6542,0,,,19/1/2022 7:23
29/8/2021,Surat Thani,176,6472,1071496,527024,544472,4790,4115,675,69,25,19/1/2022 7:23
29/8/2021,Surin,168,11959,1376723,684837,691886,8153,8131,22,,,19/1/2022 7:23
29/8/2021,Sukhothai,42,4451,585851,283686,302165,4868,4868,0,,,19/1/2022 7:23
29/8/2021,Nong Khai,10,2226,516896,256327,260569,6520,6513,7,29,12,19/1/2022 7:23
29/8/2021,Nong Bua Lam Phu,22,3265,508942,253805,255137,1487,1487,0,,,19/1/2022 7:23
29/8/2021,Amnat Charoen,17,2500,376228,187133,189095,1440,1440,0,,,19/1/2022 7:23
29/8/2021,Udon Thani,150,9237,1566940,776022,790918,9291,9282,9,,,19/1/2022 7:23
29/8/2021,Uttaradit,9,3021,447089,217944,229145,6329,6329,0,,,19/1/2022 7:23
29/8/2021,Uthai Thani,48,2829,325254,158926,166328,2279,2279,0,,,19/1/2022 7:23
29/8/2021,Ubon Ratchathani,190,13994,1867365,932174,935191,7252,7252,0,34,18,19/1/2022 7:23
29/8/2021,Ang Thong,123,8357,275476,131801,143675,962,962,0,,,19/1/2022 7:23
29/8/2021,Chiang Rai,25,2951,1297168,630483,666685,28142,27897,245,27,10,19/1/2022 7:23
29/8/2021,Chiang Mai,49,11145,1787281,863640,923641,68614,67650,964,45,24,19/1/2022 7:23
29/8/2021,Phetchaburi,93,15105,482600,232958,249642,12139,12096,43,,,19/1/2022 7:23
29/8/2021,Phetchabun,140,5732,979033,482878,496155,20292,20262,30,,,19/1/2022 7:23
29/8/2021,Loei,22,2541,638862,320119,318743,5789,5778,11,22,13,19/1/2022 7:23
29/8/2021,Phrae,12,1354,435481,209872,225609,5872,5872,0,33,14,19/1/2022 7:23
29/8/2021,Mae Hong Son,0,278,285778,144757,141021,8861,8659,202,19,9,19/1/2022 7:23
29/8/2021,,0,153,,,,,,,,,19/1/2022 7:23
30/8/2021,Krabi,40,1616,478664,237717,240947,2096,1981,115,,,19/1/2022 7:23
30/8/2021,Bangkok,3775,303516,5544789,2601856,2942933,202959,181431,21528,50,27,19/1/2022 7:23
30/8/2021,Kanchanaburi,336,12463,893129,447919,445210,20185,20157,28,33,16,19/1/2022 7:23
30/8/2021,Kalasin,44,6870,976083,482351,493732,2306,2306,0,,,19/1/2022 7:23
30/8/2021,Kamphaeng Phet,33,5916,712600,351801,360799,6769,6769,0,,,19/1/2022 7:23
30/8/2021,Khon Kaen,112,9967,1791967,880624,911343,21098,21098,0,51,28,19/1/2022 7:23
30/8/2021,Chanthaburi,82,5821,536132,262097,274035,17881,17815,66,,,19/1/2022 7:23
30/8/2021,Chachoengsao,252,25763,722615,354177,368438,1995,1995,0,45,32,19/1/2022 7:23
30/8/2021,Chon Buri,748,64275,1580389,771364,809025,30270,29695,575, ,26,19/1/2022 7:23
30/8/2021,Chai Nat,15,1932,321015,154292,166723,4171,4171,0,,,19/1/2022 7:23
30/8/2021,Chaiyaphum,79,7850,1122780,554646,568134,13695,13682,13,,,19/1/2022 7:23
30/8/2021,Chumphon,104,4008,509292,251346,257946,1644,1644,0,,,19/1/2022 7:23
30/8/2021,Trang,72,4098,639931,312837,327094,2469,2469,0,,,19/1/2022 7:23
30/8/2021,Trat,54,2204,228459,112922,115537,22368,22277,91,,,19/1/2022 7:23
30/8/2021,Tak,165,10655,674616,341111,333505,12606,12606,0,,,19/1/2022 7:23
30/8/2021,Nakhon Nayok,37,8062,259735,128303,131432,2679,2679,0,,,19/1/2022 7:23
30/8/2021,Nakhon Pathom,278,27356,921500,442584,478916,2714,2714,0,38,25,19/1/2022 7:23
30/8/2021,Nakhon Phanom,37,4408,717048,357194,359854,3548,3548,0,,,19/1/2022 7:23
30/8/2021,Nakhon Ratchasima,418,18172,2633733,1293977,1339756,88532,87939,593,54,23,19/1/2022 7:23
30/8/2021,Nakhon Si Thammarat,147,7693,1549496,764523,784973,7996,7996,0,,,19/1/2022 7:23
30/8/2021,Nakhon Sawan,103,8096,1036534,505545,530989,15946,15946,0,68,26,19/1/2022 7:23
30/8/2021,Nonthaburi,375,52183,1285013,597870,687143,2822,2815,7,29,24,19/1/2022 7:23
30/8/2021,Narathiwat,208,13323,808758,400002,408756,421,421,0,54,19,19/1/2022 7:23
30/8/2021,Nan,27,2189,475941,238073,237868,9832,9798,34,,,19/1/2022 7:23
30/8/2021,Bueng Kan,6,1641,421931,211488,210443,2114,2114,0,,,19/1/2022 7:23
30/8/2021,Buri Ram,389,13217,1579709,783665,796044,12087,12044,43,,,19/1/2022 7:23
30/8/2021,Pathum Thani,278,33788,1185082,561507,623575,1319,1306,13,45, ,19/1/2022 7:23
30/8/2021,Prachuap Khiri Khan,73,8307,552888,274321,278567,13974,13921,53,,,19/1/2022 7:23
30/8/2021,Prachin Buri,74,8146,494505,244150,250355,3143,3143,0,58,28,19/1/2022 7:23
30/8/2021,Pattani,157,15345,728801,359974,368827,517,517,0,,,19/1/2022 7:23
30/8/2021,Phra Nakhon Si Ayutthaya,405,20716,819892,393788,426104,17000,16958,42,46,45,19/1/2022 7:23
30/8/2021,Phayao,6,1553,465390,226498,238892,9277,9277,0,42,18,19/1/2022 7:23
30/8/2021,Phang-nga,7,1057,268269,133881,134388,7037,5969,1068,,,19/1/2022 7:23
30/8/2021,Phatthalung,34,2707,522612,254531,268081,1598,1598,0,,,19/1/2022 7:23
30/8/2021,Phichit,54,3385,530258,258492,271766,6914,6914,0,,,19/1/2022 7:23
30/8/2021,Phitsanulok,22,3632,847684,414983,432701,25715,25564,151,,,19/1/2022 7:23
30/8/2021,Phuket,164,4143,418055,197662,220393,33530,18204,15326,61,20,19/1/2022 7:23
30/8/2021,Maha Sarakham,25,8553,949783,465624,484159,2772,2772,0,,,19/1/2022 7:23
30/8/2021,Mukdahan,9,1836,351259,175474,175785,5322,5322,0,,,19/1/2022 7:23
30/8/2021,Yala,190,11846,541494,269636,271858,438,438,0,44,17,19/1/2022 7:23
30/8/2021,Yasothon,46,4322,533506,266189,267317,1561,1561,0,,,19/1/2022 7:23
30/8/2021,Ranong,151,5918,194677,98263,96414,1369,1369,0,,,19/1/2022 7:23
30/8/2021,Rayong,558,18164,748943,367783,381160,18635,18409,226,30,27,19/1/2022 7:23
30/8/2021,Ratchaburi,780,17086,869099,422558,446541,7187,7187,0,,,19/1/2022 7:23
30/8/2021,Roi Et,120,11491,1296428,642234,654194,2700,2700,0,,,19/1/2022 7:23
30/8/2021,Lop Buri,176,10954,740487,369278,371209,7057,7028,29,,,19/1/2022 7:23
30/8/2021,Lampang,14,2014,726261,353817,372444,6862,6727,135,55,16,19/1/2022 7:23
30/8/2021,Lamphun,7,1146,401525,192998,208527,7455,7381,74,,,19/1/2022 7:23
30/8/2021,Si Sa Ket,101,12415,1456985,725190,731795,3838,3838,0,,,19/1/2022 7:23
30/8/2021,Sakon Nakhon,62,6111,1146507,569654,576853,4675,4675,0,,,19/1/2022 7:23
30/8/2021,Songkhla,332,20473,1430543,696923,733620,1132,1132,0,64,26,19/1/2022 7:23
30/8/2021,Satun,19,1331,324496,161423,163073,1183,1170,13,58,27,19/1/2022 7:23
30/8/2021,Samut Prakarn,1055,81219,1355823,645868,709955,1887,1860,27,,,19/1/2022 7:23
30/8/2021,Samut Songkhram,178,7859,191276,91338,99938,4546,4546,0,18,17,19/1/2022 7:23
30/8/2021,Samut Sakhon,966,90999,585685,282240,303445,1338,1338,0,51,35,19/1/2022 7:23
30/8/2021,Saraburi,277,19617,643873,316304,327569,9794,9776,18,71,75,19/1/2022 7:23
30/8/2021,Sa kaeo,109,9336,561509,280362,281147,2377,2377,0,18,17,19/1/2022 7:23
30/8/2021,Sing Buri,20,2084,205088,97428,107660,3064,3064,0,,,19/1/2022 7:23
30/8/2021,Suphan Buri,153,10232,836435,403512,432923,6542,6542,0,,,19/1/2022 7:23
30/8/2021,Surat Thani,174,6646,1071496,527024,544472,4790,4115,675,79,26,19/1/2022 7:23
30/8/2021,Surin,246,12205,1376723,684837,691886,8153,8131,22,,,19/1/2022 7:23
30/8/2021,Sukhothai,31,4482,585851,283686,302165,4868,4868,0,,,19/1/2022 7:23
30/8/2021,Nong Khai,29,2255,516896,256327,260569,6520,6513,7,31,8,19/1/2022 7:23
30/8/2021,Nong Bua Lam Phu,24,3289,508942,253805,255137,1487,1487,0,,,19/1/2022 7:23
30/8/2021,Amnat Charoen,12,2512,376228,187133,189095,1440,1440,0,,,19/1/2022 7:23
30/8/2021,Udon Thani,174,9411,1566940,776022,790918,9291,9282,9,,,19/1/2022 7:23
30/8/2021,Uttaradit,15,3036,447089,217944,229145,6329,6329,0,,,19/1/2022 7:23
30/8/2021,Uthai Thani,81,2910,325254,158926,166328,2279,2279,0,,,19/1/2022 7:23
30/8/2021,Ubon Ratchathani,127,14121,1867365,932174,935191,7252,7252,0,38,14,19/1/2022 7:23
30/8/2021,Ang Thong,170,8527,275476,131801,143675,962,962,0,,,19/1/2022 7:23
30/8/2021,Chiang Rai,30,2981,1297168,630483,666685,28142,27897,245,39,7,19/1/2022 7:23
30/8/2021,Chiang Mai,31,11176,1787281,863640,923641,68614,67650,964,50,24,19/1/2022 7:23
30/8/2021,Phetchaburi,93,15198,482600,232958,249642,12139,12096,43,,,19/1/2022 7:23
30/8/2021,Phetchabun,130,5862,979033,482878,496155,20292,20262,30,,,19/1/2022 7:23
30/8/2021,Loei,26,2567,638862,320119,318743,5789,5778,11,22,13,19/1/2022 7:23
30/8/2021,Phrae,17,1371,435481,209872,225609,5872,5872,0,33,14,19/1/2022 7:23
30/8/2021,Mae Hong Son,4,282,285778,144757,141021,8861,8659,202,33,12,19/1/2022 7:23
30/8/2021,,0,153,,,,,,,,,19/1/2022 7:23
31/8/2021,Krabi,6,1622,478664,237717,240947,2096,1981,115,,,19/1/2022 7:23
31/8/2021,Bangkok,3989,307505,5544789,2601856,2942933,202959,181431,21528,61,29,19/1/2022 7:23
31/8/2021,Kanchanaburi,216,12679,893129,447919,445210,20185,20157,28,33,8,19/1/2022 7:23
31/8/2021,Kalasin,38,6908,976083,482351,493732,2306,2306,0,,,19/1/2022 7:23
31/8/2021,Kamphaeng Phet,90,6006,712600,351801,360799,6769,6769,0,,,19/1/2022 7:23
31/8/2021,Khon Kaen,110,10077,1791967,880624,911343,21098,21098,0,59,26,19/1/2022 7:23
31/8/2021,Chanthaburi,89,5910,536132,262097,274035,17881,17815,66,,,19/1/2022 7:23
31/8/2021,Chachoengsao,222,25985,722615,354177,368438,1995,1995,0,50,29,19/1/2022 7:23
31/8/2021,Chon Buri,746,65021,1580389,771364,809025,30270,29695,575,39,24,19/1/2022 7:23
31/8/2021,Chai Nat,12,1944,321015,154292,166723,4171,4171,0,,,19/1/2022 7:23
31/8/2021,Chaiyaphum,67,7917,1122780,554646,568134,13695,13682,13,,,19/1/2022 7:23
31/8/2021,Chumphon,117,4125,509292,251346,257946,1644,1644,0,,,19/1/2022 7:23
31/8/2021,Trang,77,4175,639931,312837,327094,2469,2469,0,,,19/1/2022 7:23
31/8/2021,Trat,49,2253,228459,112922,115537,22368,22277,91,,,19/1/2022 7:23
31/8/2021,Tak,105,10760,674616,341111,333505,12606,12606,0,,,19/1/2022 7:23
31/8/2021,Nakhon Nayok,54,8116,259735,128303,131432,2679,2679,0,,,19/1/2022 7:23
31/8/2021,Nakhon Pathom,273,27629,921500,442584,478916,2714,2714,0,54,16,19/1/2022 7:23
31/8/2021,Nakhon Phanom,29,4437,717048,357194,359854,3548,3548,0,,,19/1/2022 7:23
31/8/2021,Nakhon Ratchasima,300,18472,2633733,1293977,1339756,88532,87939,593,52,20,19/1/2022 7:23
31/8/2021,Nakhon Si Thammarat,119,7812,1549496,764523,784973,7996,7996,0,,,19/1/2022 7:23
31/8/2021,Nakhon Sawan,183,8279,1036534,505545,530989,15946,15946,0,49,23,19/1/2022 7:23
31/8/2021,Nonthaburi,488,52671,1285013,597870,687143,2822,2815,7,47,22,19/1/2022 7:23
31/8/2021,Narathiwat,229,13552,808758,400002,408756,421,421,0,44,24,19/1/2022 7:23
31/8/2021,Nan,6,2195,475941,238073,237868,9832,9798,34,,,19/1/2022 7:23
31/8/2021,Bueng Kan,8,1649,421931,211488,210443,2114,2114,0,,,19/1/2022 7:23
31/8/2021,Buri Ram,248,13465,1579709,783665,796044,12087,12044,43,,,19/1/2022 7:23
31/8/2021,Pathum Thani,218,34006,1185082,561507,623575,1319,1306,13,,,19/1/2022 7:23
31/8/2021,Prachuap Khiri Khan,44,8351,552888,274321,278567,13974,13921,53,,,19/1/2022 7:23
31/8/2021,Prachin Buri,145,8291,494505,244150,250355,3143,3143,0,64,24,19/1/2022 7:23
31/8/2021,Pattani,171,15516,728801,359974,368827,517,517,0,,,19/1/2022 7:23
31/8/2021,Phra Nakhon Si Ayutthaya,308,21024,819892,393788,426104,17000,16958,42,62,39,19/1/2022 7:23
31/8/2021,Phayao,7,1560,465390,226498,238892,9277,9277,0,45,16,19/1/2022 7:23
31/8/2021,Phang-nga,6,1063,268269,133881,134388,7037,5969,1068,,,19/1/2022 7:23
31/8/2021,Phatthalung,107,2814,522612,254531,268081,1598,1598,0,,,19/1/2022 7:23
31/8/2021,Phichit,23,3408,530258,258492,271766,6914,6914,0,,,19/1/2022 7:23
31/8/2021,Phitsanulok,43,3675,847684,414983,432701,25715,25564,151,,,19/1/2022 7:23
31/8/2021,Phuket,260,4403,418055,197662,220393,33530,18204,15326,50,20,19/1/2022 7:23
31/8/2021,Maha Sarakham,19,8572,949783,465624,484159,2772,2772,0,,,19/1/2022 7:23
31/8/2021,Mukdahan,16,1852,351259,175474,175785,5322,5322,0,,,19/1/2022 7:23
31/8/2021,Yala,98,11944,541494,269636,271858,438,438,0,40,24,19/1/2022 7:23
31/8/2021,Yasothon,46,4368,533506,266189,267317,1561,1561,0,,,19/1/2022 7:23
31/8/2021,Ranong,143,6061,194677,98263,96414,1369,1369,0,,,19/1/2022 7:23
31/8/2021,Rayong,203,18367,748943,367783,381160,18635,18409,226,36,100,19/1/2022 7:23
31/8/2021,Ratchaburi,490,17576,869099,422558,446541,7187,7187,0,,,19/1/2022 7:23
31/8/2021,Roi Et,84,11575,1296428,642234,654194,2700,2700,0,,,19/1/2022 7:23
31/8/2021,Lop Buri,120,11074,740487,369278,371209,7057,7028,29,,,19/1/2022 7:23
31/8/2021,Lampang,5,2019,726261,353817,372444,6862,6727,135,47,17,19/1/2022 7:23
31/8/2021,Lamphun,3,1149,401525,192998,208527,7455,7381,74,,,19/1/2022 7:23
31/8/2021,Si Sa Ket,103,12518,1456985,725190,731795,3838,3838,0,,,19/1/2022 7:23
31/8/2021,Sakon Nakhon,29,6140,1146507,569654,576853,4675,4675,0,,,19/1/2022 7:23
31/8/2021,Songkhla,273,20746,1430543,696923,733620,1132,1132,0,54,33,19/1/2022 7:23
31/8/2021,Satun,26,1357,324496,161423,163073,1183,1170,13,46,22,19/1/2022 7:23
31/8/2021,Samut Prakarn,1402,82621,1355823,645868,709955,1887,1860,27,,,19/1/2022 7:23
31/8/2021,Samut Songkhram,148,8007,191276,91338,99938,4546,4546,0,33,15,19/1/2022 7:23
31/8/2021,Samut Sakhon,983,91982,585685,282240,303445,1338,1338,0,72,31,19/1/2022 7:23
31/8/2021,Saraburi,88,19705,643873,316304,327569,9794,9776,18,71,72,19/1/2022 7:23
31/8/2021,Sa kaeo,25,9361,561509,280362,281147,2377,2377,0,31,16,19/1/2022 7:23
31/8/2021,Sing Buri,12,2096,205088,97428,107660,3064,3064,0,,,19/1/2022 7:23
31/8/2021,Suphan Buri,94,10326,836435,403512,432923,6542,6542,0,,,19/1/2022 7:23
31/8/2021,Surat Thani,115,6761,1071496,527024,544472,4790,4115,675,64,25,19/1/2022 7:23
31/8/2021,Surin,238,12443,1376723,684837,691886,8153,8131,22,,,19/1/2022 7:23
31/8/2021,Sukhothai,10,4492,585851,283686,302165,4868,4868,0,,,19/1/2022 7:23
31/8/2021,Nong Khai,10,2265,516896,256327,260569,6520,6513,7,21,7,19/1/2022 7:23
31/8/2021,Nong Bua Lam Phu,26,3315,508942,253805,255137,1487,1487,0,,,19/1/2022 7:23
31/8/2021,Amnat Charoen,11,2523,376228,187133,189095,1440,1440,0,,,19/1/2022 7:23
31/8/2021,Udon Thani,108,9519,1566940,776022,790918,9291,9282,9,,,19/1/2022 7:23
31/8/2021,Uttaradit,24,3060,447089,217944,229145,6329,6329,0,,,19/1/2022 7:23
31/8/2021,Uthai Thani,21,2931,325254,158926,166328,2279,2279,0,,,19/1/2022 7:23
31/8/2021,Ubon Ratchathani,125,14246,1867365,932174,935191,7252,7252,0,31,17,19/1/2022 7:23
31/8/2021,Ang Thong,58,8585,275476,131801,143675,962,962,0,,,19/1/2022 7:23
31/8/2021,Chiang Rai,20,3001,1297168,630483,666685,28142,27897,245,25,12,19/1/2022 7:23
31/8/2021,Chiang Mai,34,11210,1787281,863640,923641,68614,67650,964,54,26,19/1/2022 7:23
31/8/2021,Phetchaburi,47,15245,482600,232958,249642,12139,12096,43,,,19/1/2022 7:23
31/8/2021,Phetchabun,174,6036,979033,482878,496155,20292,20262,30,,,19/1/2022 7:23
31/8/2021,Loei,20,2587,638862,320119,318743,5789,5778,11,22,15,19/1/2022 7:23
31/8/2021,Phrae,8,1379,435481,209872,225609,5872,5872,0,34,12,19/1/2022 7:23
31/8/2021,Mae Hong Son,5,287,285778,144757,141021,8861,8659,202,46,8,19/1/2022 7:23
31/8/2021,,0,153,,,,,,,,,19/1/2022 7:23
1/9/2021,Krabi,18,1640,478854,237878,240976,4086,3912,174,,,19/1/2022 7:23
1/9/2021,Bangkok,3734,311239,5538629,2598539,2940090,448391,422787,25604,62,25,19/1/2022 7:23
1/9/2021,Kanchanaburi,224,12903,894044,448524,445520,190781,190728,53,19,9,19/1/2022 7:23
1/9/2021,Kalasin,33,6941,976025,482401,493624,4757,4757,0,,,19/1/2022 7:23
1/9/2021,Kamphaeng Phet,21,6027,712444,351736,360708,7679,7679,0,,,19/1/2022 7:23
1/9/2021,Khon Kaen,121,10198,1791794,880418,911376,36884,36884,0,56,33,19/1/2022 7:23
1/9/2021,Chanthaburi,146,6056,536411,262228,274183,24937,24842,95,,,19/1/2022 7:23
1/9/2021,Chachoengsao,332,26317,723178,354451,368727,7480,7480,0,54,29,19/1/2022 7:23
1/9/2021,Chon Buri,879,65900,1581618,771595,810023,119870,119059,811,43,22,19/1/2022 7:23
1/9/2021,Chai Nat,20,1964,320948,154287,166661,11052,11052,0,,,19/1/2022 7:23
1/9/2021,Chaiyaphum,61,7978,1122539,554554,567985,16842,16813,29,,,19/1/2022 7:23
1/9/2021,Chumphon,224,4349,509344,251379,257965,2620,2620,0,,,19/1/2022 7:23
1/9/2021,Trang,84,4259,639876,312767,327109,5191,5191,0,,,19/1/2022 7:23
1/9/2021,Trat,102,2355,228450,112952,115498,33159,33006,153,,,19/1/2022 7:23
1/9/2021,Tak,159,10919,675112,341344,333768,18741,18741,0,,,19/1/2022 7:23
1/9/2021,Nakhon Nayok,103,8219,260238,128796,131442,6150,6150,0,,,19/1/2022 7:23
1/9/2021,Nakhon Pathom,161,27790,921861,442674,479187,17076,17058,18,44,17,19/1/2022 7:23
1/9/2021,Nakhon Phanom,13,4450,717043,357140,359903,9839,9839,0,,,19/1/2022 7:23
1/9/2021,Nakhon Ratchasima,333,18805,2634005,1293977,1340028,158830,157909,921,48,24,19/1/2022 7:23
1/9/2021,Nakhon Si Thammarat,83,7895,1549321,764443,784878,9361,9361,0,,,19/1/2022 7:23
1/9/2021,Nakhon Sawan,79,8358,1036053,505240,530813,18756,18756,0,47,25,19/1/2022 7:23
1/9/2021,Nonthaburi,217,52888,1285994,598164,687830,13326,13275,51,48,14,19/1/2022 7:23
1/9/2021,Narathiwat,317,13869,808908,400179,408729,945,945,0,45,17,19/1/2022 7:23
1/9/2021,Nan,9,2204,475915,238017,237898,21353,21281,72,,,19/1/2022 7:23
1/9/2021,Bueng Kan,3,1652,421910,211455,210455,2662,2662,0,,,19/1/2022 7:23
1/9/2021,Buri Ram,87,13552,1579547,783516,796031,22217,22141,76,,,19/1/2022 7:23
1/9/2021,Pathum Thani,275,34281,1186767,562265,624502,10969,10893,76,,,19/1/2022 7:23
1/9/2021,Prachuap Khiri Khan,34,8385,553460,274610,278850,78909,78814,95,,,19/1/2022 7:23
1/9/2021,Prachin Buri,155,8446,494821,244371,250450,7010,7010,0,57,30,19/1/2022 7:23
1/9/2021,Pattani,189,15705,728989,360071,368918,1410,1410,0,,,19/1/2022 7:23
1/9/2021,Phra Nakhon Si Ayutthaya,492,21516,820211,393877,426334,63382,63260,122,49,35,19/1/2022 7:23
1/9/2021,Phayao,12,1572,465194,226350,238844,12520,12407,113,31,14,19/1/2022 7:23
1/9/2021,Phang-nga,14,1077,268130,133856,134274,11169,9671,1498,,,19/1/2022 7:23
1/9/2021,Phatthalung,32,2846,522511,254483,268028,1958,1958,0,,,19/1/2022 7:23
1/9/2021,Phichit,13,3421,530097,258414,271683,7058,7058,0,,,19/1/2022 7:23
1/9/2021,Phitsanulok,48,3723,847460,414773,432687,33623,33466,157,,,19/1/2022 7:23
1/9/2021,Phuket,116,4519,419217,198181,221036,85481,60028,25453,49,21,19/1/2022 7:23
1/9/2021,Maha Sarakham,70,8642,949461,465434,484027,4086,4086,0,,,19/1/2022 7:23
1/9/2021,Mukdahan,9,1861,351274,175455,175819,17246,17246,0,,,19/1/2022 7:23
1/9/2021,Yala,197,12141,541791,269774,272017,710,710,0,54,20,19/1/2022 7:23
1/9/2021,Yasothon,52,4420,533435,266108,267327,3724,3724,0,,,19/1/2022 7:23
1/9/2021,Ranong,128,6189,194674,98251,96423,2582,2582,0,,,19/1/2022 7:23
1/9/2021,Rayong,547,18914,749481,368005,381476,24688,24442,246,41,126,19/1/2022 7:23
1/9/2021,Ratchaburi,418,17994,868959,422400,446559,30897,30897,0,,,19/1/2022 7:23
1/9/2021,Roi Et,89,11664,1296274,642169,654105,3672,3672,0,,,19/1/2022 7:23
1/9/2021,Lop Buri,124,11198,740199,368985,371214,24082,24044,38,,,19/1/2022 7:23
1/9/2021,Lampang,16,2035,725923,353601,372322,9312,9210,102,53,17,19/1/2022 7:23
1/9/2021,Lamphun,12,1161,401450,192935,208515,8920,8828,92,,,19/1/2022 7:23
1/9/2021,Si Sa Ket,110,12628,1456968,725147,731821,15417,15417,0,,,19/1/2022 7:23
1/9/2021,Sakon Nakhon,87,6227,1146233,569519,576714,10521,10521,0,,,19/1/2022 7:23
1/9/2021,Songkhla,290,21036,1431271,697260,734011,1827,1827,0,64,31,19/1/2022 7:23
1/9/2021,Satun,4,1361,324578,161454,163124,1995,1995,0,44,25,19/1/2022 7:23
1/9/2021,Samut Prakarn,1284,83905,1355935,645831,710104,12413,12329,84,,,19/1/2022 7:23
1/9/2021,Samut Songkhram,107,8114,191160,91278,99882,31388,31388,0,32,14,19/1/2022 7:23
1/9/2021,Samut Sakhon,864,92846,585760,282297,303463,7943,7943,0,67,28,19/1/2022 7:23
1/9/2021,Saraburi,126,19831,644131,316501,327630,30780,30737,43,72,62,19/1/2022 7:23
1/9/2021,Sa kaeo,125,9486,561572,280341,281231,4108,4108,0,25,16,19/1/2022 7:23
1/9/2021,Sing Buri,13,2109,204996,97383,107613,9410,9410,0,,,19/1/2022 7:23
1/9/2021,Suphan Buri,83,10409,835999,403285,432714,30584,30584,0,,,19/1/2022 7:23
1/9/2021,Surat Thani,128,6889,1072025,527245,544780,4772,3619,1153,74,24,19/1/2022 7:23
1/9/2021,Surin,222,12665,1376610,684728,691882,9296,9269,27,,,19/1/2022 7:23
1/9/2021,Sukhothai,41,4533,585695,283594,302101,6514,6514,0,,,19/1/2022 7:23
1/9/2021,Nong Khai,23,2288,516903,256356,260547,11497,11490,7,16,13,19/1/2022 7:23
1/9/2021,Nong Bua Lam Phu,59,3374,508929,253795,255134,1880,1880,0,,,19/1/2022 7:23
1/9/2021,Amnat Charoen,7,2530,376291,187148,189143,2964,2964,0,,,19/1/2022 7:23
1/9/2021,Udon Thani,83,9602,1566740,775793,790947,11621,11611,10,,,19/1/2022 7:23
1/9/2021,Uttaradit,24,3084,446754,217769,228985,7108,7108,0,,,19/1/2022 7:23
1/9/2021,Uthai Thani,22,2953,325202,158940,166262,2630,2630,0,,,19/1/2022 7:23
1/9/2021,Ubon Ratchathani,72,14318,1867421,932017,935404,25612,25612,0,32,19,19/1/2022 7:23
1/9/2021,Ang Thong,46,8631,275337,131732,143605,5978,5978,0,,,19/1/2022 7:23
1/9/2021,Chiang Rai,47,3048,1297567,630638,666929,52280,52001,279,45,9,19/1/2022 7:23
1/9/2021,Chiang Mai,27,11237,1787951,863847,924104,149552,148477,1075,60,27,19/1/2022 7:23
1/9/2021,Phetchaburi,116,15361,482635,232935,249700,88893,88804,89,,,19/1/2022 7:23
1/9/2021,Phetchabun,172,6208,978763,482612,496151,26514,26475,39,,,19/1/2022 7:23
1/9/2021,Loei,13,2600,638822,320038,318784,13785,13770,15,21,13,19/1/2022 7:23
1/9/2021,Phrae,2,1381,435288,209765,225523,11993,11993,0,27,18,19/1/2022 7:23
1/9/2021,Mae Hong Son,0,287,285937,144838,141099,11764,11539,225,36,6,19/1/2022 7:23
1/9/2021,,0,153,,,,,,,,,19/1/2022 7:23
2/9/2021,Krabi,24,1664,478854,237878,240976,4086,3912,174,,,19/1/2022 7:23
2/9/2021,Bangkok,3357,314596,5538629,2598539,2940090,448391,422787,25604,45,20,19/1/2022 7:23
2/9/2021,Kanchanaburi,265,13168,894044,448524,445520,190781,190728,53,23,7,19/1/2022 7:23
2/9/2021,Kalasin,24,6965,976025,482401,493624,4757,4757,0,,,19/1/2022 7:23
2/9/2021,Kamphaeng Phet,47,6074,712444,351736,360708,7679,7679,0,,,19/1/2022 7:23
2/9/2021,Khon Kaen,151,10349,1791794,880418,911376,36884,36884,0,62,29,19/1/2022 7:23
2/9/2021,Chanthaburi,133,6189,536411,262228,274183,24937,24842,95,,,19/1/2022 7:23
2/9/2021,Chachoengsao,266,26583,723178,354451,368727,7480,7480,0,60,25,19/1/2022 7:23
2/9/2021,Chon Buri,888,66788,1581618,771595,810023,119870,119059,811,40,25,19/1/2022 7:23
2/9/2021,Chai Nat,17,1981,320948,154287,166661,11052,11052,0,,,19/1/2022 7:23
2/9/2021,Chaiyaphum,46,8024,1122539,554554,567985,16842,16813,29,,,19/1/2022 7:23
2/9/2021,Chumphon,145,4494,509344,251379,257965,2620,2620,0,,,19/1/2022 7:23
2/9/2021,Trang,37,4296,639876,312767,327109,5191,5191,0,,,19/1/2022 7:23
2/9/2021,Trat,95,2450,228450,112952,115498,33159,33006,153,,,19/1/2022 7:23
2/9/2021,Tak,161,11080,675112,341344,333768,18741,18741,0,,,19/1/2022 7:23
2/9/2021,Nakhon Nayok,118,8337,260238,128796,131442,6150,6150,0,,,19/1/2022 7:23
2/9/2021,Nakhon Pathom,341,28131,921861,442674,479187,17076,17058,18,41,11,19/1/2022 7:23
2/9/2021,Nakhon Phanom,22,4472,717043,357140,359903,9839,9839,0,,,19/1/2022 7:23
2/9/2021,Nakhon Ratchasima,280,19085,2634005,1293977,1340028,158830,157909,921,53,24,19/1/2022 7:23
2/9/2021,Nakhon Si Thammarat,194,8089,1549321,764443,784878,9361,9361,0,,,19/1/2022 7:23
2/9/2021,Nakhon Sawan,89,8447,1036053,505240,530813,18756,18756,0,49, ,19/1/2022 7:23
2/9/2021,Nonthaburi,275,53163,1285994,598164,687830,13326,13275,51,29,13,19/1/2022 7:23
2/9/2021,Narathiwat,442,14311,808908,400179,408729,945,945,0,36, ,19/1/2022 7:23
2/9/2021,Nan,13,2217,475915,238017,237898,21353,21281,72,,,19/1/2022 7:23
2/9/2021,Bueng Kan,5,1657,421910,211455,210455,2662,2662,0,,,19/1/2022 7:23
2/9/2021,Buri Ram,156,13708,1579547,783516,796031,22217,22141,76,,,19/1/2022 7:23
2/9/2021,Pathum Thani,193,34474,1186767,562265,624502,10969,10893,76,,,19/1/2022 7:23
2/9/2021,Prachuap Khiri Khan,71,8456,553460,274610,278850,78909,78814,95,,,19/1/2022 7:23
2/9/2021,Prachin Buri,176,8622,494821,244371,250450,7010,7010,0,62,23,19/1/2022 7:23
2/9/2021,Pattani,111,15816,728989,360071,368918,1410,1410,0,,,19/1/2022 7:23
2/9/2021,Phra Nakhon Si Ayutthaya,494,22010,820211,393877,426334,63382,63260,122,41,33,19/1/2022 7:23
2/9/2021,Phayao,6,1578,465194,226350,238844,12520,12407,113,32,16,19/1/2022 7:23
2/9/2021,Phang-nga,21,1098,268130,133856,134274,11169,9671,1498,,,19/1/2022 7:23
2/9/2021,Phatthalung,108,2954,522511,254483,268028,1958,1958,0,,,19/1/2022 7:23
2/9/2021,Phichit,48,3469,530097,258414,271683,7058,7058,0,,,19/1/2022 7:23
2/9/2021,Phitsanulok,30,3753,847460,414773,432687,33623,33466,157,,,19/1/2022 7:23
2/9/2021,Phuket,240,4759,419217,198181,221036,85481,60028,25453,53,27,19/1/2022 7:23
2/9/2021,Maha Sarakham,37,8679,949461,465434,484027,4086,4086,0,,,19/1/2022 7:23
2/9/2021,Mukdahan,8,1869,351274,175455,175819,17246,17246,0,,,19/1/2022 7:23
2/9/2021,Yala,276,12417,541791,269774,272017,710,710,0,44,21,19/1/2022 7:23
2/9/2021,Yasothon,44,4464,533435,266108,267327,3724,3724,0,,,19/1/2022 7:23
2/9/2021,Ranong,116,6305,194674,98251,96423,2582,2582,0,,,19/1/2022 7:23
2/9/2021,Rayong,340,19254,749481,368005,381476,24688,24442,246,41,21,19/1/2022 7:23
2/9/2021,Ratchaburi,349,18343,868959,422400,446559,30897,30897,0,,,19/1/2022 7:23
2/9/2021,Roi Et,91,11755,1296274,642169,654105,3672,3672,0,,,19/1/2022 7:23
2/9/2021,Lop Buri,135,11333,740199,368985,371214,24082,24044,38,,,19/1/2022 7:23
2/9/2021,Lampang,8,2043,725923,353601,372322,9312,9210,102,54,17,19/1/2022 7:23
2/9/2021,Lamphun,27,1188,401450,192935,208515,8920,8828,92,,,19/1/2022 7:23
2/9/2021,Si Sa Ket,147,12775,1456968,725147,731821,15417,15417,0,,,19/1/2022 7:23
2/9/2021,Sakon Nakhon,37,6264,1146233,569519,576714,10521,10521,0,,,19/1/2022 7:23
2/9/2021,Songkhla,254,21290,1431271,697260,734011,1827,1827,0,60,38,19/1/2022 7:23
2/9/2021,Satun,14,1375,324578,161454,163124,1995,1995,0,45,24,19/1/2022 7:23
2/9/2021,Samut Prakarn,1220,85125,1355935,645831,710104,12413,12329,84,,,19/1/2022 7:23
2/9/2021,Samut Songkhram,102,8216,191160,91278,99882,31388,31388,0,30,11,19/1/2022 7:23
2/9/2021,Samut Sakhon,733,93579,585760,282297,303463,7943,7943,0,47,31,19/1/2022 7:23
2/9/2021,Saraburi,310,20141,644131,316501,327630,30780,30737,43,64,48,19/1/2022 7:23
2/9/2021,Sa kaeo,102,9588,561572,280341,281231,4108,4108,0,23,18,19/1/2022 7:23
2/9/2021,Sing Buri,29,2138,204996,97383,107613,9410,9410,0,,,19/1/2022 7:23
2/9/2021,Suphan Buri,244,10653,835999,403285,432714,30584,30584,0,,,19/1/2022 7:23
2/9/2021,Surat Thani,134,7023,1072025,527245,544780,4772,3619,1153,81,27,19/1/2022 7:23
2/9/2021,Surin,155,12820,1376610,684728,691882,9296,9269,27,,,19/1/2022 7:23
2/9/2021,Sukhothai,51,4584,585695,283594,302101,6514,6514,0,,,19/1/2022 7:23
2/9/2021,Nong Khai,19,2307,516903,256356,260547,11497,11490,7,36,14,19/1/2022 7:23
2/9/2021,Nong Bua Lam Phu,38,3412,508929,253795,255134,1880,1880,0,,,19/1/2022 7:23
2/9/2021,Amnat Charoen,21,2551,376291,187148,189143,2964,2964,0,,,19/1/2022 7:23
2/9/2021,Udon Thani,124,9726,1566740,775793,790947,11621,11611,10,,,19/1/2022 7:23
2/9/2021,Uttaradit,34,3118,446754,217769,228985,7108,7108,0,,,19/1/2022 7:23
2/9/2021,Uthai Thani,35,2988,325202,158940,166262,2630,2630,0,,,19/1/2022 7:23
2/9/2021,Ubon Ratchathani,148,14466,1867421,932017,935404,25612,25612,0,41,15,19/1/2022 7:23
2/9/2021,Ang Thong,116,8747,275337,131732,143605,5978,5978,0,,,19/1/2022 7:23
2/9/2021,Chiang Rai,28,3076,1297567,630638,666929,52280,52001,279,33,12,19/1/2022 7:23
2/9/2021,Chiang Mai,28,11265,1787951,863847,924104,149552,148477,1075,62,27,19/1/2022 7:23
2/9/2021,Phetchaburi,87,15448,482635,232935,249700,88893,88804,89,,,19/1/2022 7:23
2/9/2021,Phetchabun,194,6402,978763,482612,496151,26514,26475,39,,,19/1/2022 7:23
2/9/2021,Loei,10,2610,638822,320038,318784,13785,13770,15,21,17,19/1/2022 7:23
2/9/2021,Phrae,10,1391,435288,209765,225523,11993,11993,0,41,17,19/1/2022 7:23
2/9/2021,Mae Hong Son,12,299,285937,144838,141099,11764,11539,225,25, ,19/1/2022 7:23
2/9/2021,,0,153,,,,,,,,,19/1/2022 7:23
3/9/2021,Krabi,20,1684,478854,237878,240976,4086,3912,174,,,19/1/2022 7:23
3/9/2021,Bangkok,3441,318037,5538629,2598539,2940090,448391,422787,25604,39,22,19/1/2022 7:23
3/9/2021,Kanchanaburi,174,13342,894044,448524,445520,190781,190728,53,17,10,19/1/2022 7:23
3/9/2021,Kalasin,41,7006,976025,482401,493624,4757,4757,0,,,19/1/2022 7:23
3/9/2021,Kamphaeng Phet,64,6138,712444,351736,360708,7679,7679,0,,,19/1/2022 7:23
3/9/2021,Khon Kaen,220,10569,1791794,880418,911376,36884,36884,0,61,24,19/1/2022 7:23
3/9/2021,Chanthaburi,103,6292,536411,262228,274183,24937,24842,95,,,19/1/2022 7:23
3/9/2021,Chachoengsao,230,26813,723178,354451,368727,7480,7480,0,24,33,19/1/2022 7:23
3/9/2021,Chon Buri,822,67610,1581618,771595,810023,119870,119059,811,33,31,19/1/2022 7:23
3/9/2021,Chai Nat,14,1995,320948,154287,166661,11052,11052,0,,,19/1/2022 7:23
3/9/2021,Chaiyaphum,98,8122,1122539,554554,567985,16842,16813,29,,,19/1/2022 7:23
3/9/2021,Chumphon,143,4637,509344,251379,257965,2620,2620,0,,,19/1/2022 7:23
3/9/2021,Trang,96,4392,639876,312767,327109,5191,5191,0,,,19/1/2022 7:23
3/9/2021,Trat,92,2542,228450,112952,115498,33159,33006,153,,,19/1/2022 7:23
3/9/2021,Tak,140,11220,675112,341344,333768,18741,18741,0,,,19/1/2022 7:23
3/9/2021,Nakhon Nayok,58,8395,260238,128796,131442,6150,6150,0,,,19/1/2022 7:23
3/9/2021,Nakhon Pathom,224,28355,921861,442674,479187,17076,17058,18,23,14,19/1/2022 7:23
3/9/2021,Nakhon Phanom,25,4497,717043,357140,359903,9839,9839,0,,,19/1/2022 7:23
3/9/2021,Nakhon Ratchasima,283,19368,2634005,1293977,1340028,158830,157909,921,56,23,19/1/2022 7:23
3/9/2021,Nakhon Si Thammarat,139,8228,1549321,764443,784878,9361,9361,0,,,19/1/2022 7:23
3/9/2021,Nakhon Sawan,80,8527,1036053,505240,530813,18756,18756,0, ,16,19/1/2022 7:23
3/9/2021,Nonthaburi,287,53450,1285994,598164,687830,13326,13275,51,22,15,19/1/2022 7:23
3/9/2021,Narathiwat,465,14776,808908,400179,408729,945,945,0,41,24,19/1/2022 7:23
3/9/2021,Nan,5,2222,475915,238017,237898,21353,21281,72,,,19/1/2022 7:23
3/9/2021,Bueng Kan,6,1663,421910,211455,210455,2662,2662,0,,,19/1/2022 7:23
3/9/2021,Buri Ram,81,13789,1579547,783516,796031,22217,22141,76,,,19/1/2022 7:23
3/9/2021,Pathum Thani,182,34656,1186767,562265,624502,10969,10893,76,,,19/1/2022 7:23
3/9/2021,Prachuap Khiri Khan,75,8531,553460,274610,278850,78909,78814,95,,,19/1/2022 7:23
3/9/2021,Prachin Buri,205,8827,494821,244371,250450,7010,7010,0,51,29,19/1/2022 7:23
3/9/2021,Pattani,198,16014,728989,360071,368918,1410,1410,0,,,19/1/2022 7:23
3/9/2021,Phra Nakhon Si Ayutthaya,263,22273,820211,393877,426334,63382,63260,122,27,36,19/1/2022 7:23
3/9/2021,Phayao,5,1583,465194,226350,238844,12520,12407,113,40,11,19/1/2022 7:23
3/9/2021,Phang-nga,31,1129,268130,133856,134274,11169,9671,1498,,,19/1/2022 7:23
3/9/2021,Phatthalung,38,2992,522511,254483,268028,1958,1958,0,,,19/1/2022 7:23
3/9/2021,Phichit,23,3492,530097,258414,271683,7058,7058,0,,,19/1/2022 7:23
3/9/2021,Phitsanulok,31,3784,847460,414773,432687,33623,33466,157,,,19/1/2022 7:23
3/9/2021,Phuket,240,4999,419217,198181,221036,85481,60028,25453,55,24,19/1/2022 7:23
3/9/2021,Maha Sarakham,34,8713,949461,465434,484027,4086,4086,0,,,19/1/2022 7:23
3/9/2021,Mukdahan,7,1876,351274,175455,175819,17246,17246,0,,,19/1/2022 7:23
3/9/2021,Yala,202,12619,541791,269774,272017,710,710,0,46,32,19/1/2022 7:23
3/9/2021,Yasothon,64,4528,533435,266108,267327,3724,3724,0,,,19/1/2022 7:23
3/9/2021,Ranong,161,6466,194674,98251,96423,2582,2582,0,,,19/1/2022 7:23
3/9/2021,Rayong,639,19893,749481,368005,381476,24688,24442,246,30,18,19/1/2022 7:23
3/9/2021,Ratchaburi,340,18683,868959,422400,446559,30897,30897,0,,,19/1/2022 7:23
3/9/2021,Roi Et,71,11826,1296274,642169,654105,3672,3672,0,,,19/1/2022 7:23
3/9/2021,Lop Buri,81,11414,740199,368985,371214,24082,24044,38,,,19/1/2022 7:23
3/9/2021,Lampang,4,2047,725923,353601,372322,9312,9210,102,51,14,19/1/2022 7:23
3/9/2021,Lamphun,14,1202,401450,192935,208515,8920,8828,92,,,19/1/2022 7:23
3/9/2021,Si Sa Ket,156,12931,1456968,725147,731821,15417,15417,0,,,19/1/2022 7:23
3/9/2021,Sakon Nakhon,31,6295,1146233,569519,576714,10521,10521,0,,,19/1/2022 7:23
3/9/2021,Songkhla,279,21569,1431271,697260,734011,1827,1827,0,73,41,19/1/2022 7:23
3/9/2021,Satun,32,1407,324578,161454,163124,1995,1995,0,40,33,19/1/2022 7:23
3/9/2021,Samut Prakarn,1237,86362,1355935,645831,710104,12413,12329,84,,,19/1/2022 7:23
3/9/2021,Samut Songkhram,135,8351,191160,91278,99882,31388,31388,0,19,11,19/1/2022 7:23
3/9/2021,Samut Sakhon,860,94439,585760,282297,303463,7943,7943,0,52,33,19/1/2022 7:23
3/9/2021,Saraburi,268,20409,644131,316501,327630,30780,30737,43,54,46,19/1/2022 7:23
3/9/2021,Sa kaeo,98,9686,561572,280341,281231,4108,4108,0,25,19,19/1/2022 7:23
3/9/2021,Sing Buri,21,2159,204996,97383,107613,9410,9410,0,,,19/1/2022 7:23
3/9/2021,Suphan Buri,96,10749,835999,403285,432714,30584,30584,0,,,19/1/2022 7:23
3/9/2021,Surat Thani,177,7200,1072025,527245,544780,4772,3619,1153,62,27,19/1/2022 7:23
3/9/2021,Surin,103,12923,1376610,684728,691882,9296,9269,27,,,19/1/2022 7:23
3/9/2021,Sukhothai,27,4611,585695,283594,302101,6514,6514,0,,,19/1/2022 7:23
3/9/2021,Nong Khai,25,2332,516903,256356,260547,11497,11490,7,34,13,19/1/2022 7:23
3/9/2021,Nong Bua Lam Phu,36,3448,508929,253795,255134,1880,1880,0,,,19/1/2022 7:23
3/9/2021,Amnat Charoen,6,2557,376291,187148,189143,2964,2964,0,,,19/1/2022 7:23
3/9/2021,Udon Thani,156,9882,1566740,775793,790947,11621,11611,10,,,19/1/2022 7:23
3/9/2021,Uttaradit,33,3151,446754,217769,228985,7108,7108,0,,,19/1/2022 7:23
3/9/2021,Uthai Thani,29,3017,325202,158940,166262,2630,2630,0,,,19/1/2022 7:23
3/9/2021,Ubon Ratchathani,159,14625,1867421,932017,935404,25612,25612,0,30,16,19/1/2022 7:23
3/9/2021,Ang Thong,106,8853,275337,131732,143605,5978,5978,0,,,19/1/2022 7:23
3/9/2021,Chiang Rai,23,3099,1297567,630638,666929,52280,52001,279,43,14,19/1/2022 7:23
3/9/2021,Chiang Mai,22,11287,1787951,863847,924104,149552,148477,1075,62,20,19/1/2022 7:23
3/9/2021,Phetchaburi,96,15544,482635,232935,249700,88893,88804,89,,,19/1/2022 7:23
3/9/2021,Phetchabun,156,6558,978763,482612,496151,26514,26475,39,,,19/1/2022 7:23
3/9/2021,Loei,19,2629,638822,320038,318784,13785,13770,15,25,16,19/1/2022 7:23
3/9/2021,Phrae,6,1397,435288,209765,225523,11993,11993,0,36,11,19/1/2022 7:23
3/9/2021,Mae Hong Son,2,301,285937,144838,141099,11764,11539,225, ,5,19/1/2022 7:23
3/9/2021,,0,153,,,,,,,,,19/1/2022 7:23
4/9/2021,Krabi,66,1750,478854,237878,240976,4086,3912,174,,,19/1/2022 7:23
4/9/2021,Bangkok,3849,321886,5538629,2598539,2940090,448391,422787,25604,45,23,19/1/2022 7:23
4/9/2021,Kanchanaburi,239,13581,894044,448524,445520,190781,190728,53,25,5,19/1/2022 7:23
4/9/2021,Kalasin,24,7030,976025,482401,493624,4757,4757,0,,,19/1/2022 7:23
4/9/2021,Kamphaeng Phet,28,6166,712444,351736,360708,7679,7679,0,,,19/1/2022 7:23
4/9/2021,Khon Kaen,121,10690,1791794,880418,911376,36884,36884,0,53,20,19/1/2022 7:23
4/9/2021,Chanthaburi,168,6460,536411,262228,274183,24937,24842,95,,,19/1/2022 7:23
4/9/2021,Chachoengsao,262,27075,723178,354451,368727,7480,7480,0,45,22,19/1/2022 7:23
4/9/2021,Chon Buri,956,68566,1581618,771595,810023,119870,119059,811,37,10,19/1/2022 7:23
4/9/2021,Chai Nat,9,2004,320948,154287,166661,11052,11052,0,,,19/1/2022 7:23
4/9/2021,Chaiyaphum,44,8166,1122539,554554,567985,16842,16813,29,,,19/1/2022 7:23
4/9/2021,Chumphon,107,4744,509344,251379,257965,2620,2620,0,,,19/1/2022 7:23
4/9/2021,Trang,29,4421,639876,312767,327109,5191,5191,0,,,19/1/2022 7:23
4/9/2021,Trat,130,2672,228450,112952,115498,33159,33006,153,,,19/1/2022 7:23
4/9/2021,Tak,252,11472,675112,341344,333768,18741,18741,0,,,19/1/2022 7:23
4/9/2021,Nakhon Nayok,61,8456,260238,128796,131442,6150,6150,0,,,19/1/2022 7:23
4/9/2021,Nakhon Pathom,340,28695,921861,442674,479187,17076,17058,18,30,19,19/1/2022 7:23
4/9/2021,Nakhon Phanom,20,4517,717043,357140,359903,9839,9839,0,,,19/1/2022 7:23
4/9/2021,Nakhon Ratchasima,296,19664,2634005,1293977,1340028,158830,157909,921,51,23,19/1/2022 7:23
4/9/2021,Nakhon Si Thammarat,149,8377,1549321,764443,784878,9361,9361,0,,,19/1/2022 7:23
4/9/2021,Nakhon Sawan,94,8621,1036053,505240,530813,18756,18756,0,26, ,19/1/2022 7:23
4/9/2021,Nonthaburi,476,53926,1285994,598164,687830,13326,13275,51,28,15,19/1/2022 7:23
4/9/2021,Narathiwat,343,15119,808908,400179,408729,945,945,0,49,32,19/1/2022 7:23
4/9/2021,Nan,12,2234,475915,238017,237898,21353,21281,72,,,19/1/2022 7:23
4/9/2021,Bueng Kan,9,1672,421910,211455,210455,2662,2662,0,,,19/1/2022 7:23
4/9/2021,Buri Ram,79,13868,1579547,783516,796031,22217,22141,76,,,19/1/2022 7:23
4/9/2021,Pathum Thani,162,34818,1186767,562265,624502,10969,10893,76,,,19/1/2022 7:23
4/9/2021,Prachuap Khiri Khan,220,8751,553460,274610,278850,78909,78814,95,,,19/1/2022 7:23
4/9/2021,Prachin Buri,181,9008,494821,244371,250450,7010,7010,0,59,17,19/1/2022 7:23
4/9/2021,Pattani,123,16137,728989,360071,368918,1410,1410,0,,,19/1/2022 7:23
4/9/2021,Phra Nakhon Si Ayutthaya,243,22516,820211,393877,426334,63382,63260,122,36,35,19/1/2022 7:23
4/9/2021,Phayao,33,1616,465194,226350,238844,12520,12407,113,25,12,19/1/2022 7:23
4/9/2021,Phang-nga,23,1152,268130,133856,134274,11169,9671,1498,,,19/1/2022 7:23
4/9/2021,Phatthalung,51,3043,522511,254483,268028,1958,1958,0,,,19/1/2022 7:23
4/9/2021,Phichit,16,3508,530097,258414,271683,7058,7058,0,,,19/1/2022 7:23
4/9/2021,Phitsanulok,37,3821,847460,414773,432687,33623,33466,157,,,19/1/2022 7:23
4/9/2021,Phuket,227,5226,419217,198181,221036,85481,60028,25453,55,27,19/1/2022 7:23
4/9/2021,Maha Sarakham,40,8753,949461,465434,484027,4086,4086,0,,,19/1/2022 7:23
4/9/2021,Mukdahan,12,1888,351274,175455,175819,17246,17246,0,,,19/1/2022 7:23
4/9/2021,Yala,209,12828,541791,269774,272017,710,710,0,62,36,19/1/2022 7:23
4/9/2021,Yasothon,51,4579,533435,266108,267327,3724,3724,0,,,19/1/2022 7:23
4/9/2021,Ranong,137,6603,194674,98251,96423,2582,2582,0,,,19/1/2022 7:23
4/9/2021,Rayong,447,20340,749481,368005,381476,24688,24442,246,22,16,19/1/2022 7:23
4/9/2021,Ratchaburi,502,19185,868959,422400,446559,30897,30897,0,,,19/1/2022 7:23
4/9/2021,Roi Et,80,11906,1296274,642169,654105,3672,3672,0,,,19/1/2022 7:23
4/9/2021,Lop Buri,119,11533,740199,368985,371214,24082,24044,38,,,19/1/2022 7:23
4/9/2021,Lampang,0,2047,725923,353601,372322,9312,9210,102,43,14,19/1/2022 7:23
4/9/2021,Lamphun,2,1204,401450,192935,208515,8920,8828,92,,,19/1/2022 7:23
4/9/2021,Si Sa Ket,165,13096,1456968,725147,731821,15417,15417,0,,,19/1/2022 7:23
4/9/2021,Sakon Nakhon,72,6367,1146233,569519,576714,10521,10521,0,,,19/1/2022 7:23
4/9/2021,Songkhla,224,21793,1431271,697260,734011,1827,1827,0,72,49,19/1/2022 7:23
4/9/2021,Satun,43,1450,324578,161454,163124,1995,1995,0,65,21,19/1/2022 7:23
4/9/2021,Samut Prakarn,1570,87932,1355935,645831,710104,12413,12329,84,,,19/1/2022 7:23
4/9/2021,Samut Songkhram,114,8465,191160,91278,99882,31388,31388,0,20,13,19/1/2022 7:23
4/9/2021,Samut Sakhon,897,95336,585760,282297,303463,7943,7943,0,54,31,19/1/2022 7:23
4/9/2021,Saraburi,280,20689,644131,316501,327630,30780,30737,43,50,43,19/1/2022 7:23
4/9/2021,Sa kaeo,121,9807,561572,280341,281231,4108,4108,0,25,16,19/1/2022 7:23
4/9/2021,Sing Buri,28,2187,204996,97383,107613,9410,9410,0,,,19/1/2022 7:23
4/9/2021,Suphan Buri,84,10833,835999,403285,432714,30584,30584,0,,,19/1/2022 7:23
4/9/2021,Surat Thani,210,7410,1072025,527245,544780,4772,3619,1153,59,32,19/1/2022 7:23
4/9/2021,Surin,192,13115,1376610,684728,691882,9296,9269,27,,,19/1/2022 7:23
4/9/2021,Sukhothai,29,4640,585695,283594,302101,6514,6514,0,,,19/1/2022 7:23
4/9/2021,Nong Khai,34,2366,516903,256356,260547,11497,11490,7,34,15,19/1/2022 7:23
4/9/2021,Nong Bua Lam Phu,9,3457,508929,253795,255134,1880,1880,0,,,19/1/2022 7:23
4/9/2021,Amnat Charoen,7,2564,376291,187148,189143,2964,2964,0,,,19/1/2022 7:23
4/9/2021,Udon Thani,138,10020,1566740,775793,790947,11621,11611,10,,,19/1/2022 7:23
4/9/2021,Uttaradit,62,3213,446754,217769,228985,7108,7108,0,,,19/1/2022 7:23
4/9/2021,Uthai Thani,33,3050,325202,158940,166262,2630,2630,0,,,19/1/2022 7:23
4/9/2021,Ubon Ratchathani,93,14718,1867421,932017,935404,25612,25612,0,33,13,19/1/2022 7:23
4/9/2021,Ang Thong,87,8940,275337,131732,143605,5978,5978,0,,,19/1/2022 7:23
4/9/2021,Chiang Rai,31,3130,1297567,630638,666929,52280,52001,279,36,7,19/1/2022 7:23
4/9/2021,Chiang Mai,27,11314,1787951,863847,924104,149552,148477,1075,45,15,19/1/2022 7:23
4/9/2021,Phetchaburi,85,15629,482635,232935,249700,88893,88804,89,,,19/1/2022 7:23
4/9/2021,Phetchabun,221,6779,978763,482612,496151,26514,26475,39,,,19/1/2022 7:23
4/9/2021,Loei,5,2634,638822,320038,318784,13785,13770,15,24,19,19/1/2022 7:23
4/9/2021,Phrae,2,1399,435288,209765,225523,11993,11993,0,25,13,19/1/2022 7:23
4/9/2021,Mae Hong Son,1,302,285937,144838,141099,11764,11539,225,19,2,19/1/2022 7:23
4/9/2021,,0,153,,,,,,,,,19/1/2022 7:23
5/9/2021,Krabi,35,1785,478854,237878,240976,4086,3912,174,,,19/1/2022 7:23
5/9/2021,Bangkok,3913,325799,5538629,2598539,2940090,448391,422787,25604,53,32,19/1/2022 7:23
5/9/2021,Kanchanaburi,206,13787,894044,448524,445520,190781,190728,53,12,12,19/1/2022 7:23
5/9/2021,Kalasin,25,7055,976025,482401,493624,4757,4757,0,,,19/1/2022 7:23
5/9/2021,Kamphaeng Phet,34,6200,712444,351736,360708,7679,7679,0,,,19/1/2022 7:23
5/9/2021,Khon Kaen,236,10926,1791794,880418,911376,36884,36884,0,47,24,19/1/2022 7:23
5/9/2021,Chanthaburi,125,6585,536411,262228,274183,24937,24842,95,,,19/1/2022 7:23
5/9/2021,Chachoengsao,350,27425,723178,354451,368727,7480,7480,0,44,34,19/1/2022 7:23
5/9/2021,Chon Buri,961,69527,1581618,771595,810023,119870,119059,811,17, ,19/1/2022 7:23
5/9/2021,Chai Nat,11,2015,320948,154287,166661,11052,11052,0,,,19/1/2022 7:23
5/9/2021,Chaiyaphum,41,8207,1122539,554554,567985,16842,16813,29,,,19/1/2022 7:23
5/9/2021,Chumphon,184,4928,509344,251379,257965,2620,2620,0,,,19/1/2022 7:23
5/9/2021,Trang,62,4483,639876,312767,327109,5191,5191,0,,,19/1/2022 7:23
5/9/2021,Trat,83,2755,228450,112952,115498,33159,33006,153,,,19/1/2022 7:23
5/9/2021,Tak,175,11647,675112,341344,333768,18741,18741,0,,,19/1/2022 7:23
5/9/2021,Nakhon Nayok,41,8497,260238,128796,131442,6150,6150,0,,,19/1/2022 7:23
5/9/2021,Nakhon Pathom,256,28951,921861,442674,479187,17076,17058,18,55,20,19/1/2022 7:23
5/9/2021,Nakhon Phanom,19,4536,717043,357140,359903,9839,9839,0,,,19/1/2022 7:23
5/9/2021,Nakhon Ratchasima,301,19965,2634005,1293977,1340028,158830,157909,921,48,28,19/1/2022 7:23
5/9/2021,Nakhon Si Thammarat,163,8540,1549321,764443,784878,9361,9361,0,,,19/1/2022 7:23
5/9/2021,Nakhon Sawan,57,8678,1036053,505240,530813,18756,18756,0, ,24,19/1/2022 7:23
5/9/2021,Nonthaburi,437,54363,1285994,598164,687830,13326,13275,51,26,21,19/1/2022 7:23
5/9/2021,Narathiwat,151,15270,808908,400179,408729,945,945,0,64,36,19/1/2022 7:23
5/9/2021,Nan,12,2246,475915,238017,237898,21353,21281,72,,,19/1/2022 7:23
5/9/2021,Bueng Kan,3,1675,421910,211455,210455,2662,2662,0,,,19/1/2022 7:23
5/9/2021,Buri Ram,85,13953,1579547,783516,796031,22217,22141,76,,,19/1/2022 7:23
5/9/2021,Pathum Thani,140,34958,1186767,562265,624502,10969,10893,76, ,46,19/1/2022 7:23
5/9/2021,Prachuap Khiri Khan,55,8806,553460,274610,278850,78909,78814,95,,,19/1/2022 7:23
5/9/2021,Prachin Buri,234,9242,494821,244371,250450,7010,7010,0,50,31,19/1/2022 7:23
5/9/2021,Pattani,177,16314,728989,360071,368918,1410,1410,0,,,19/1/2022 7:23
5/9/2021,Phra Nakhon Si Ayutthaya,354,22870,820211,393877,426334,63382,63260,122,40,43,19/1/2022 7:23
5/9/2021,Phayao,18,1634,465194,226350,238844,12520,12407,113,27,14,19/1/2022 7:23
5/9/2021,Phang-nga,4,1156,268130,133856,134274,11169,9671,1498,,,19/1/2022 7:23
5/9/2021,Phatthalung,51,3094,522511,254483,268028,1958,1958,0,,,19/1/2022 7:23
5/9/2021,Phichit,11,3519,530097,258414,271683,7058,7058,0,,,19/1/2022 7:23
5/9/2021,Phitsanulok,40,3861,847460,414773,432687,33623,33466,157,,,19/1/2022 7:23
5/9/2021,Phuket,243,5469,419217,198181,221036,85481,60028,25453,56,28,19/1/2022 7:23
5/9/2021,Maha Sarakham,50,8803,949461,465434,484027,4086,4086,0,,,19/1/2022 7:23
5/9/2021,Mukdahan,16,1904,351274,175455,175819,17246,17246,0,,,19/1/2022 7:23
5/9/2021,Yala,353,13181,541791,269774,272017,710,710,0,70,31,19/1/2022 7:23
5/9/2021,Yasothon,23,4602,533435,266108,267327,3724,3724,0,,,19/1/2022 7:23
5/9/2021,Ranong,135,6738,194674,98251,96423,2582,2582,0,,,19/1/2022 7:23
5/9/2021,Rayong,402,20742,749481,368005,381476,24688,24442,246,36,23,19/1/2022 7:23
5/9/2021,Ratchaburi,741,19926,868959,422400,446559,30897,30897,0,,,19/1/2022 7:23
5/9/2021,Roi Et,67,11973,1296274,642169,654105,3672,3672,0,,,19/1/2022 7:23
5/9/2021,Lop Buri,156,11689,740199,368985,371214,24082,24044,38,,,19/1/2022 7:23
5/9/2021,Lampang,6,2053,725923,353601,372322,9312,9210,102,48,14,19/1/2022 7:23
5/9/2021,Lamphun,4,1208,401450,192935,208515,8920,8828,92,,,19/1/2022 7:23
5/9/2021,Si Sa Ket,90,13186,1456968,725147,731821,15417,15417,0,,,19/1/2022 7:23
5/9/2021,Sakon Nakhon,33,6400,1146233,569519,576714,10521,10521,0,,,19/1/2022 7:23
5/9/2021,Songkhla,227,22020,1431271,697260,734011,1827,1827,0,96,40,19/1/2022 7:23
5/9/2021,Satun,45,1495,324578,161454,163124,1995,1995,0,51,34,19/1/2022 7:23
5/9/2021,Samut Prakarn,988,88920,1355935,645831,710104,12413,12329,84,,,19/1/2022 7:23
5/9/2021,Samut Songkhram,80,8545,191160,91278,99882,31388,31388,0,27,18,19/1/2022 7:23
5/9/2021,Samut Sakhon,843,96179,585760,282297,303463,7943,7943,0,58,29,19/1/2022 7:23
5/9/2021,Saraburi,252,20941,644131,316501,327630,30780,30737,43,44,93,19/1/2022 7:23
5/9/2021,Sa kaeo,154,9961,561572,280341,281231,4108,4108,0,22,19,19/1/2022 7:23
5/9/2021,Sing Buri,16,2203,204996,97383,107613,9410,9410,0,,,19/1/2022 7:23
5/9/2021,Suphan Buri,91,10924,835999,403285,432714,30584,30584,0,,,19/1/2022 7:23
5/9/2021,Surat Thani,179,7589,1072025,527245,544780,4772,3619,1153,66,30,19/1/2022 7:23
5/9/2021,Surin,150,13265,1376610,684728,691882,9296,9269,27,,,19/1/2022 7:23
5/9/2021,Sukhothai,35,4675,585695,283594,302101,6514,6514,0,,,19/1/2022 7:23
5/9/2021,Nong Khai,90,2456,516903,256356,260547,11497,11490,7,35,16,19/1/2022 7:23
5/9/2021,Nong Bua Lam Phu,15,3472,508929,253795,255134,1880,1880,0,,,19/1/2022 7:23
5/9/2021,Amnat Charoen,1,2565,376291,187148,189143,2964,2964,0,,,19/1/2022 7:23
5/9/2021,Udon Thani,163,10183,1566740,775793,790947,11621,11611,10,,,19/1/2022 7:23
5/9/2021,Uttaradit,33,3246,446754,217769,228985,7108,7108,0,,,19/1/2022 7:23
5/9/2021,Uthai Thani,13,3063,325202,158940,166262,2630,2630,0,,,19/1/2022 7:23
5/9/2021,Ubon Ratchathani,161,14879,1867421,932017,935404,25612,25612,0,30,17,19/1/2022 7:23
5/9/2021,Ang Thong,56,8996,275337,131732,143605,5978,5978,0,,,19/1/2022 7:23
5/9/2021,Chiang Rai,27,3157,1297567,630638,666929,52280,52001,279,23,8,19/1/2022 7:23
5/9/2021,Chiang Mai,24,11338,1787951,863847,924104,149552,148477,1075,39,23,19/1/2022 7:23
5/9/2021,Phetchaburi,98,15727,482635,232935,249700,88893,88804,89,,,19/1/2022 7:23
5/9/2021,Phetchabun,321,7100,978763,482612,496151,26514,26475,39,,,19/1/2022 7:23
5/9/2021,Loei,12,2646,638822,320038,318784,13785,13770,15,23,17,19/1/2022 7:23
5/9/2021,Phrae,7,1406,435288,209765,225523,11993,11993,0,24,17,19/1/2022 7:23
5/9/2021,Mae Hong Son,2,304,285937,144838,141099,11764,11539,225,9,3,19/1/2022 7:23
5/9/2021,,0,153,,,,,,,,,19/1/2022 7:23
6/9/2021,Krabi,23,1808,478854,237878,240976,4086,3912,174,,,19/1/2022 7:23
6/9/2021,Bangkok,3624,329423,5538629,2598539,2940090,448391,422787,25604,59,29,19/1/2022 7:23
6/9/2021,Kanchanaburi,124,13911,894044,448524,445520,190781,190728,53,27,10,19/1/2022 7:23
6/9/2021,Kalasin,16,7071,976025,482401,493624,4757,4757,0,,,19/1/2022 7:23
6/9/2021,Kamphaeng Phet,71,6271,712444,351736,360708,7679,7679,0,,,19/1/2022 7:23
6/9/2021,Khon Kaen,128,11054,1791794,880418,911376,36884,36884,0,49, ,19/1/2022 7:23
6/9/2021,Chanthaburi,150,6735,536411,262228,274183,24937,24842,95,,,19/1/2022 7:23
6/9/2021,Chachoengsao,179,27604,723178,354451,368727,7480,7480,0,53,32,19/1/2022 7:23
6/9/2021,Chon Buri,704,70231,1581618,771595,810023,119870,119059,811,,,19/1/2022 7:23
6/9/2021,Chai Nat,9,2024,320948,154287,166661,11052,11052,0,,,19/1/2022 7:23
6/9/2021,Chaiyaphum,44,8251,1122539,554554,567985,16842,16813,29,,,19/1/2022 7:23
6/9/2021,Chumphon,176,5104,509344,251379,257965,2620,2620,0,,,19/1/2022 7:23
6/9/2021,Trang,28,4511,639876,312767,327109,5191,5191,0,,,19/1/2022 7:23
6/9/2021,Trat,46,2801,228450,112952,115498,33159,33006,153,,,19/1/2022 7:23
6/9/2021,Tak,195,11842,675112,341344,333768,18741,18741,0,,,19/1/2022 7:23
6/9/2021,Nakhon Nayok,20,8517,260238,128796,131442,6150,6150,0,,,19/1/2022 7:23
6/9/2021,Nakhon Pathom,249,29200,921861,442674,479187,17076,17058,18,47,19,19/1/2022 7:23
6/9/2021,Nakhon Phanom,17,4553,717043,357140,359903,9839,9839,0,,,19/1/2022 7:23
6/9/2021,Nakhon Ratchasima,278,20243,2634005,1293977,1340028,158830,157909,921,60,24,19/1/2022 7:23
6/9/2021,Nakhon Si Thammarat,159,8699,1549321,764443,784878,9361,9361,0,,,19/1/2022 7:23
6/9/2021,Nakhon Sawan,81,8759,1036053,505240,530813,18756,18756,0,48,21,19/1/2022 7:23
6/9/2021,Nonthaburi,303,54666,1285994,598164,687830,13326,13275,51,38,20,19/1/2022 7:23
6/9/2021,Narathiwat,83,15353,808908,400179,408729,945,945,0,73,32,19/1/2022 7:23
6/9/2021,Nan,20,2266,475915,238017,237898,21353,21281,72,,,19/1/2022 7:23
6/9/2021,Bueng Kan,1,1676,421910,211455,210455,2662,2662,0,,,19/1/2022 7:23
6/9/2021,Buri Ram,92,14045,1579547,783516,796031,22217,22141,76,,,19/1/2022 7:23
6/9/2021,Pathum Thani,88,35046,1186767,562265,624502,10969,10893,76,94,22,19/1/2022 7:23
6/9/2021,Prachuap Khiri Khan,100,8906,553460,274610,278850,78909,78814,95,,,19/1/2022 7:23
6/9/2021,Prachin Buri,147,9389,494821,244371,250450,7010,7010,0,50,33,19/1/2022 7:23
6/9/2021,Pattani,154,16468,728989,360071,368918,1410,1410,0,,,19/1/2022 7:23
6/9/2021,Phra Nakhon Si Ayutthaya,294,23164,820211,393877,426334,63382,63260,122,48,32,19/1/2022 7:23
6/9/2021,Phayao,12,1646,465194,226350,238844,12520,12407,113,32,14,19/1/2022 7:23
6/9/2021,Phang-nga,27,1183,268130,133856,134274,11169,9671,1498,,,19/1/2022 7:23
6/9/2021,Phatthalung,38,3132,522511,254483,268028,1958,1958,0,,,19/1/2022 7:23
6/9/2021,Phichit,36,3555,530097,258414,271683,7058,7058,0,,,19/1/2022 7:23
6/9/2021,Phitsanulok,31,3892,847460,414773,432687,33623,33466,157,,,19/1/2022 7:23
6/9/2021,Phuket,241,5710,419217,198181,221036,85481,60028,25453,60,26,19/1/2022 7:23
6/9/2021,Maha Sarakham,30,8833,949461,465434,484027,4086,4086,0,,,19/1/2022 7:23
6/9/2021,Mukdahan,10,1914,351274,175455,175819,17246,17246,0,,,19/1/2022 7:23
6/9/2021,Yala,229,13410,541791,269774,272017,710,710,0,61,28,19/1/2022 7:23
6/9/2021,Yasothon,29,4631,533435,266108,267327,3724,3724,0,,,19/1/2022 7:23
6/9/2021,Ranong,129,6867,194674,98251,96423,2582,2582,0,,,19/1/2022 7:23
6/9/2021,Rayong,482,21224,749481,368005,381476,24688,24442,246,42,20,19/1/2022 7:23
6/9/2021,Ratchaburi,267,20193,868959,422400,446559,30897,30897,0,,,19/1/2022 7:23
6/9/2021,Roi Et,85,12058,1296274,642169,654105,3672,3672,0,,,19/1/2022 7:23
6/9/2021,Lop Buri,109,11798,740199,368985,371214,24082,24044,38,,,19/1/2022 7:23
6/9/2021,Lampang,23,2076,725923,353601,372322,9312,9210,102,46,15,19/1/2022 7:23
6/9/2021,Lamphun,34,1242,401450,192935,208515,8920,8828,92,,,19/1/2022 7:23
6/9/2021,Si Sa Ket,148,13334,1456968,725147,731821,15417,15417,0,,,19/1/2022 7:23
6/9/2021,Sakon Nakhon,31,6431,1146233,569519,576714,10521,10521,0,,,19/1/2022 7:23
6/9/2021,Songkhla,263,22283,1431271,697260,734011,1827,1827,0,73,37,19/1/2022 7:23
6/9/2021,Satun,18,1513,324578,161454,163124,1995,1995,0,66,30,19/1/2022 7:23
6/9/2021,Samut Prakarn,868,89788,1355935,645831,710104,12413,12329,84,,,19/1/2022 7:23
6/9/2021,Samut Songkhram,120,8665,191160,91278,99882,31388,31388,0,34,14,19/1/2022 7:23
6/9/2021,Samut Sakhon,713,96892,585760,282297,303463,7943,7943,0,55,69,19/1/2022 7:23
6/9/2021,Saraburi,245,21186,644131,316501,327630,30780,30737,43,67,61,19/1/2022 7:23
6/9/2021,Sa kaeo,72,10033,561572,280341,281231,4108,4108,0,32,20,19/1/2022 7:23
6/9/2021,Sing Buri,10,2213,204996,97383,107613,9410,9410,0,,,19/1/2022 7:23
6/9/2021,Suphan Buri,85,11009,835999,403285,432714,30584,30584,0,,,19/1/2022 7:23
6/9/2021,Surat Thani,160,7749,1072025,527245,544780,4772,3619,1153,61,29,19/1/2022 7:23
6/9/2021,Surin,166,13431,1376610,684728,691882,9296,9269,27,,,19/1/2022 7:23
6/9/2021,Sukhothai,24,4699,585695,283594,302101,6514,6514,0,,,19/1/2022 7:23
6/9/2021,Nong Khai,249,2705,516903,256356,260547,11497,11490,7,38,15,19/1/2022 7:23
6/9/2021,Nong Bua Lam Phu,8,3480,508929,253795,255134,1880,1880,0,,,19/1/2022 7:23
6/9/2021,Amnat Charoen,7,2572,376291,187148,189143,2964,2964,0,,,19/1/2022 7:23
6/9/2021,Udon Thani,313,10496,1566740,775793,790947,11621,11611,10,,,19/1/2022 7:23
6/9/2021,Uttaradit,22,3268,446754,217769,228985,7108,7108,0,,,19/1/2022 7:23
6/9/2021,Uthai Thani,17,3080,325202,158940,166262,2630,2630,0,,,19/1/2022 7:23
6/9/2021,Ubon Ratchathani,136,15015,1867421,932017,935404,25612,25612,0,37,18,19/1/2022 7:23
6/9/2021,Ang Thong,92,9088,275337,131732,143605,5978,5978,0,,,19/1/2022 7:23
6/9/2021,Chiang Rai,21,3178,1297567,630638,666929,52280,52001,279,22,10,19/1/2022 7:23
6/9/2021,Chiang Mai,14,11352,1787951,863847,924104,149552,148477,1075,47,23,19/1/2022 7:23
6/9/2021,Phetchaburi,94,15821,482635,232935,249700,88893,88804,89,,,19/1/2022 7:23
6/9/2021,Phetchabun,640,7740,978763,482612,496151,26514,26475,39,,,19/1/2022 7:23
6/9/2021,Loei,12,2658,638822,320038,318784,13785,13770,15,24,14,19/1/2022 7:23
6/9/2021,Phrae,13,1419,435288,209765,225523,11993,11993,0,46,16,19/1/2022 7:23
6/9/2021,Mae Hong Son,12,316,285937,144838,141099,11764,11539,225,15,4,19/1/2022 7:23
6/9/2021,,0,153,,,,,,,,,19/1/2022 7:23
7/9/2021,Krabi,121,1929,478854,237878,240976,4086,3912,174,,,19/1/2022 7:23
7/9/2021,Bangkok,4037,333460,5538629,2598539,2940090,448391,422787,25604,58,21,19/1/2022 7:23
7/9/2021,Kanchanaburi,182,14093,894044,448524,445520,190781,190728,53,23,9,19/1/2022 7:23
7/9/2021,Kalasin,21,7092,976025,482401,493624,4757,4757,0,,,19/1/2022 7:23
7/9/2021,Kamphaeng Phet,64,6335,712444,351736,360708,7679,7679,0,,,19/1/2022 7:23
7/9/2021,Khon Kaen,105,11159,1791794,880418,911376,36884,36884,0, ,39,19/1/2022 7:23
7/9/2021,Chanthaburi,110,6845,536411,262228,274183,24937,24842,95,,,19/1/2022 7:23
7/9/2021,Chachoengsao,174,27778,723178,354451,368727,7480,7480,0,54,25,19/1/2022 7:23
7/9/2021,Chon Buri,719,70950,1581618,771595,810023,119870,119059,811, ,22,19/1/2022 7:23
7/9/2021,Chai Nat,22,2046,320948,154287,166661,11052,11052,0,,,19/1/2022 7:23
7/9/2021,Chaiyaphum,12,8263,1122539,554554,567985,16842,16813,29,,,19/1/2022 7:23
7/9/2021,Chumphon,173,5277,509344,251379,257965,2620,2620,0,,,19/1/2022 7:23
7/9/2021,Trang,35,4546,639876,312767,327109,5191,5191,0,,,19/1/2022 7:23
7/9/2021,Trat,82,2883,228450,112952,115498,33159,33006,153,,,19/1/2022 7:23
7/9/2021,Tak,102,11944,675112,341344,333768,18741,18741,0,,,19/1/2022 7:23
7/9/2021,Nakhon Nayok,22,8539,260238,128796,131442,6150,6150,0,,,19/1/2022 7:23
7/9/2021,Nakhon Pathom,200,29400,921861,442674,479187,17076,17058,18,50,13,19/1/2022 7:23
7/9/2021,Nakhon Phanom,12,4565,717043,357140,359903,9839,9839,0,,,19/1/2022 7:23
7/9/2021,Nakhon Ratchasima,192,20435,2634005,1293977,1340028,158830,157909,921,45,18,19/1/2022 7:23
7/9/2021,Nakhon Si Thammarat,127,8826,1549321,764443,784878,9361,9361,0,,,19/1/2022 7:23
7/9/2021,Nakhon Sawan,67,8826,1036053,505240,530813,18756,18756,0,34,34,19/1/2022 7:23
7/9/2021,Nonthaburi,250,54916,1285994,598164,687830,13326,13275,51,37,12,19/1/2022 7:23
7/9/2021,Narathiwat,195,15548,808908,400179,408729,945,945,0,65,25,19/1/2022 7:23
7/9/2021,Nan,16,2282,475915,238017,237898,21353,21281,72,,,19/1/2022 7:23
7/9/2021,Bueng Kan,11,1687,421910,211455,210455,2662,2662,0,,,19/1/2022 7:23
7/9/2021,Buri Ram,84,14129,1579547,783516,796031,22217,22141,76,,,19/1/2022 7:23
7/9/2021,Pathum Thani,108,35154,1186767,562265,624502,10969,10893,76,48,18,19/1/2022 7:23
7/9/2021,Prachuap Khiri Khan,71,8977,553460,274610,278850,78909,78814,95,,,19/1/2022 7:23
7/9/2021,Prachin Buri,139,9528,494821,244371,250450,7010,7010,0,56,23,19/1/2022 7:23
7/9/2021,Pattani,215,16683,728989,360071,368918,1410,1410,0,,,19/1/2022 7:23
7/9/2021,Phra Nakhon Si Ayutthaya,311,23475,820211,393877,426334,63382,63260,122,24,30,19/1/2022 7:23
7/9/2021,Phayao,9,1655,465194,226350,238844,12520,12407,113,36,19,19/1/2022 7:23
7/9/2021,Phang-nga,36,1219,268130,133856,134274,11169,9671,1498,,,19/1/2022 7:23
7/9/2021,Phatthalung,29,3161,522511,254483,268028,1958,1958,0,,,19/1/2022 7:23
7/9/2021,Phichit,22,3577,530097,258414,271683,7058,7058,0,,,19/1/2022 7:23
7/9/2021,Phitsanulok,33,3925,847460,414773,432687,33623,33466,157,,,19/1/2022 7:23
7/9/2021,Phuket,232,5942,419217,198181,221036,85481,60028,25453,59,23,19/1/2022 7:23
7/9/2021,Maha Sarakham,19,8852,949461,465434,484027,4086,4086,0,,,19/1/2022 7:23
7/9/2021,Mukdahan,13,1927,351274,175455,175819,17246,17246,0,,,19/1/2022 7:23
7/9/2021,Yala,144,13554,541791,269774,272017,710,710,0,58,21,19/1/2022 7:23
7/9/2021,Yasothon,33,4664,533435,266108,267327,3724,3724,0,,,19/1/2022 7:23
7/9/2021,Ranong,80,6947,194674,98251,96423,2582,2582,0,,,19/1/2022 7:23
7/9/2021,Rayong,357,21581,749481,368005,381476,24688,24442,246,44,21,19/1/2022 7:23
7/9/2021,Ratchaburi,439,20632,868959,422400,446559,30897,30897,0,,,19/1/2022 7:23
7/9/2021,Roi Et,58,12116,1296274,642169,654105,3672,3672,0,,,19/1/2022 7:23
7/9/2021,Lop Buri,134,11932,740199,368985,371214,24082,24044,38,,,19/1/2022 7:23
7/9/2021,Lampang,2,2078,725923,353601,372322,9312,9210,102,45,16,19/1/2022 7:23
7/9/2021,Lamphun,72,1314,401450,192935,208515,8920,8828,92,,,19/1/2022 7:23
7/9/2021,Si Sa Ket,98,13432,1456968,725147,731821,15417,15417,0,,,19/1/2022 7:23
7/9/2021,Sakon Nakhon,34,6465,1146233,569519,576714,10521,10521,0,,,19/1/2022 7:23
7/9/2021,Songkhla,200,22483,1431271,697260,734011,1827,1827,0,67,32,19/1/2022 7:23
7/9/2021,Satun,33,1546,324578,161454,163124,1995,1995,0,58, ,19/1/2022 7:23
7/9/2021,Samut Prakarn,1140,90928,1355935,645831,710104,12413,12329,84,,,19/1/2022 7:23
7/9/2021,Samut Songkhram,95,8760,191160,91278,99882,31388,31388,0,35,12,19/1/2022 7:23
7/9/2021,Samut Sakhon,694,97586,585760,282297,303463,7943,7943,0,62,22,19/1/2022 7:23
7/9/2021,Saraburi,201,21387,644131,316501,327630,30780,30737,43,54,55,19/1/2022 7:23
7/9/2021,Sa kaeo,112,10145,561572,280341,281231,4108,4108,0,36,14,19/1/2022 7:23
7/9/2021,Sing Buri,13,2226,204996,97383,107613,9410,9410,0,,,19/1/2022 7:23
7/9/2021,Suphan Buri,74,11083,835999,403285,432714,30584,30584,0,,,19/1/2022 7:23
7/9/2021,Surat Thani,141,7890,1072025,527245,544780,4772,3619,1153,62,26,19/1/2022 7:23
7/9/2021,Surin,167,13598,1376610,684728,691882,9296,9269,27,,,19/1/2022 7:23
7/9/2021,Sukhothai,68,4767,585695,283594,302101,6514,6514,0,,,19/1/2022 7:23
7/9/2021,Nong Khai,8,2713,516903,256356,260547,11497,11490,7,36,13,19/1/2022 7:23
7/9/2021,Nong Bua Lam Phu,14,3494,508929,253795,255134,1880,1880,0,,,19/1/2022 7:23
7/9/2021,Amnat Charoen,19,2591,376291,187148,189143,2964,2964,0,,,19/1/2022 7:23
7/9/2021,Udon Thani,291,10787,1566740,775793,790947,11621,11611,10,,,19/1/2022 7:23
7/9/2021,Uttaradit,20,3288,446754,217769,228985,7108,7108,0,,,19/1/2022 7:23
7/9/2021,Uthai Thani,7,3087,325202,158940,166262,2630,2630,0,,,19/1/2022 7:23
7/9/2021,Ubon Ratchathani,74,15089,1867421,932017,935404,25612,25612,0,32,19,19/1/2022 7:23
7/9/2021,Ang Thong,45,9133,275337,131732,143605,5978,5978,0,,,19/1/2022 7:23
7/9/2021,Chiang Rai,20,3198,1297567,630638,666929,52280,52001,279,28,15,19/1/2022 7:23
7/9/2021,Chiang Mai,27,11379,1787951,863847,924104,149552,148477,1075,45,21,19/1/2022 7:23
7/9/2021,Phetchaburi,66,15887,482635,232935,249700,88893,88804,89,,,19/1/2022 7:23
7/9/2021,Phetchabun,447,8187,978763,482612,496151,26514,26475,39,,,19/1/2022 7:23
7/9/2021,Loei,10,2668,638822,320038,318784,13785,13770,15,23,15,19/1/2022 7:23
7/9/2021,Phrae,3,1422,435288,209765,225523,11993,11993,0,35,13,19/1/2022 7:23
7/9/2021,Mae Hong Son,9,325,285937,144838,141099,11764,11539,225,17,6,19/1/2022 7:23
7/9/2021,,0,153,,,,,,,,,19/1/2022 7:23
8/9/2021,Krabi,81,2010,478854,237878,240976,4086,3912,174,,,19/1/2022 7:23
8/9/2021,Bangkok,3708,337168,5538629,2598539,2940090,448391,422787,25604,53,29,19/1/2022 7:23
8/9/2021,Kanchanaburi,67,14160,894044,448524,445520,190781,190728,53,25,10,19/1/2022 7:23
8/9/2021,Kalasin,48,7140,976025,482401,493624,4757,4757,0,,,19/1/2022 7:23
8/9/2021,Kamphaeng Phet,39,6374,712444,351736,360708,7679,7679,0,,,19/1/2022 7:23
8/9/2021,Khon Kaen,191,11350,1791794,880418,911376,36884,36884,0,69,29,19/1/2022 7:23
8/9/2021,Chanthaburi,224,7069,536411,262228,274183,24937,24842,95,,,19/1/2022 7:23
8/9/2021,Chachoengsao,210,27988,723178,354451,368727,7480,7480,0,42,27,19/1/2022 7:23
8/9/2021,Chon Buri,846,71796,1581618,771595,810023,119870,119059,811,38,29,19/1/2022 7:23
8/9/2021,Chai Nat,23,2069,320948,154287,166661,11052,11052,0,,,19/1/2022 7:23
8/9/2021,Chaiyaphum,13,8276,1122539,554554,567985,16842,16813,29,,,19/1/2022 7:23
8/9/2021,Chumphon,139,5416,509344,251379,257965,2620,2620,0,,,19/1/2022 7:23
8/9/2021,Trang,53,4599,639876,312767,327109,5191,5191,0,,,19/1/2022 7:23
8/9/2021,Trat,151,3034,228450,112952,115498,33159,33006,153,,,19/1/2022 7:23
8/9/2021,Tak,146,12090,675112,341344,333768,18741,18741,0,,,19/1/2022 7:23
8/9/2021,Nakhon Nayok,53,8592,260238,128796,131442,6150,6150,0,,,19/1/2022 7:23
8/9/2021,Nakhon Pathom,167,29567,921861,442674,479187,17076,17058,18,35,15,19/1/2022 7:23
8/9/2021,Nakhon Phanom,9,4574,717043,357140,359903,9839,9839,0,,,19/1/2022 7:23
8/9/2021,Nakhon Ratchasima,205,20640,2634005,1293977,1340028,158830,157909,921,40,17,19/1/2022 7:23
8/9/2021,Nakhon Si Thammarat,215,9041,1549321,764443,784878,9361,9361,0,,,19/1/2022 7:23
8/9/2021,Nakhon Sawan,83,8909,1036053,505240,530813,18756,18756,0,69,27,19/1/2022 7:23
8/9/2021,Nonthaburi,366,55282,1285994,598164,687830,13326,13275,51,29,22,19/1/2022 7:23
8/9/2021,Narathiwat,366,15914,808908,400179,408729,945,945,0,54,12,19/1/2022 7:23
8/9/2021,Nan,8,2290,475915,238017,237898,21353,21281,72,,,19/1/2022 7:23
8/9/2021,Bueng Kan,3,1690,421910,211455,210455,2662,2662,0,,,19/1/2022 7:23
8/9/2021,Buri Ram,63,14192,1579547,783516,796031,22217,22141,76,,,19/1/2022 7:23
8/9/2021,Pathum Thani,130,35284,1186767,562265,624502,10969,10893,76,38,39,19/1/2022 7:23
8/9/2021,Prachuap Khiri Khan,339,9316,553460,274610,278850,78909,78814,95,,,19/1/2022 7:23
8/9/2021,Prachin Buri,188,9716,494821,244371,250450,7010,7010,0,46,26,19/1/2022 7:23
8/9/2021,Pattani,116,16799,728989,360071,368918,1410,1410,0,,,19/1/2022 7:23
8/9/2021,Phra Nakhon Si Ayutthaya,406,23881,820211,393877,426334,63382,63260,122,22, ,19/1/2022 7:23
8/9/2021,Phayao,7,1662,465194,226350,238844,12520,12407,113,47,12,19/1/2022 7:23
8/9/2021,Phang-nga,46,1265,268130,133856,134274,11169,9671,1498,,,19/1/2022 7:23
8/9/2021,Phatthalung,39,3200,522511,254483,268028,1958,1958,0,,,19/1/2022 7:23
8/9/2021,Phichit,18,3595,530097,258414,271683,7058,7058,0,,,19/1/2022 7:23
8/9/2021,Phitsanulok,34,3959,847460,414773,432687,33623,33466,157,,,19/1/2022 7:23
8/9/2021,Phuket,234,6176,419217,198181,221036,85481,60028,25453,50,26,19/1/2022 7:23
8/9/2021,Maha Sarakham,45,8897,949461,465434,484027,4086,4086,0,,,19/1/2022 7:23
8/9/2021,Mukdahan,6,1933,351274,175455,175819,17246,17246,0,,,19/1/2022 7:23
8/9/2021,Yala,278,13832,541791,269774,272017,710,710,0,47,13,19/1/2022 7:23
8/9/2021,Yasothon,31,4695,533435,266108,267327,3724,3724,0,,,19/1/2022 7:23
8/9/2021,Ranong,148,7095,194674,98251,96423,2582,2582,0,,,19/1/2022 7:23
8/9/2021,Rayong,473,22054,749481,368005,381476,24688,24442,246,30,22,19/1/2022 7:23
8/9/2021,Ratchaburi,529,21161,868959,422400,446559,30897,30897,0,,,19/1/2022 7:23
8/9/2021,Roi Et,50,12166,1296274,642169,654105,3672,3672,0,,,19/1/2022 7:23
8/9/2021,Lop Buri,83,12015,740199,368985,371214,24082,24044,38,,,19/1/2022 7:23
8/9/2021,Lampang,6,2084,725923,353601,372322,9312,9210,102,50,14,19/1/2022 7:23
8/9/2021,Lamphun,52,1366,401450,192935,208515,8920,8828,92,,,19/1/2022 7:23
8/9/2021,Si Sa Ket,119,13551,1456968,725147,731821,15417,15417,0,,,19/1/2022 7:23
8/9/2021,Sakon Nakhon,36,6501,1146233,569519,576714,10521,10521,0,,,19/1/2022 7:23
8/9/2021,Songkhla,369,22852,1431271,697260,734011,1827,1827,0,55,22,19/1/2022 7:23
8/9/2021,Satun,15,1561,324578,161454,163124,1995,1995,0,,,19/1/2022 7:23
8/9/2021,Samut Prakarn,955,91883,1355935,645831,710104,12413,12329,84,,,19/1/2022 7:23
8/9/2021,Samut Songkhram,53,8813,191160,91278,99882,31388,31388,0,22,11,19/1/2022 7:23
8/9/2021,Samut Sakhon,641,98227,585760,282297,303463,7943,7943,0, ,38,19/1/2022 7:23
8/9/2021,Saraburi,145,21532,644131,316501,327630,30780,30737,43,56,64,19/1/2022 7:23
8/9/2021,Sa kaeo,128,10273,561572,280341,281231,4108,4108,0,18,16,19/1/2022 7:23
8/9/2021,Sing Buri,20,2246,204996,97383,107613,9410,9410,0,,,19/1/2022 7:23
8/9/2021,Suphan Buri,53,11136,835999,403285,432714,30584,30584,0,,,19/1/2022 7:23
8/9/2021,Surat Thani,126,8016,1072025,527245,544780,4772,3619,1153,69,21,19/1/2022 7:23
8/9/2021,Surin,108,13706,1376610,684728,691882,9296,9269,27,,,19/1/2022 7:23
8/9/2021,Sukhothai,54,4821,585695,283594,302101,6514,6514,0,,,19/1/2022 7:23
8/9/2021,Nong Khai,10,2723,516903,256356,260547,11497,11490,7,33,15,19/1/2022 7:23
8/9/2021,Nong Bua Lam Phu,27,3521,508929,253795,255134,1880,1880,0,,,19/1/2022 7:23
8/9/2021,Amnat Charoen,12,2603,376291,187148,189143,2964,2964,0,,,19/1/2022 7:23
8/9/2021,Udon Thani,236,11023,1566740,775793,790947,11621,11611,10,,,19/1/2022 7:23
8/9/2021,Uttaradit,34,3322,446754,217769,228985,7108,7108,0,,,19/1/2022 7:23
8/9/2021,Uthai Thani,15,3102,325202,158940,166262,2630,2630,0,,,19/1/2022 7:23
8/9/2021,Ubon Ratchathani,48,15137,1867421,932017,935404,25612,25612,0,24,13,19/1/2022 7:23
8/9/2021,Ang Thong,31,9164,275337,131732,143605,5978,5978,0,,,19/1/2022 7:23
8/9/2021,Chiang Rai,15,3213,1297567,630638,666929,52280,52001,279,42,13,19/1/2022 7:23
8/9/2021,Chiang Mai,38,11417,1787951,863847,924104,149552,148477,1075,53,22,19/1/2022 7:23
8/9/2021,Phetchaburi,88,15975,482635,232935,249700,88893,88804,89,,,19/1/2022 7:23
8/9/2021,Phetchabun,51,8238,978763,482612,496151,26514,26475,39,,,19/1/2022 7:23
8/9/2021,Loei,2,2670,638822,320038,318784,13785,13770,15,28,9,19/1/2022 7:23
8/9/2021,Phrae,4,1426,435288,209765,225523,11993,11993,0,29,8,19/1/2022 7:23
8/9/2021,Mae Hong Son,8,333,285937,144838,141099,11764,11539,225,24,11,19/1/2022 7:23
8/9/2021,,0,153,,,,,,,,,19/1/2022 7:23
9/9/2021,Krabi,89,2099,478854,237878,240976,4086,3912,174,,,19/1/2022 7:23
9/9/2021,Bangkok,3745,340913,5538629,2598539,2940090,448391,422787,25604,62,19,19/1/2022 7:23
9/9/2021,Kanchanaburi,165,14325,894044,448524,445520,190781,190728,53,24,12,19/1/2022 7:23
9/9/2021,Kalasin,22,7162,976025,482401,493624,4757,4757,0,,,19/1/2022 7:23
9/9/2021,Kamphaeng Phet,19,6393,712444,351736,360708,7679,7679,0,,,19/1/2022 7:23
9/9/2021,Khon Kaen,176,11526,1791794,880418,911376,36884,36884,0,52,23,19/1/2022 7:23
9/9/2021,Chanthaburi,163,7232,536411,262228,274183,24937,24842,95,,,19/1/2022 7:23
9/9/2021,Chachoengsao,323,28311,723178,354451,368727,7480,7480,0,53,25,19/1/2022 7:23
9/9/2021,Chon Buri,1595,73391,1581618,771595,810023,119870,119059,811,48,22,19/1/2022 7:23
9/9/2021,Chai Nat,22,2091,320948,154287,166661,11052,11052,0,,,19/1/2022 7:23
9/9/2021,Chaiyaphum,35,8311,1122539,554554,567985,16842,16813,29,,,19/1/2022 7:23
9/9/2021,Chumphon,168,5584,509344,251379,257965,2620,2620,0,,,19/1/2022 7:23
9/9/2021,Trang,43,4642,639876,312767,327109,5191,5191,0,,,19/1/2022 7:23
9/9/2021,Trat,76,3110,228450,112952,115498,33159,33006,153,,,19/1/2022 7:23
9/9/2021,Tak,198,12288,675112,341344,333768,18741,18741,0,,,19/1/2022 7:23
9/9/2021,Nakhon Nayok,67,8659,260238,128796,131442,6150,6150,0,,,19/1/2022 7:23
9/9/2021,Nakhon Pathom,180,29747,921861,442674,479187,17076,17058,18,34,20,19/1/2022 7:23
9/9/2021,Nakhon Phanom,23,4597,717043,357140,359903,9839,9839,0,,,19/1/2022 7:23
9/9/2021,Nakhon Ratchasima,162,20802,2634005,1293977,1340028,158830,157909,921,41,17,19/1/2022 7:23
9/9/2021,Nakhon Si Thammarat,245,9286,1549321,764443,784878,9361,9361,0,,,19/1/2022 7:23
9/9/2021,Nakhon Sawan,65,8974,1036053,505240,530813,18756,18756,0,54,19,19/1/2022 7:23
9/9/2021,Nonthaburi,436,55718,1285994,598164,687830,13326,13275,51,34,17,19/1/2022 7:23
9/9/2021,Narathiwat,456,16370,808908,400179,408729,945,945,0,25,16,19/1/2022 7:23
9/9/2021,Nan,9,2299,475915,238017,237898,21353,21281,72,,,19/1/2022 7:23
9/9/2021,Bueng Kan,4,1694,421910,211455,210455,2662,2662,0,,,19/1/2022 7:23
9/9/2021,Buri Ram,113,14305,1579547,783516,796031,22217,22141,76,,,19/1/2022 7:23
9/9/2021,Pathum Thani,140,35424,1186767,562265,624502,10969,10893,76,71,30,19/1/2022 7:23
9/9/2021,Prachuap Khiri Khan,86,9402,553460,274610,278850,78909,78814,95,,,19/1/2022 7:23
9/9/2021,Prachin Buri,190,9906,494821,244371,250450,7010,7010,0,53,25,19/1/2022 7:23
9/9/2021,Pattani,200,16999,728989,360071,368918,1410,1410,0,,,19/1/2022 7:23
9/9/2021,Phra Nakhon Si Ayutthaya,460,24341,820211,393877,426334,63382,63260,122,36, ,19/1/2022 7:23
9/9/2021,Phayao,2,1664,465194,226350,238844,12520,12407,113,29,12,19/1/2022 7:23
9/9/2021,Phang-nga,21,1286,268130,133856,134274,11169,9671,1498,,,19/1/2022 7:23
9/9/2021,Phatthalung,46,3246,522511,254483,268028,1958,1958,0,,,19/1/2022 7:23
9/9/2021,Phichit,30,3625,530097,258414,271683,7058,7058,0,,,19/1/2022 7:23
9/9/2021,Phitsanulok,33,3992,847460,414773,432687,33623,33466,157,,,19/1/2022 7:23
9/9/2021,Phuket,219,6395,419217,198181,221036,85481,60028,25453,56,26,19/1/2022 7:23
9/9/2021,Maha Sarakham,23,8920,949461,465434,484027,4086,4086,0,,,19/1/2022 7:23
9/9/2021,Mukdahan,3,1936,351274,175455,175819,17246,17246,0,,,19/1/2022 7:23
9/9/2021,Yala,323,14155,541791,269774,272017,710,710,0,29,18,19/1/2022 7:23
9/9/2021,Yasothon,26,4721,533435,266108,267327,3724,3724,0,,,19/1/2022 7:23
9/9/2021,Ranong,114,7209,194674,98251,96423,2582,2582,0,,,19/1/2022 7:23
9/9/2021,Rayong,549,22603,749481,368005,381476,24688,24442,246,44,19,19/1/2022 7:23
9/9/2021,Ratchaburi,466,21627,868959,422400,446559,30897,30897,0,,,19/1/2022 7:23
9/9/2021,Roi Et,44,12210,1296274,642169,654105,3672,3672,0,,,19/1/2022 7:23
9/9/2021,Lop Buri,87,12102,740199,368985,371214,24082,24044,38,,,19/1/2022 7:23
9/9/2021,Lampang,0,2084,725923,353601,372322,9312,9210,102,45,14,19/1/2022 7:23
9/9/2021,Lamphun,23,1389,401450,192935,208515,8920,8828,92,,,19/1/2022 7:23
9/9/2021,Si Sa Ket,83,13634,1456968,725147,731821,15417,15417,0,,,19/1/2022 7:23
9/9/2021,Sakon Nakhon,44,6545,1146233,569519,576714,10521,10521,0,,,19/1/2022 7:23
9/9/2021,Songkhla,374,23226,1431271,697260,734011,1827,1827,0,45,34,19/1/2022 7:23
9/9/2021,Satun,32,1593,324578,161454,163124,1995,1995,0,,,19/1/2022 7:23
9/9/2021,Samut Prakarn,1197,93080,1355935,645831,710104,12413,12329,84,,,19/1/2022 7:23
9/9/2021,Samut Songkhram,48,8861,191160,91278,99882,31388,31388,0,19,13,19/1/2022 7:23
9/9/2021,Samut Sakhon,643,98870,585760,282297,303463,7943,7943,0, ,37,19/1/2022 7:23
9/9/2021,Saraburi,362,21894,644131,316501,327630,30780,30737,43,56,50,19/1/2022 7:23
9/9/2021,Sa kaeo,148,10421,561572,280341,281231,4108,4108,0,20,15,19/1/2022 7:23
9/9/2021,Sing Buri,21,2267,204996,97383,107613,9410,9410,0,,,19/1/2022 7:23
9/9/2021,Suphan Buri,68,11204,835999,403285,432714,30584,30584,0,,,19/1/2022 7:23
9/9/2021,Surat Thani,150,8166,1072025,527245,544780,4772,3619,1153,63,25,19/1/2022 7:23
9/9/2021,Surin,77,13783,1376610,684728,691882,9296,9269,27,,,19/1/2022 7:23
9/9/2021,Sukhothai,44,4865,585695,283594,302101,6514,6514,0,,,19/1/2022 7:23
9/9/2021,Nong Khai,32,2755,516903,256356,260547,11497,11490,7,36,16,19/1/2022 7:23
9/9/2021,Nong Bua Lam Phu,25,3546,508929,253795,255134,1880,1880,0,,,19/1/2022 7:23
9/9/2021,Amnat Charoen,6,2609,376291,187148,189143,2964,2964,0,,,19/1/2022 7:23
9/9/2021,Udon Thani,487,11510,1566740,775793,790947,11621,11611,10,,,19/1/2022 7:23
9/9/2021,Uttaradit,39,3361,446754,217769,228985,7108,7108,0,,,19/1/2022 7:23
9/9/2021,Uthai Thani,6,3108,325202,158940,166262,2630,2630,0,,,19/1/2022 7:23
9/9/2021,Ubon Ratchathani,85,15222,1867421,932017,935404,25612,25612,0,26,15,19/1/2022 7:23
9/9/2021,Ang Thong,73,9237,275337,131732,143605,5978,5978,0,,,19/1/2022 7:23
9/9/2021,Chiang Rai,27,3240,1297567,630638,666929,52280,52001,279,36,8,19/1/2022 7:23
9/9/2021,Chiang Mai,26,11443,1787951,863847,924104,149552,148477,1075,53,17,19/1/2022 7:23
9/9/2021,Phetchaburi,125,16100,482635,232935,249700,88893,88804,89,,,19/1/2022 7:23
9/9/2021,Phetchabun,71,8309,978763,482612,496151,26514,26475,39,,,19/1/2022 7:23
9/9/2021,Loei,22,2692,638822,320038,318784,13785,13770,15,14,8,19/1/2022 7:23
9/9/2021,Phrae,6,1432,435288,209765,225523,11993,11993,0,23,11,19/1/2022 7:23
9/9/2021,Mae Hong Son,26,359,285937,144838,141099,11764,11539,225,44,4,19/1/2022 7:23
9/9/2021,,0,153,,,,,,,,,19/1/2022 7:23
10/9/2021,Krabi,92,2191,478854,237878,240976,4086,3912,174,,,19/1/2022 7:23
10/9/2021,Bangkok,3504,344417,5538629,2598539,2940090,448391,422787,25604,44,23,19/1/2022 7:23
10/9/2021,Kanchanaburi,190,14515,894044,448524,445520,190781,190728,53,24,11,19/1/2022 7:23
10/9/2021,Kalasin,30,7192,976025,482401,493624,4757,4757,0,,,19/1/2022 7:23
10/9/2021,Kamphaeng Phet,57,6450,712444,351736,360708,7679,7679,0,,,19/1/2022 7:23
10/9/2021,Khon Kaen,166,11692,1791794,880418,911376,36884,36884,0,59,56,19/1/2022 7:23
10/9/2021,Chanthaburi,142,7374,536411,262228,274183,24937,24842,95,,,19/1/2022 7:23
10/9/2021,Chachoengsao,217,28528,723178,354451,368727,7480,7480,0,28,27,19/1/2022 7:23
10/9/2021,Chon Buri,802,74193,1581618,771595,810023,119870,119059,811,38,20,19/1/2022 7:23
10/9/2021,Chai Nat,13,2104,320948,154287,166661,11052,11052,0,,,19/1/2022 7:23
10/9/2021,Chaiyaphum,25,8336,1122539,554554,567985,16842,16813,29,,,19/1/2022 7:23
10/9/2021,Chumphon,118,5702,509344,251379,257965,2620,2620,0,,,19/1/2022 7:23
10/9/2021,Trang,21,4663,639876,312767,327109,5191,5191,0,,,19/1/2022 7:23
10/9/2021,Trat,106,3216,228450,112952,115498,33159,33006,153,,,19/1/2022 7:23
10/9/2021,Tak,171,12459,675112,341344,333768,18741,18741,0,,,19/1/2022 7:23
10/9/2021,Nakhon Nayok,26,8685,260238,128796,131442,6150,6150,0,,,19/1/2022 7:23
10/9/2021,Nakhon Pathom,196,29943,921861,442674,479187,17076,17058,18,50,17,19/1/2022 7:23
10/9/2021,Nakhon Phanom,9,4606,717043,357140,359903,9839,9839,0,,,19/1/2022 7:23
10/9/2021,Nakhon Ratchasima,116,20918,2634005,1293977,1340028,158830,157909,921,38,23,19/1/2022 7:23
10/9/2021,Nakhon Si Thammarat,232,9518,1549321,764443,784878,9361,9361,0,,,19/1/2022 7:23
10/9/2021,Nakhon Sawan,82,9056,1036053,505240,530813,18756,18756,0,38,22,19/1/2022 7:23
10/9/2021,Nonthaburi,497,56215,1285994,598164,687830,13326,13275,51,34,15,19/1/2022 7:23
10/9/2021,Narathiwat,404,16774,808908,400179,408729,945,945,0,34,22,19/1/2022 7:23
10/9/2021,Nan,2,2301,475915,238017,237898,21353,21281,72,,,19/1/2022 7:23
10/9/2021,Bueng Kan,11,1705,421910,211455,210455,2662,2662,0,,,19/1/2022 7:23
10/9/2021,Buri Ram,66,14371,1579547,783516,796031,22217,22141,76,,,19/1/2022 7:23
10/9/2021,Pathum Thani,164,35588,1186767,562265,624502,10969,10893,76,57,29,19/1/2022 7:23
10/9/2021,Prachuap Khiri Khan,96,9498,553460,274610,278850,78909,78814,95,,,19/1/2022 7:23
10/9/2021,Prachin Buri,399,10305,494821,244371,250450,7010,7010,0,49,31,19/1/2022 7:23
10/9/2021,Pattani,154,17153,728989,360071,368918,1410,1410,0,,,19/1/2022 7:23
10/9/2021,Phra Nakhon Si Ayutthaya,275,24616,820211,393877,426334,63382,63260,122,35, ,19/1/2022 7:23
10/9/2021,Phayao,7,1671,465194,226350,238844,12520,12407,113,26,14,19/1/2022 7:23
10/9/2021,Phang-nga,66,1352,268130,133856,134274,11169,9671,1498,,,19/1/2022 7:23
10/9/2021,Phatthalung,22,3268,522511,254483,268028,1958,1958,0,,,19/1/2022 7:23
10/9/2021,Phichit,12,3637,530097,258414,271683,7058,7058,0,,,19/1/2022 7:23
10/9/2021,Phitsanulok,26,4018,847460,414773,432687,33623,33466,157,,,19/1/2022 7:23
10/9/2021,Phuket,212,6607,419217,198181,221036,85481,60028,25453,52,26,19/1/2022 7:23
10/9/2021,Maha Sarakham,45,8965,949461,465434,484027,4086,4086,0,,,19/1/2022 7:23
10/9/2021,Mukdahan,2,1938,351274,175455,175819,17246,17246,0,,,19/1/2022 7:23
10/9/2021,Yala,256,14411,541791,269774,272017,710,710,0,33,21,19/1/2022 7:23
10/9/2021,Yasothon,23,4744,533435,266108,267327,3724,3724,0,,,19/1/2022 7:23
10/9/2021,Ranong,110,7319,194674,98251,96423,2582,2582,0,,,19/1/2022 7:23
10/9/2021,Rayong,393,22996,749481,368005,381476,24688,24442,246,32,21,19/1/2022 7:23
10/9/2021,Ratchaburi,615,22242,868959,422400,446559,30897,30897,0,,,19/1/2022 7:23
10/9/2021,Roi Et,54,12264,1296274,642169,654105,3672,3672,0,,,19/1/2022 7:23
10/9/2021,Lop Buri,115,12217,740199,368985,371214,24082,24044,38,,,19/1/2022 7:23
10/9/2021,Lampang,13,2097,725923,353601,372322,9312,9210,102,43,12,19/1/2022 7:23
10/9/2021,Lamphun,40,1429,401450,192935,208515,8920,8828,92,,,19/1/2022 7:23
10/9/2021,Si Sa Ket,80,13714,1456968,725147,731821,15417,15417,0,,,19/1/2022 7:23
10/9/2021,Sakon Nakhon,35,6580,1146233,569519,576714,10521,10521,0,,,19/1/2022 7:23
10/9/2021,Songkhla,285,23511,1431271,697260,734011,1827,1827,0,59,31,19/1/2022 7:23
10/9/2021,Satun,14,1607,324578,161454,163124,1995,1995,0,,,19/1/2022 7:23
10/9/2021,Samut Prakarn,1037,94117,1355935,645831,710104,12413,12329,84,,,19/1/2022 7:23
10/9/2021,Samut Songkhram,29,8890,191160,91278,99882,31388,31388,0,24,12,19/1/2022 7:23
10/9/2021,Samut Sakhon,678,99548,585760,282297,303463,7943,7943,0, ,32,19/1/2022 7:23
10/9/2021,Saraburi,321,22215,644131,316501,327630,30780,30737,43,59,42,19/1/2022 7:23
10/9/2021,Sa kaeo,137,10558,561572,280341,281231,4108,4108,0,20,21,19/1/2022 7:23
10/9/2021,Sing Buri,13,2280,204996,97383,107613,9410,9410,0,,,19/1/2022 7:23
10/9/2021,Suphan Buri,58,11262,835999,403285,432714,30584,30584,0,,,19/1/2022 7:23
10/9/2021,Surat Thani,193,8359,1072025,527245,544780,4772,3619,1153,53,25,19/1/2022 7:23
10/9/2021,Surin,96,13879,1376610,684728,691882,9296,9269,27,,,19/1/2022 7:23
10/9/2021,Sukhothai,70,4935,585695,283594,302101,6514,6514,0,,,19/1/2022 7:23
10/9/2021,Nong Khai,39,2794,516903,256356,260547,11497,11490,7,39,15,19/1/2022 7:23
10/9/2021,Nong Bua Lam Phu,14,3560,508929,253795,255134,1880,1880,0,,,19/1/2022 7:23
10/9/2021,Amnat Charoen,9,2618,376291,187148,189143,2964,2964,0,,,19/1/2022 7:23
10/9/2021,Udon Thani,421,11931,1566740,775793,790947,11621,11611,10,,,19/1/2022 7:23
10/9/2021,Uttaradit,37,3398,446754,217769,228985,7108,7108,0,,,19/1/2022 7:23
10/9/2021,Uthai Thani,22,3130,325202,158940,166262,2630,2630,0,,,19/1/2022 7:23
10/9/2021,Ubon Ratchathani,55,15277,1867421,932017,935404,25612,25612,0,28,18,19/1/2022 7:23
10/9/2021,Ang Thong,76,9313,275337,131732,143605,5978,5978,0,,,19/1/2022 7:23
10/9/2021,Chiang Rai,16,3256,1297567,630638,666929,52280,52001,279,20,15,19/1/2022 7:23
10/9/2021,Chiang Mai,57,11500,1787951,863847,924104,149552,148477,1075,43,21,19/1/2022 7:23
10/9/2021,Phetchaburi,92,16192,482635,232935,249700,88893,88804,89,,,19/1/2022 7:23
10/9/2021,Phetchabun,57,8366,978763,482612,496151,26514,26475,39,,,19/1/2022 7:23
10/9/2021,Loei,21,2713,638822,320038,318784,13785,13770,15,15,10,19/1/2022 7:23
10/9/2021,Phrae,7,1439,435288,209765,225523,11993,11993,0,26,13,19/1/2022 7:23
10/9/2021,Mae Hong Son,40,399,285937,144838,141099,11764,11539,225,17,4,19/1/2022 7:23
10/9/2021,,0,153,,,,,,,,,19/1/2022 7:23
11/9/2021,Krabi,139,2330,478854,237878,240976,4086,3912,174,,,19/1/2022 7:23
11/9/2021,Bangkok,3394,347811,5538629,2598539,2940090,448391,422787,25604,47,22,19/1/2022 7:23
11/9/2021,Kanchanaburi,113,14628,894044,448524,445520,190781,190728,53,22,12,19/1/2022 7:23
11/9/2021,Kalasin,20,7212,976025,482401,493624,4757,4757,0,,,19/1/2022 7:23
11/9/2021,Kamphaeng Phet,44,6494,712444,351736,360708,7679,7679,0,,,19/1/2022 7:23
11/9/2021,Khon Kaen,156,11848,1791794,880418,911376,36884,36884,0,59,27,19/1/2022 7:23
11/9/2021,Chanthaburi,168,7542,536411,262228,274183,24937,24842,95,,,19/1/2022 7:23
11/9/2021,Chachoengsao,251,28779,723178,354451,368727,7480,7480,0,35,31,19/1/2022 7:23
11/9/2021,Chon Buri,993,75186,1581618,771595,810023,119870,119059,811,35,29,19/1/2022 7:23
11/9/2021,Chai Nat,19,2123,320948,154287,166661,11052,11052,0,,,19/1/2022 7:23
11/9/2021,Chaiyaphum,38,8374,1122539,554554,567985,16842,16813,29,,,19/1/2022 7:23
11/9/2021,Chumphon,89,5791,509344,251379,257965,2620,2620,0,,,19/1/2022 7:23
11/9/2021,Trang,22,4685,639876,312767,327109,5191,5191,0,,,19/1/2022 7:23
11/9/2021,Trat,87,3303,228450,112952,115498,33159,33006,153,,,19/1/2022 7:23
11/9/2021,Tak,192,12651,675112,341344,333768,18741,18741,0,,,19/1/2022 7:23
11/9/2021,Nakhon Nayok,64,8749,260238,128796,131442,6150,6150,0,,,19/1/2022 7:23
11/9/2021,Nakhon Pathom,190,30133,921861,442674,479187,17076,17058,18,46,18,19/1/2022 7:23
11/9/2021,Nakhon Phanom,23,4629,717043,357140,359903,9839,9839,0,,,19/1/2022 7:23
11/9/2021,Nakhon Ratchasima,183,21101,2634005,1293977,1340028,158830,157909,921,48,21,19/1/2022 7:23
11/9/2021,Nakhon Si Thammarat,263,9781,1549321,764443,784878,9361,9361,0,,,19/1/2022 7:23
11/9/2021,Nakhon Sawan,72,9128,1036053,505240,530813,18756,18756,0,43,25,19/1/2022 7:23
11/9/2021,Nonthaburi,280,56495,1285994,598164,687830,13326,13275,51,28,14,19/1/2022 7:23
11/9/2021,Narathiwat,369,17143,808908,400179,408729,945,945,0,49,15,19/1/2022 7:23
11/9/2021,Nan,3,2304,475915,238017,237898,21353,21281,72,,,19/1/2022 7:23
11/9/2021,Bueng Kan,18,1723,421910,211455,210455,2662,2662,0,,,19/1/2022 7:23
11/9/2021,Buri Ram,71,14442,1579547,783516,796031,22217,22141,76,,,19/1/2022 7:23
11/9/2021,Pathum Thani,134,35722,1186767,562265,624502,10969,10893,76,45,24,19/1/2022 7:23
11/9/2021,Prachuap Khiri Khan,53,9551,553460,274610,278850,78909,78814,95,,,19/1/2022 7:23
11/9/2021,Prachin Buri,372,10677,494821,244371,250450,7010,7010,0,53,38,19/1/2022 7:23
11/9/2021,Pattani,203,17356,728989,360071,368918,1410,1410,0,,,19/1/2022 7:23
11/9/2021,Phra Nakhon Si Ayutthaya,239,24855,820211,393877,426334,63382,63260,122,25, ,19/1/2022 7:23
11/9/2021,Phayao,1,1672,465194,226350,238844,12520,12407,113,25,14,19/1/2022 7:23
11/9/2021,Phang-nga,59,1411,268130,133856,134274,11169,9671,1498,,,19/1/2022 7:23
11/9/2021,Phatthalung,14,3282,522511,254483,268028,1958,1958,0,,,19/1/2022 7:23
11/9/2021,Phichit,24,3661,530097,258414,271683,7058,7058,0,,,19/1/2022 7:23
11/9/2021,Phitsanulok,26,4044,847460,414773,432687,33623,33466,157,,,19/1/2022 7:23
11/9/2021,Phuket,238,6845,419217,198181,221036,85481,60028,25453,53,23,19/1/2022 7:23
11/9/2021,Maha Sarakham,40,9005,949461,465434,484027,4086,4086,0,,,19/1/2022 7:23
11/9/2021,Mukdahan,1,1939,351274,175455,175819,17246,17246,0,,,19/1/2022 7:23
11/9/2021,Yala,309,14720,541791,269774,272017,710,710,0,45, ,19/1/2022 7:23
11/9/2021,Yasothon,14,4758,533435,266108,267327,3724,3724,0,,,19/1/2022 7:23
11/9/2021,Ranong,121,7440,194674,98251,96423,2582,2582,0,,,19/1/2022 7:23
11/9/2021,Rayong,441,23437,749481,368005,381476,24688,24442,246,30,21,19/1/2022 7:23
11/9/2021,Ratchaburi,629,22871,868959,422400,446559,30897,30897,0,,,19/1/2022 7:23
11/9/2021,Roi Et,51,12315,1296274,642169,654105,3672,3672,0,,,19/1/2022 7:23
11/9/2021,Lop Buri,144,12361,740199,368985,371214,24082,24044,38,,,19/1/2022 7:23
11/9/2021,Lampang,4,2101,725923,353601,372322,9312,9210,102,37,15,19/1/2022 7:23
11/9/2021,Lamphun,26,1455,401450,192935,208515,8920,8828,92,,,19/1/2022 7:23
11/9/2021,Si Sa Ket,71,13785,1456968,725147,731821,15417,15417,0,,,19/1/2022 7:23
11/9/2021,Sakon Nakhon,56,6636,1146233,569519,576714,10521,10521,0,,,19/1/2022 7:23
11/9/2021,Songkhla,473,23984,1431271,697260,734011,1827,1827,0,57,30,19/1/2022 7:23
11/9/2021,Satun,37,1644,324578,161454,163124,1995,1995,0,,,19/1/2022 7:23
11/9/2021,Samut Prakarn,1308,95425,1355935,645831,710104,12413,12329,84,,,19/1/2022 7:23
11/9/2021,Samut Songkhram,77,8967,191160,91278,99882,31388,31388,0,23,14,19/1/2022 7:23
11/9/2021,Samut Sakhon,643,100191,585760,282297,303463,7943,7943,0, ,34,19/1/2022 7:23
11/9/2021,Saraburi,303,22518,644131,316501,327630,30780,30737,43,42,63,19/1/2022 7:23
11/9/2021,Sa kaeo,244,10802,561572,280341,281231,4108,4108,0,30,26,19/1/2022 7:23
11/9/2021,Sing Buri,17,2297,204996,97383,107613,9410,9410,0,,,19/1/2022 7:23
11/9/2021,Suphan Buri,79,11341,835999,403285,432714,30584,30584,0,,,19/1/2022 7:23
11/9/2021,Surat Thani,170,8529,1072025,527245,544780,4772,3619,1153,56,25,19/1/2022 7:23
11/9/2021,Surin,69,13948,1376610,684728,691882,9296,9269,27,,,19/1/2022 7:23
11/9/2021,Sukhothai,53,4988,585695,283594,302101,6514,6514,0,,,19/1/2022 7:23
11/9/2021,Nong Khai,58,2852,516903,256356,260547,11497,11490,7,35,14,19/1/2022 7:23
11/9/2021,Nong Bua Lam Phu,15,3575,508929,253795,255134,1880,1880,0,,,19/1/2022 7:23
11/9/2021,Amnat Charoen,6,2624,376291,187148,189143,2964,2964,0,,,19/1/2022 7:23
11/9/2021,Udon Thani,669,12600,1566740,775793,790947,11621,11611,10,,,19/1/2022 7:23
11/9/2021,Uttaradit,30,3428,446754,217769,228985,7108,7108,0,,,19/1/2022 7:23
11/9/2021,Uthai Thani,17,3147,325202,158940,166262,2630,2630,0,,,19/1/2022 7:23
11/9/2021,Ubon Ratchathani,78,15355,1867421,932017,935404,25612,25612,0,34,21,19/1/2022 7:23
11/9/2021,Ang Thong,57,9370,275337,131732,143605,5978,5978,0,,,19/1/2022 7:23
11/9/2021,Chiang Rai,21,3277,1297567,630638,666929,52280,52001,279,36,14,19/1/2022 7:23
11/9/2021,Chiang Mai,38,11538,1787951,863847,924104,149552,148477,1075,46,21,19/1/2022 7:23
11/9/2021,Phetchaburi,75,16267,482635,232935,249700,88893,88804,89,,,19/1/2022 7:23
11/9/2021,Phetchabun,64,8430,978763,482612,496151,26514,26475,39,,,19/1/2022 7:23
11/9/2021,Loei,15,2728,638822,320038,318784,13785,13770,15,18,12,19/1/2022 7:23
11/9/2021,Phrae,8,1447,435288,209765,225523,11993,11993,0,22,17,19/1/2022 7:23
11/9/2021,Mae Hong Son,36,435,285937,144838,141099,11764,11539,225,19,6,19/1/2022 7:23
11/9/2021,,0,153,,,,,,,,,19/1/2022 7:23
12/9/2021,Krabi,72,2402,478854,237878,240976,4086,3912,174,,,19/1/2022 7:23
12/9/2021,Bangkok,3397,351208,5538629,2598539,2940090,448391,422787,25604,46,23,19/1/2022 7:23
12/9/2021,Kanchanaburi,158,14786,894044,448524,445520,190781,190728,53,23,15,19/1/2022 7:23
12/9/2021,Kalasin,18,7230,976025,482401,493624,4757,4757,0,,,19/1/2022 7:23
12/9/2021,Kamphaeng Phet,50,6544,712444,351736,360708,7679,7679,0,,,19/1/2022 7:23
12/9/2021,Khon Kaen,116,11964,1791794,880418,911376,36884,36884,0,52,30,19/1/2022 7:23
12/9/2021,Chanthaburi,219,7761,536411,262228,274183,24937,24842,95,,,19/1/2022 7:23
12/9/2021,Chachoengsao,206,28985,723178,354451,368727,7480,7480,0,47,34,19/1/2022 7:23
12/9/2021,Chon Buri,850,76036,1581618,771595,810023,119870,119059,811,42,32,19/1/2022 7:23
12/9/2021,Chai Nat,18,2141,320948,154287,166661,11052,11052,0,,,19/1/2022 7:23
12/9/2021,Chaiyaphum,37,8411,1122539,554554,567985,16842,16813,29,,,19/1/2022 7:23
12/9/2021,Chumphon,98,5889,509344,251379,257965,2620,2620,0,,,19/1/2022 7:23
12/9/2021,Trang,42,4727,639876,312767,327109,5191,5191,0,,,19/1/2022 7:23
12/9/2021,Trat,89,3392,228450,112952,115498,33159,33006,153,,,19/1/2022 7:23
12/9/2021,Tak,211,12862,675112,341344,333768,18741,18741,0,,,19/1/2022 7:23
12/9/2021,Nakhon Nayok,63,8812,260238,128796,131442,6150,6150,0,,,19/1/2022 7:23
12/9/2021,Nakhon Pathom,194,30327,921861,442674,479187,17076,17058,18,45,18,19/1/2022 7:23
12/9/2021,Nakhon Phanom,11,4640,717043,357140,359903,9839,9839,0,,,19/1/2022 7:23
12/9/2021,Nakhon Ratchasima,173,21274,2634005,1293977,1340028,158830,157909,921,48,23,19/1/2022 7:23
12/9/2021,Nakhon Si Thammarat,236,10017,1549321,764443,784878,9361,9361,0,,,19/1/2022 7:23
12/9/2021,Nakhon Sawan,79,9207,1036053,505240,530813,18756,18756,0,43,25,19/1/2022 7:23
12/9/2021,Nonthaburi,426,56921,1285994,598164,687830,13326,13275,51,26,16,19/1/2022 7:23
12/9/2021,Narathiwat,288,17431,808908,400179,408729,945,945,0,35,11,19/1/2022 7:23
12/9/2021,Nan,3,2307,475915,238017,237898,21353,21281,72,,,19/1/2022 7:23
12/9/2021,Bueng Kan,4,1727,421910,211455,210455,2662,2662,0,,,19/1/2022 7:23
12/9/2021,Buri Ram,82,14524,1579547,783516,796031,22217,22141,76,,,19/1/2022 7:23
12/9/2021,Pathum Thani,198,35920,1186767,562265,624502,10969,10893,76,42,24,19/1/2022 7:23
12/9/2021,Prachuap Khiri Khan,68,9619,553460,274610,278850,78909,78814,95,,,19/1/2022 7:23
12/9/2021,Prachin Buri,379,11056,494821,244371,250450,7010,7010,0,58,41,19/1/2022 7:23
12/9/2021,Pattani,178,17534,728989,360071,368918,1410,1410,0,,,19/1/2022 7:23
12/9/2021,Phra Nakhon Si Ayutthaya,221,25076,820211,393877,426334,63382,63260,122,35, ,19/1/2022 7:23
12/9/2021,Phayao,3,1675,465194,226350,238844,12520,12407,113,36,17,19/1/2022 7:23
12/9/2021,Phang-nga,78,1489,268130,133856,134274,11169,9671,1498,,,19/1/2022 7:23
12/9/2021,Phatthalung,17,3299,522511,254483,268028,1958,1958,0,,,19/1/2022 7:23
12/9/2021,Phichit,38,3699,530097,258414,271683,7058,7058,0,,,19/1/2022 7:23
12/9/2021,Phitsanulok,34,4078,847460,414773,432687,33623,33466,157,,,19/1/2022 7:23
12/9/2021,Phuket,229,7074,419217,198181,221036,85481,60028,25453,49,31,19/1/2022 7:23
12/9/2021,Maha Sarakham,37,9042,949461,465434,484027,4086,4086,0,,,19/1/2022 7:23
12/9/2021,Mukdahan,9,1948,351274,175455,175819,17246,17246,0,,,19/1/2022 7:23
12/9/2021,Yala,402,15122,541791,269774,272017,710,710,0, ,17,19/1/2022 7:23
12/9/2021,Yasothon,44,4802,533435,266108,267327,3724,3724,0,,,19/1/2022 7:23
12/9/2021,Ranong,113,7553,194674,98251,96423,2582,2582,0,,,19/1/2022 7:23
12/9/2021,Rayong,525,23962,749481,368005,381476,24688,24442,246,36,24,19/1/2022 7:23
12/9/2021,Ratchaburi,518,23389,868959,422400,446559,30897,30897,0,,,19/1/2022 7:23
12/9/2021,Roi Et,42,12357,1296274,642169,654105,3672,3672,0,,,19/1/2022 7:23
12/9/2021,Lop Buri,129,12490,740199,368985,371214,24082,24044,38,,,19/1/2022 7:23
12/9/2021,Lampang,6,2107,725923,353601,372322,9312,9210,102,47,16,19/1/2022 7:23
12/9/2021,Lamphun,91,1546,401450,192935,208515,8920,8828,92,,,19/1/2022 7:23
12/9/2021,Si Sa Ket,50,13835,1456968,725147,731821,15417,15417,0,,,19/1/2022 7:23
12/9/2021,Sakon Nakhon,59,6695,1146233,569519,576714,10521,10521,0,,,19/1/2022 7:23
12/9/2021,Songkhla,396,24380,1431271,697260,734011,1827,1827,0,57,24,19/1/2022 7:23
12/9/2021,Satun,14,1658,324578,161454,163124,1995,1995,0, ,17,19/1/2022 7:23
12/9/2021,Samut Prakarn,832,96257,1355935,645831,710104,12413,12329,84,,,19/1/2022 7:23
12/9/2021,Samut Songkhram,84,9051,191160,91278,99882,31388,31388,0,30,18,19/1/2022 7:23
12/9/2021,Samut Sakhon,506,100697,585760,282297,303463,7943,7943,0, ,31,19/1/2022 7:23
12/9/2021,Saraburi,251,22769,644131,316501,327630,30780,30737,43,66,74,19/1/2022 7:23
12/9/2021,Sa kaeo,134,10936,561572,280341,281231,4108,4108,0,39,29,19/1/2022 7:23
12/9/2021,Sing Buri,25,2322,204996,97383,107613,9410,9410,0,,,19/1/2022 7:23
12/9/2021,Suphan Buri,74,11415,835999,403285,432714,30584,30584,0,,,19/1/2022 7:23
12/9/2021,Surat Thani,159,8688,1072025,527245,544780,4772,3619,1153,56,26,19/1/2022 7:23
12/9/2021,Surin,110,14058,1376610,684728,691882,9296,9269,27,,,19/1/2022 7:23
12/9/2021,Sukhothai,58,5046,585695,283594,302101,6514,6514,0,,,19/1/2022 7:23
12/9/2021,Nong Khai,18,2870,516903,256356,260547,11497,11490,7,35,15,19/1/2022 7:23
12/9/2021,Nong Bua Lam Phu,6,3581,508929,253795,255134,1880,1880,0,,,19/1/2022 7:23
12/9/2021,Amnat Charoen,11,2635,376291,187148,189143,2964,2964,0,,,19/1/2022 7:23
12/9/2021,Udon Thani,341,12941,1566740,775793,790947,11621,11611,10,,,19/1/2022 7:23
12/9/2021,Uttaradit,13,3441,446754,217769,228985,7108,7108,0,,,19/1/2022 7:23
12/9/2021,Uthai Thani,14,3161,325202,158940,166262,2630,2630,0,,,19/1/2022 7:23
12/9/2021,Ubon Ratchathani,90,15445,1867421,932017,935404,25612,25612,0,37,19,19/1/2022 7:23
12/9/2021,Ang Thong,58,9428,275337,131732,143605,5978,5978,0,,,19/1/2022 7:23
12/9/2021,Chiang Rai,17,3294,1297567,630638,666929,52280,52001,279,40,17,19/1/2022 7:23
12/9/2021,Chiang Mai,33,11571,1787951,863847,924104,149552,148477,1075,46,26,19/1/2022 7:23
12/9/2021,Phetchaburi,82,16349,482635,232935,249700,88893,88804,89,,,19/1/2022 7:23
12/9/2021,Phetchabun,58,8488,978763,482612,496151,26514,26475,39,,,19/1/2022 7:23
12/9/2021,Loei,9,2737,638822,320038,318784,13785,13770,15,19,15,19/1/2022 7:23
12/9/2021,Phrae,3,1450,435288,209765,225523,11993,11993,0,30,18,19/1/2022 7:23
12/9/2021,Mae Hong Son,25,460,285937,144838,141099,11764,11539,225,23,6,19/1/2022 7:23
12/9/2021,,0,153,,,,,,,,,19/1/2022 7:23
13/9/2021,Krabi,62,2464,478854,237878,240976,4086,3912,174,,,19/1/2022 7:23
13/9/2021,Bangkok,3364,354572,5538629,2598539,2940090,448391,422787,25604,45,25,19/1/2022 7:23
13/9/2021,Kanchanaburi,167,14953,894044,448524,445520,190781,190728,53,34,14,19/1/2022 7:23
13/9/2021,Kalasin,41,7271,976025,482401,493624,4757,4757,0,,,19/1/2022 7:23
13/9/2021,Kamphaeng Phet,39,6583,712444,351736,360708,7679,7679,0,,,19/1/2022 7:23
13/9/2021,Khon Kaen,106,12070,1791794,880418,911376,36884,36884,0,62, ,19/1/2022 7:23
13/9/2021,Chanthaburi,119,7880,536411,262228,274183,24937,24842,95,,,19/1/2022 7:23
13/9/2021,Chachoengsao,148,29133,723178,354451,368727,7480,7480,0,47,34,19/1/2022 7:23
13/9/2021,Chon Buri,650,76686,1581618,771595,810023,119870,119059,811,49,25,19/1/2022 7:23
13/9/2021,Chai Nat,4,2145,320948,154287,166661,11052,11052,0,,,19/1/2022 7:23
13/9/2021,Chaiyaphum,43,8454,1122539,554554,567985,16842,16813,29,,,19/1/2022 7:23
13/9/2021,Chumphon,159,6048,509344,251379,257965,2620,2620,0,,,19/1/2022 7:23
13/9/2021,Trang,29,4756,639876,312767,327109,5191,5191,0,,,19/1/2022 7:23
13/9/2021,Trat,38,3430,228450,112952,115498,33159,33006,153,,,19/1/2022 7:23
13/9/2021,Tak,197,13059,675112,341344,333768,18741,18741,0,,,19/1/2022 7:23
13/9/2021,Nakhon Nayok,12,8824,260238,128796,131442,6150,6150,0,,,19/1/2022 7:23
13/9/2021,Nakhon Pathom,158,30485,921861,442674,479187,17076,17058,18,48,17,19/1/2022 7:23
13/9/2021,Nakhon Phanom,20,4660,717043,357140,359903,9839,9839,0,,,19/1/2022 7:23
13/9/2021,Nakhon Ratchasima,212,21486,2634005,1293977,1340028,158830,157909,921,54,16,19/1/2022 7:23
13/9/2021,Nakhon Si Thammarat,235,10252,1549321,764443,784878,9361,9361,0,,,19/1/2022 7:23
13/9/2021,Nakhon Sawan,67,9274,1036053,505240,530813,18756,18756,0,46,24,19/1/2022 7:23
13/9/2021,Nonthaburi,472,57393,1285994,598164,687830,13326,13275,51,29,19,19/1/2022 7:23
13/9/2021,Narathiwat,403,17834,808908,400179,408729,945,945,0,25,19,19/1/2022 7:23
13/9/2021,Nan,3,2310,475915,238017,237898,21353,21281,72,,,19/1/2022 7:23
13/9/2021,Bueng Kan,3,1730,421910,211455,210455,2662,2662,0,,,19/1/2022 7:23
13/9/2021,Buri Ram,69,14593,1579547,783516,796031,22217,22141,76,,,19/1/2022 7:23
13/9/2021,Pathum Thani,225,36145,1186767,562265,624502,10969,10893,76,50,29,19/1/2022 7:23
13/9/2021,Prachuap Khiri Khan,59,9678,553460,274610,278850,78909,78814,95,,,19/1/2022 7:23
13/9/2021,Prachin Buri,276,11332,494821,244371,250450,7010,7010,0,63,39,19/1/2022 7:23
13/9/2021,Pattani,261,17795,728989,360071,368918,1410,1410,0,,,19/1/2022 7:23
13/9/2021,Phra Nakhon Si Ayutthaya,217,25293,820211,393877,426334,63382,63260,122,38, ,19/1/2022 7:23
13/9/2021,Phayao,4,1679,465194,226350,238844,12520,12407,113,42,13,19/1/2022 7:23
13/9/2021,Phang-nga,62,1551,268130,133856,134274,11169,9671,1498,,,19/1/2022 7:23
13/9/2021,Phatthalung,22,3321,522511,254483,268028,1958,1958,0,,,19/1/2022 7:23
13/9/2021,Phichit,17,3716,530097,258414,271683,7058,7058,0,,,19/1/2022 7:23
13/9/2021,Phitsanulok,16,4094,847460,414773,432687,33623,33466,157,,,19/1/2022 7:23
13/9/2021,Phuket,245,7319,419217,198181,221036,85481,60028,25453,57,27,19/1/2022 7:23
13/9/2021,Maha Sarakham,19,9061,949461,465434,484027,4086,4086,0,,,19/1/2022 7:23
13/9/2021,Mukdahan,6,1954,351274,175455,175819,17246,17246,0,,,19/1/2022 7:23
13/9/2021,Yala,366,15488,541791,269774,272017,710,710,0,34,21,19/1/2022 7:23
13/9/2021,Yasothon,20,4822,533435,266108,267327,3724,3724,0,,,19/1/2022 7:23
13/9/2021,Ranong,112,7665,194674,98251,96423,2582,2582,0,,,19/1/2022 7:23
13/9/2021,Rayong,647,24609,749481,368005,381476,24688,24442,246,48,24,19/1/2022 7:23
13/9/2021,Ratchaburi,299,23688,868959,422400,446559,30897,30897,0,,,19/1/2022 7:23
13/9/2021,Roi Et,48,12405,1296274,642169,654105,3672,3672,0,,,19/1/2022 7:23
13/9/2021,Lop Buri,119,12609,740199,368985,371214,24082,24044,38,,,19/1/2022 7:23
13/9/2021,Lampang,2,2109,725923,353601,372322,9312,9210,102,50,17,19/1/2022 7:23
13/9/2021,Lamphun,27,1573,401450,192935,208515,8920,8828,92,,,19/1/2022 7:23
13/9/2021,Si Sa Ket,62,13897,1456968,725147,731821,15417,15417,0,,,19/1/2022 7:23
13/9/2021,Sakon Nakhon,27,6722,1146233,569519,576714,10521,10521,0,,,19/1/2022 7:23
13/9/2021,Songkhla,301,24681,1431271,697260,734011,1827,1827,0,44,38,19/1/2022 7:23
13/9/2021,Satun,33,1691,324578,161454,163124,1995,1995,0,26,33,19/1/2022 7:23
13/9/2021,Samut Prakarn,443,96700,1355935,645831,710104,12413,12329,84,,,19/1/2022 7:23
13/9/2021,Samut Songkhram,95,9146,191160,91278,99882,31388,31388,0,35,14,19/1/2022 7:23
13/9/2021,Samut Sakhon,402,101099,585760,282297,303463,7943,7943,0, ,38,19/1/2022 7:23
13/9/2021,Saraburi,233,23002,644131,316501,327630,30780,30737,43,65,91,19/1/2022 7:23
13/9/2021,Sa kaeo,66,11002,561572,280341,281231,4108,4108,0,52,21,19/1/2022 7:23
13/9/2021,Sing Buri,24,2346,204996,97383,107613,9410,9410,0,,,19/1/2022 7:23
13/9/2021,Suphan Buri,45,11460,835999,403285,432714,30584,30584,0,,,19/1/2022 7:23
13/9/2021,Surat Thani,160,8848,1072025,527245,544780,4772,3619,1153,50,29,19/1/2022 7:23
13/9/2021,Surin,150,14208,1376610,684728,691882,9296,9269,27,,,19/1/2022 7:23
13/9/2021,Sukhothai,20,5066,585695,283594,302101,6514,6514,0,,,19/1/2022 7:23
13/9/2021,Nong Khai,17,2887,516903,256356,260547,11497,11490,7,37,14,19/1/2022 7:23
13/9/2021,Nong Bua Lam Phu,14,3595,508929,253795,255134,1880,1880,0,,,19/1/2022 7:23
13/9/2021,Amnat Charoen,6,2641,376291,187148,189143,2964,2964,0,,,19/1/2022 7:23
13/9/2021,Udon Thani,166,13107,1566740,775793,790947,11621,11611,10,,,19/1/2022 7:23
13/9/2021,Uttaradit,9,3450,446754,217769,228985,7108,7108,0,,,19/1/2022 7:23
13/9/2021,Uthai Thani,13,3174,325202,158940,166262,2630,2630,0,,,19/1/2022 7:23
13/9/2021,Ubon Ratchathani,69,15514,1867421,932017,935404,25612,25612,0,38,22,19/1/2022 7:23
13/9/2021,Ang Thong,79,9507,275337,131732,143605,5978,5978,0,,,19/1/2022 7:23
13/9/2021,Chiang Rai,17,3311,1297567,630638,666929,52280,52001,279,50,14,19/1/2022 7:23
13/9/2021,Chiang Mai,62,11633,1787951,863847,924104,149552,148477,1075,52,23,19/1/2022 7:23
13/9/2021,Phetchaburi,101,16450,482635,232935,249700,88893,88804,89,,,19/1/2022 7:23
13/9/2021,Phetchabun,44,8532,978763,482612,496151,26514,26475,39,,,19/1/2022 7:23
13/9/2021,Loei,5,2742,638822,320038,318784,13785,13770,15,30,9,19/1/2022 7:23
13/9/2021,Phrae,13,1463,435288,209765,225523,11993,11993,0,45,14,19/1/2022 7:23
13/9/2021,Mae Hong Son,18,478,285937,144838,141099,11764,11539,225,24,11,19/1/2022 7:23
13/9/2021,,0,153,,,,,,,,,19/1/2022 7:23
14/9/2021,Krabi,22,2486,478854,237878,240976,4086,3912,174,,,19/1/2022 7:23
14/9/2021,Bangkok,2804,357376,5538629,2598539,2940090,448391,422787,25604,53,23,19/1/2022 7:23
14/9/2021,Kanchanaburi,150,15103,894044,448524,445520,190781,190728,53,26,12,19/1/2022 7:23
14/9/2021,Kalasin,26,7297,976025,482401,493624,4757,4757,0,,,19/1/2022 7:23
14/9/2021,Kamphaeng Phet,28,6611,712444,351736,360708,7679,7679,0,,,19/1/2022 7:23
14/9/2021,Khon Kaen,111,12181,1791794,880418,911376,36884,36884,0, ,30,19/1/2022 7:23
14/9/2021,Chanthaburi,160,8040,536411,262228,274183,24937,24842,95,,,19/1/2022 7:23
14/9/2021,Chachoengsao,208,29341,723178,354451,368727,7480,7480,0,46,26,19/1/2022 7:23
14/9/2021,Chon Buri,955,77641,1581618,771595,810023,119870,119059,811,41,19,19/1/2022 7:23
14/9/2021,Chai Nat,15,2160,320948,154287,166661,11052,11052,0,,,19/1/2022 7:23
14/9/2021,Chaiyaphum,36,8490,1122539,554554,567985,16842,16813,29,,,19/1/2022 7:23
14/9/2021,Chumphon,194,6242,509344,251379,257965,2620,2620,0,,,19/1/2022 7:23
14/9/2021,Trang,30,4786,639876,312767,327109,5191,5191,0,,,19/1/2022 7:23
14/9/2021,Trat,74,3504,228450,112952,115498,33159,33006,153,,,19/1/2022 7:23
14/9/2021,Tak,144,13203,675112,341344,333768,18741,18741,0,,,19/1/2022 7:23
14/9/2021,Nakhon Nayok,41,8865,260238,128796,131442,6150,6150,0,,,19/1/2022 7:23
14/9/2021,Nakhon Pathom,167,30652,921861,442674,479187,17076,17058,18,47,18,19/1/2022 7:23
14/9/2021,Nakhon Phanom,25,4685,717043,357140,359903,9839,9839,0,,,19/1/2022 7:23
14/9/2021,Nakhon Ratchasima,163,21649,2634005,1293977,1340028,158830,157909,921,45,21,19/1/2022 7:23
14/9/2021,Nakhon Si Thammarat,197,10449,1549321,764443,784878,9361,9361,0,,,19/1/2022 7:23
14/9/2021,Nakhon Sawan,120,9394,1036053,505240,530813,18756,18756,0,47,32,19/1/2022 7:23
14/9/2021,Nonthaburi,484,57877,1285994,598164,687830,13326,13275,51,44,14,19/1/2022 7:23
14/9/2021,Narathiwat,262,18096,808908,400179,408729,945,945,0,40,23,19/1/2022 7:23
14/9/2021,Nan,2,2312,475915,238017,237898,21353,21281,72,,,19/1/2022 7:23
14/9/2021,Bueng Kan,1,1731,421910,211455,210455,2662,2662,0,,,19/1/2022 7:23
14/9/2021,Buri Ram,58,14651,1579547,783516,796031,22217,22141,76,,,19/1/2022 7:23
14/9/2021,Pathum Thani,70,36215,1186767,562265,624502,10969,10893,76,59,25,19/1/2022 7:23
14/9/2021,Prachuap Khiri Khan,109,9787,553460,274610,278850,78909,78814,95,,,19/1/2022 7:23
14/9/2021,Prachin Buri,296,11628,494821,244371,250450,7010,7010,0,69,30,19/1/2022 7:23
14/9/2021,Pattani,126,17921,728989,360071,368918,1410,1410,0,,,19/1/2022 7:23
14/9/2021,Phra Nakhon Si Ayutthaya,207,25500,820211,393877,426334,63382,63260,122,40,39,19/1/2022 7:23
14/9/2021,Phayao,0,1679,465194,226350,238844,12520,12407,113,38,17,19/1/2022 7:23
14/9/2021,Phang-nga,69,1620,268130,133856,134274,11169,9671,1498,,,19/1/2022 7:23
14/9/2021,Phatthalung,26,3347,522511,254483,268028,1958,1958,0,,,19/1/2022 7:23
14/9/2021,Phichit,25,3741,530097,258414,271683,7058,7058,0,,,19/1/2022 7:23
14/9/2021,Phitsanulok,30,4124,847460,414773,432687,33623,33466,157,,,19/1/2022 7:23
14/9/2021,Phuket,251,7570,419217,198181,221036,85481,60028,25453,56,27,19/1/2022 7:23
14/9/2021,Maha Sarakham,37,9098,949461,465434,484027,4086,4086,0,,,19/1/2022 7:23
14/9/2021,Mukdahan,14,1968,351274,175455,175819,17246,17246,0,,,19/1/2022 7:23
14/9/2021,Yala,118,15606,541791,269774,272017,710,710,0,44,25,19/1/2022 7:23
14/9/2021,Yasothon,13,4835,533435,266108,267327,3724,3724,0,,,19/1/2022 7:23
14/9/2021,Ranong,73,7738,194674,98251,96423,2582,2582,0,,,19/1/2022 7:23
14/9/2021,Rayong,217,24826,749481,368005,381476,24688,24442,246,43,20,19/1/2022 7:23
14/9/2021,Ratchaburi,314,24002,868959,422400,446559,30897,30897,0,,,19/1/2022 7:23
14/9/2021,Roi Et,53,12458,1296274,642169,654105,3672,3672,0,,,19/1/2022 7:23
14/9/2021,Lop Buri,97,12706,740199,368985,371214,24082,24044,38,,,19/1/2022 7:23
14/9/2021,Lampang,4,2113,725923,353601,372322,9312,9210,102,55,17,19/1/2022 7:23
14/9/2021,Lamphun,24,1597,401450,192935,208515,8920,8828,92,,,19/1/2022 7:23
14/9/2021,Si Sa Ket,42,13939,1456968,725147,731821,15417,15417,0,,,19/1/2022 7:23
14/9/2021,Sakon Nakhon,29,6751,1146233,569519,576714,10521,10521,0,,,19/1/2022 7:23
14/9/2021,Songkhla,272,24953,1431271,697260,734011,1827,1827,0,67,32,19/1/2022 7:23
14/9/2021,Satun,31,1722,324578,161454,163124,1995,1995,0,62,27,19/1/2022 7:23
14/9/2021,Samut Prakarn,811,97511,1355935,645831,710104,12413,12329,84,,,19/1/2022 7:23
14/9/2021,Samut Songkhram,98,9244,191160,91278,99882,31388,31388,0,29,12,19/1/2022 7:23
14/9/2021,Samut Sakhon,542,101641,585760,282297,303463,7943,7943,0,52,38,19/1/2022 7:23
14/9/2021,Saraburi,127,23129,644131,316501,327630,30780,30737,43,82,79,19/1/2022 7:23
14/9/2021,Sa kaeo,51,11053,561572,280341,281231,4108,4108,0,40,18,19/1/2022 7:23
14/9/2021,Sing Buri,22,2368,204996,97383,107613,9410,9410,0,,,19/1/2022 7:23
14/9/2021,Suphan Buri,47,11507,835999,403285,432714,30584,30584,0,,,19/1/2022 7:23
14/9/2021,Surat Thani,252,9100,1072025,527245,544780,4772,3619,1153,65,25,19/1/2022 7:23
14/9/2021,Surin,53,14261,1376610,684728,691882,9296,9269,27,,,19/1/2022 7:23
14/9/2021,Sukhothai,23,5089,585695,283594,302101,6514,6514,0,,,19/1/2022 7:23
14/9/2021,Nong Khai,15,2902,516903,256356,260547,11497,11490,7,33,14,19/1/2022 7:23
14/9/2021,Nong Bua Lam Phu,10,3605,508929,253795,255134,1880,1880,0,,,19/1/2022 7:23
14/9/2021,Amnat Charoen,5,2646,376291,187148,189143,2964,2964,0,,,19/1/2022 7:23
14/9/2021,Udon Thani,296,13403,1566740,775793,790947,11621,11611,10,,,19/1/2022 7:23
14/9/2021,Uttaradit,35,3485,446754,217769,228985,7108,7108,0,,,19/1/2022 7:23
14/9/2021,Uthai Thani,6,3180,325202,158940,166262,2630,2630,0,,,19/1/2022 7:23
14/9/2021,Ubon Ratchathani,53,15567,1867421,932017,935404,25612,25612,0,46,22,19/1/2022 7:23
14/9/2021,Ang Thong,45,9552,275337,131732,143605,5978,5978,0,,,19/1/2022 7:23
14/9/2021,Chiang Rai,14,3325,1297567,630638,666929,52280,52001,279,37,15,19/1/2022 7:23
14/9/2021,Chiang Mai,96,11729,1787951,863847,924104,149552,148477,1075,61,22,19/1/2022 7:23
14/9/2021,Phetchaburi,76,16526,482635,232935,249700,88893,88804,89,,,19/1/2022 7:23
14/9/2021,Phetchabun,41,8573,978763,482612,496151,26514,26475,39,,,19/1/2022 7:23
14/9/2021,Loei,10,2752,638822,320038,318784,13785,13770,15,21,10,19/1/2022 7:23
14/9/2021,Phrae,6,1469,435288,209765,225523,11993,11993,0,38,16,19/1/2022 7:23
14/9/2021,Mae Hong Son,28,506,285937,144838,141099,11764,11539,225,42,14,19/1/2022 7:23
14/9/2021,,0,153,,,,,,,,,19/1/2022 7:23
15/9/2021,Krabi,44,2530,478854,237878,240976,4086,3912,174,,,19/1/2022 7:23
15/9/2021,Bangkok,2789,360165,5538629,2598539,2940090,448391,422787,25604,50,19,19/1/2022 7:23
15/9/2021,Kanchanaburi,68,15171,894044,448524,445520,190781,190728,53,26,14,19/1/2022 7:23
15/9/2021,Kalasin,56,7353,976025,482401,493624,4757,4757,0,,,19/1/2022 7:23
15/9/2021,Kamphaeng Phet,34,6645,712444,351736,360708,7679,7679,0,,,19/1/2022 7:23
15/9/2021,Khon Kaen,147,12328,1791794,880418,911376,36884,36884,0,58,23,19/1/2022 7:23
15/9/2021,Chanthaburi,209,8249,536411,262228,274183,24937,24842,95,,,19/1/2022 7:23
15/9/2021,Chachoengsao,284,29625,723178,354451,368727,7480,7480,0,58,26,19/1/2022 7:23
15/9/2021,Chon Buri,835,78476,1581618,771595,810023,119870,119059,811,36,29,19/1/2022 7:23
15/9/2021,Chai Nat,19,2179,320948,154287,166661,11052,11052,0,,,19/1/2022 7:23
15/9/2021,Chaiyaphum,217,8707,1122539,554554,567985,16842,16813,29,,,19/1/2022 7:23
15/9/2021,Chumphon,172,6414,509344,251379,257965,2620,2620,0,,,19/1/2022 7:23
15/9/2021,Trang,23,4809,639876,312767,327109,5191,5191,0,,,19/1/2022 7:23
15/9/2021,Trat,105,3609,228450,112952,115498,33159,33006,153,,,19/1/2022 7:23
15/9/2021,Tak,185,13388,675112,341344,333768,18741,18741,0,,,19/1/2022 7:23
15/9/2021,Nakhon Nayok,112,8977,260238,128796,131442,6150,6150,0,,,19/1/2022 7:23
15/9/2021,Nakhon Pathom,145,30797,921861,442674,479187,17076,17058,18,41,16,19/1/2022 7:23
15/9/2021,Nakhon Phanom,14,4699,717043,357140,359903,9839,9839,0,,,19/1/2022 7:23
15/9/2021,Nakhon Ratchasima,178,21827,2634005,1293977,1340028,158830,157909,921,51,16,19/1/2022 7:23
15/9/2021,Nakhon Si Thammarat,323,10772,1549321,764443,784878,9361,9361,0,,,19/1/2022 7:23
15/9/2021,Nakhon Sawan,120,9514,1036053,505240,530813,18756,18756,0,65,26,19/1/2022 7:23
15/9/2021,Nonthaburi,368,58245,1285994,598164,687830,13326,13275,51,26,15,19/1/2022 7:23
15/9/2021,Narathiwat,374,18470,808908,400179,408729,945,945,0,51,24,19/1/2022 7:23
15/9/2021,Nan,4,2316,475915,238017,237898,21353,21281,72,,,19/1/2022 7:23
15/9/2021,Bueng Kan,2,1733,421910,211455,210455,2662,2662,0,,,19/1/2022 7:23
15/9/2021,Buri Ram,87,14738,1579547,783516,796031,22217,22141,76,,,19/1/2022 7:23
15/9/2021,Pathum Thani,164,36379,1186767,562265,624502,10969,10893,76,55,33,19/1/2022 7:23
15/9/2021,Prachuap Khiri Khan,76,9863,553460,274610,278850,78909,78814,95,,,19/1/2022 7:23
15/9/2021,Prachin Buri,345,11973,494821,244371,250450,7010,7010,0,62,25,19/1/2022 7:23
15/9/2021,Pattani,215,18136,728989,360071,368918,1410,1410,0,,,19/1/2022 7:23
15/9/2021,Phra Nakhon Si Ayutthaya,135,25635,820211,393877,426334,63382,63260,122,49,31,19/1/2022 7:23
15/9/2021,Phayao,11,1690,465194,226350,238844,12520,12407,113,45,15,19/1/2022 7:23
15/9/2021,Phang-nga,79,1699,268130,133856,134274,11169,9671,1498,,,19/1/2022 7:23
15/9/2021,Phatthalung,32,3379,522511,254483,268028,1958,1958,0,,,19/1/2022 7:23
15/9/2021,Phichit,37,3778,530097,258414,271683,7058,7058,0,,,19/1/2022 7:23
15/9/2021,Phitsanulok,39,4163,847460,414773,432687,33623,33466,157,,,19/1/2022 7:23
15/9/2021,Phuket,229,7799,419217,198181,221036,85481,60028,25453,59,26,19/1/2022 7:23
15/9/2021,Maha Sarakham,47,9145,949461,465434,484027,4086,4086,0,,,19/1/2022 7:23
15/9/2021,Mukdahan,18,1986,351274,175455,175819,17246,17246,0,,,19/1/2022 7:23
15/9/2021,Yala,295,15901,541791,269774,272017,710,710,0,51,18,19/1/2022 7:23
15/9/2021,Yasothon,9,4844,533435,266108,267327,3724,3724,0,,,19/1/2022 7:23
15/9/2021,Ranong,59,7797,194674,98251,96423,2582,2582,0,,,19/1/2022 7:23
15/9/2021,Rayong,680,25506,749481,368005,381476,24688,24442,246,36,20,19/1/2022 7:23
15/9/2021,Ratchaburi,487,24489,868959,422400,446559,30897,30897,0,,,19/1/2022 7:23
15/9/2021,Roi Et,33,12491,1296274,642169,654105,3672,3672,0,,,19/1/2022 7:23
15/9/2021,Lop Buri,106,12812,740199,368985,371214,24082,24044,38,,,19/1/2022 7:23
15/9/2021,Lampang,3,2116,725923,353601,372322,9312,9210,102,53,15,19/1/2022 7:23
15/9/2021,Lamphun,31,1628,401450,192935,208515,8920,8828,92,,,19/1/2022 7:23
15/9/2021,Si Sa Ket,69,14008,1456968,725147,731821,15417,15417,0,,,19/1/2022 7:23
15/9/2021,Sakon Nakhon,30,6781,1146233,569519,576714,10521,10521,0,,,19/1/2022 7:23
15/9/2021,Songkhla,327,25280,1431271,697260,734011,1827,1827,0,60,36,19/1/2022 7:23
15/9/2021,Satun,16,1738,324578,161454,163124,1995,1995,0,51,34,19/1/2022 7:23
15/9/2021,Samut Prakarn,1351,98862,1355935,645831,710104,12413,12329,84,,,19/1/2022 7:23
15/9/2021,Samut Songkhram,94,9338,191160,91278,99882,31388,31388,0,25,12,19/1/2022 7:23
15/9/2021,Samut Sakhon,404,102045,585760,282297,303463,7943,7943,0,60,29,19/1/2022 7:23
15/9/2021,Saraburi,218,23347,644131,316501,327630,30780,30737,43,79,71,19/1/2022 7:23
15/9/2021,Sa kaeo,119,11172,561572,280341,281231,4108,4108,0,32,12,19/1/2022 7:23
15/9/2021,Sing Buri,9,2377,204996,97383,107613,9410,9410,0,,,19/1/2022 7:23
15/9/2021,Suphan Buri,68,11575,835999,403285,432714,30584,30584,0,,,19/1/2022 7:23
15/9/2021,Surat Thani,214,9314,1072025,527245,544780,4772,3619,1153,70,28,19/1/2022 7:23
15/9/2021,Surin,49,14310,1376610,684728,691882,9296,9269,27,,,19/1/2022 7:23
15/9/2021,Sukhothai,57,5146,585695,283594,302101,6514,6514,0,,,19/1/2022 7:23
15/9/2021,Nong Khai,21,2923,516903,256356,260547,11497,11490,7,35,15,19/1/2022 7:23
15/9/2021,Nong Bua Lam Phu,14,3619,508929,253795,255134,1880,1880,0,,,19/1/2022 7:23
15/9/2021,Amnat Charoen,8,2654,376291,187148,189143,2964,2964,0,,,19/1/2022 7:23
15/9/2021,Udon Thani,278,13681,1566740,775793,790947,11621,11611,10,,,19/1/2022 7:23
15/9/2021,Uttaradit,49,3534,446754,217769,228985,7108,7108,0,,,19/1/2022 7:23
15/9/2021,Uthai Thani,10,3190,325202,158940,166262,2630,2630,0,,,19/1/2022 7:23
15/9/2021,Ubon Ratchathani,64,15631,1867421,932017,935404,25612,25612,0,46,20,19/1/2022 7:23
15/9/2021,Ang Thong,29,9581,275337,131732,143605,5978,5978,0,,,19/1/2022 7:23
15/9/2021,Chiang Rai,28,3353,1297567,630638,666929,52280,52001,279,46,10,19/1/2022 7:23
15/9/2021,Chiang Mai,54,11783,1787951,863847,924104,149552,148477,1075,55,20,19/1/2022 7:23
15/9/2021,Phetchaburi,130,16656,482635,232935,249700,88893,88804,89,,,19/1/2022 7:23
15/9/2021,Phetchabun,23,8596,978763,482612,496151,26514,26475,39,,,19/1/2022 7:23
15/9/2021,Loei,5,2757,638822,320038,318784,13785,13770,15,16,10,19/1/2022 7:23
15/9/2021,Phrae,5,1474,435288,209765,225523,11993,11993,0,45,14,19/1/2022 7:23
15/9/2021,Mae Hong Son,11,517,285937,144838,141099,11764,11539,225,51,7,19/1/2022 7:23
15/9/2021,,0,153,,,,,,,,,19/1/2022 7:23
16/9/2021,Krabi,64,2594,478854,237878,240976,4086,3912,174,,,19/1/2022 7:23
16/9/2021,Bangkok,2917,363082,5538629,2598539,2940090,448391,422787,25604,37,22,19/1/2022 7:23
16/9/2021,Kanchanaburi,181,15352,894044,448524,445520,190781,190728,53,29,15,19/1/2022 7:23
16/9/2021,Kalasin,35,7388,976025,482401,493624,4757,4757,0,,,19/1/2022 7:23
16/9/2021,Kamphaeng Phet,35,6680,712444,351736,360708,7679,7679,0,,,19/1/2022 7:23
16/9/2021,Khon Kaen,95,12423,1791794,880418,911376,36884,36884,0,50, ,19/1/2022 7:23
16/9/2021,Chanthaburi,209,8458,536411,262228,274183,24937,24842,95,,,19/1/2022 7:23
16/9/2021,Chachoengsao,208,29833,723178,354451,368727,7480,7480,0,39,27,19/1/2022 7:23
16/9/2021,Chon Buri,974,79450,1581618,771595,810023,119870,119059,811,41,28,19/1/2022 7:23
16/9/2021,Chai Nat,6,2185,320948,154287,166661,11052,11052,0,,,19/1/2022 7:23
16/9/2021,Chaiyaphum,219,8926,1122539,554554,567985,16842,16813,29,,,19/1/2022 7:23
16/9/2021,Chumphon,180,6594,509344,251379,257965,2620,2620,0,,,19/1/2022 7:23
16/9/2021,Trang,26,4835,639876,312767,327109,5191,5191,0,,,19/1/2022 7:23
16/9/2021,Trat,76,3685,228450,112952,115498,33159,33006,153,,,19/1/2022 7:23
16/9/2021,Tak,144,13532,675112,341344,333768,18741,18741,0,,,19/1/2022 7:23
16/9/2021,Nakhon Nayok,82,9059,260238,128796,131442,6150,6150,0,,,19/1/2022 7:23
16/9/2021,Nakhon Pathom,148,30945,921861,442674,479187,17076,17058,18,36,17,19/1/2022 7:23
16/9/2021,Nakhon Phanom,14,4713,717043,357140,359903,9839,9839,0,,,19/1/2022 7:23
16/9/2021,Nakhon Ratchasima,163,21990,2634005,1293977,1340028,158830,157909,921,41,19,19/1/2022 7:23
16/9/2021,Nakhon Si Thammarat,360,11132,1549321,764443,784878,9361,9361,0,,,19/1/2022 7:23
16/9/2021,Nakhon Sawan,120,9634,1036053,505240,530813,18756,18756,0,49,26,19/1/2022 7:23
16/9/2021,Nonthaburi,295,58540,1285994,598164,687830,13326,13275,51,22,15,19/1/2022 7:23
16/9/2021,Narathiwat,263,18733,808908,400179,408729,945,945,0,51,22,19/1/2022 7:23
16/9/2021,Nan,3,2319,475915,238017,237898,21353,21281,72,,,19/1/2022 7:23
16/9/2021,Bueng Kan,8,1741,421910,211455,210455,2662,2662,0,,,19/1/2022 7:23
16/9/2021,Buri Ram,85,14823,1579547,783516,796031,22217,22141,76,,,19/1/2022 7:23
16/9/2021,Pathum Thani,139,36518,1186767,562265,624502,10969,10893,76,57,33,19/1/2022 7:23
16/9/2021,Prachuap Khiri Khan,70,9933,553460,274610,278850,78909,78814,95,,,19/1/2022 7:23
16/9/2021,Prachin Buri,360,12333,494821,244371,250450,7010,7010,0,46,36,19/1/2022 7:23
16/9/2021,Pattani,189,18325,728989,360071,368918,1410,1410,0,,,19/1/2022 7:23
16/9/2021,Phra Nakhon Si Ayutthaya,80,25715,820211,393877,426334,63382,63260,122,33,40,19/1/2022 7:23
16/9/2021,Phayao,13,1703,465194,226350,238844,12520,12407,113,34,12,19/1/2022 7:23
16/9/2021,Phang-nga,64,1763,268130,133856,134274,11169,9671,1498,,,19/1/2022 7:23
16/9/2021,Phatthalung,58,3437,522511,254483,268028,1958,1958,0,,,19/1/2022 7:23
16/9/2021,Phichit,63,3841,530097,258414,271683,7058,7058,0,,,19/1/2022 7:23
16/9/2021,Phitsanulok,36,4199,847460,414773,432687,33623,33466,157,,,19/1/2022 7:23
16/9/2021,Phuket,246,8045,419217,198181,221036,85481,60028,25453,56,26,19/1/2022 7:23
16/9/2021,Maha Sarakham,38,9183,949461,465434,484027,4086,4086,0,,,19/1/2022 7:23
16/9/2021,Mukdahan,4,1990,351274,175455,175819,17246,17246,0,,,19/1/2022 7:23
16/9/2021,Yala,378,16279,541791,269774,272017,710,710,0,36,26,19/1/2022 7:23
16/9/2021,Yasothon,26,4870,533435,266108,267327,3724,3724,0,,,19/1/2022 7:23
16/9/2021,Ranong,113,7910,194674,98251,96423,2582,2582,0,,,19/1/2022 7:23
16/9/2021,Rayong,445,25951,749481,368005,381476,24688,24442,246,27,25,19/1/2022 7:23
16/9/2021,Ratchaburi,389,24878,868959,422400,446559,30897,30897,0,,,19/1/2022 7:23
16/9/2021,Roi Et,48,12539,1296274,642169,654105,3672,3672,0,,,19/1/2022 7:23
16/9/2021,Lop Buri,131,12943,740199,368985,371214,24082,24044,38,,,19/1/2022 7:23
16/9/2021,Lampang,4,2120,725923,353601,372322,9312,9210,102,46,14,19/1/2022 7:23
16/9/2021,Lamphun,20,1648,401450,192935,208515,8920,8828,92,,,19/1/2022 7:23
16/9/2021,Si Sa Ket,66,14074,1456968,725147,731821,15417,15417,0,,,19/1/2022 7:23
16/9/2021,Sakon Nakhon,30,6811,1146233,569519,576714,10521,10521,0,,,19/1/2022 7:23
16/9/2021,Songkhla,470,25750,1431271,697260,734011,1827,1827,0,70,38,19/1/2022 7:23
16/9/2021,Satun,17,1755,324578,161454,163124,1995,1995,0,64,32,19/1/2022 7:23
16/9/2021,Samut Prakarn,1455,100317,1355935,645831,710104,12413,12329,84,,,19/1/2022 7:23
16/9/2021,Samut Songkhram,96,9434,191160,91278,99882,31388,31388,0,22,16,19/1/2022 7:23
16/9/2021,Samut Sakhon,339,102384,585760,282297,303463,7943,7943,0,47,45,19/1/2022 7:23
16/9/2021,Saraburi,279,23626,644131,316501,327630,30780,30737,43,68,63,19/1/2022 7:23
16/9/2021,Sa kaeo,141,11313,561572,280341,281231,4108,4108,0,15,15,19/1/2022 7:23
16/9/2021,Sing Buri,30,2407,204996,97383,107613,9410,9410,0,,,19/1/2022 7:23
16/9/2021,Suphan Buri,83,11658,835999,403285,432714,30584,30584,0,,,19/1/2022 7:23
16/9/2021,Surat Thani,194,9508,1072025,527245,544780,4772,3619,1153,69,30,19/1/2022 7:23
16/9/2021,Surin,44,14354,1376610,684728,691882,9296,9269,27,,,19/1/2022 7:23
16/9/2021,Sukhothai,38,5184,585695,283594,302101,6514,6514,0,,,19/1/2022 7:23
16/9/2021,Nong Khai,12,2935,516903,256356,260547,11497,11490,7,35,15,19/1/2022 7:23
16/9/2021,Nong Bua Lam Phu,9,3628,508929,253795,255134,1880,1880,0,,,19/1/2022 7:23
16/9/2021,Amnat Charoen,6,2660,376291,187148,189143,2964,2964,0,,,19/1/2022 7:23
16/9/2021,Udon Thani,162,13843,1566740,775793,790947,11621,11611,10,,,19/1/2022 7:23
16/9/2021,Uttaradit,44,3578,446754,217769,228985,7108,7108,0,,,19/1/2022 7:23
16/9/2021,Uthai Thani,8,3198,325202,158940,166262,2630,2630,0,,,19/1/2022 7:23
16/9/2021,Ubon Ratchathani,91,15722,1867421,932017,935404,25612,25612,0,43,25,19/1/2022 7:23
16/9/2021,Ang Thong,63,9644,275337,131732,143605,5978,5978,0,,,19/1/2022 7:23
16/9/2021,Chiang Rai,19,3372,1297567,630638,666929,52280,52001,279,19,11,19/1/2022 7:23
16/9/2021,Chiang Mai,92,11875,1787951,863847,924104,149552,148477,1075,46,19,19/1/2022 7:23
16/9/2021,Phetchaburi,145,16801,482635,232935,249700,88893,88804,89,,,19/1/2022 7:23
16/9/2021,Phetchabun,110,8706,978763,482612,496151,26514,26475,39,,,19/1/2022 7:23
16/9/2021,Loei,12,2769,638822,320038,318784,13785,13770,15,18,11,19/1/2022 7:23
16/9/2021,Phrae,8,1482,435288,209765,225523,11993,11993,0,31,13,19/1/2022 7:23
16/9/2021,Mae Hong Son,10,527,285937,144838,141099,11764,11539,225,30,3,19/1/2022 7:23
16/9/2021,,0,153,,,,,,,,,19/1/2022 7:23
17/9/2021,Krabi,110,2704,478854,237878,240976,4086,3912,174,,,19/1/2022 7:23
17/9/2021,Bangkok,2934,366016,5538629,2598539,2940090,448391,422787,25604,44,31,19/1/2022 7:23
17/9/2021,Kanchanaburi,183,15535,894044,448524,445520,190781,190728,53,27,16,19/1/2022 7:23
17/9/2021,Kalasin,25,7413,976025,482401,493624,4757,4757,0,,,19/1/2022 7:23
17/9/2021,Kamphaeng Phet,25,6705,712444,351736,360708,7679,7679,0,,,19/1/2022 7:23
17/9/2021,Khon Kaen,100,12523,1791794,880418,911376,36884,36884,0,,,19/1/2022 7:23
17/9/2021,Chanthaburi,142,8600,536411,262228,274183,24937,24842,95,,,19/1/2022 7:23
17/9/2021,Chachoengsao,168,30001,723178,354451,368727,7480,7480,0,28,30,19/1/2022 7:23
17/9/2021,Chon Buri,936,80386,1581618,771595,810023,119870,119059,811,45,32,19/1/2022 7:23
17/9/2021,Chai Nat,21,2206,320948,154287,166661,11052,11052,0,,,19/1/2022 7:23
17/9/2021,Chaiyaphum,615,9541,1122539,554554,567985,16842,16813,29,,,19/1/2022 7:23
17/9/2021,Chumphon,188,6782,509344,251379,257965,2620,2620,0,,,19/1/2022 7:23
17/9/2021,Trang,45,4880,639876,312767,327109,5191,5191,0,,,19/1/2022 7:23
17/9/2021,Trat,135,3820,228450,112952,115498,33159,33006,153,,,19/1/2022 7:23
17/9/2021,Tak,199,13731,675112,341344,333768,18741,18741,0,,,19/1/2022 7:23
17/9/2021,Nakhon Nayok,32,9091,260238,128796,131442,6150,6150,0,,,19/1/2022 7:23
17/9/2021,Nakhon Pathom,128,31073,921861,442674,479187,17076,17058,18,41,34,19/1/2022 7:23
17/9/2021,Nakhon Phanom,8,4721,717043,357140,359903,9839,9839,0,,,19/1/2022 7:23
17/9/2021,Nakhon Ratchasima,200,22190,2634005,1293977,1340028,158830,157909,921,46,20,19/1/2022 7:23
17/9/2021,Nakhon Si Thammarat,355,11487,1549321,764443,784878,9361,9361,0,,,19/1/2022 7:23
17/9/2021,Nakhon Sawan,132,9766,1036053,505240,530813,18756,18756,0,52,41,19/1/2022 7:23
17/9/2021,Nonthaburi,328,58868,1285994,598164,687830,13326,13275,51,23,76,19/1/2022 7:23
17/9/2021,Narathiwat,275,19008,808908,400179,408729,945,945,0,49,19,19/1/2022 7:23
17/9/2021,Nan,6,2325,475915,238017,237898,21353,21281,72,,,19/1/2022 7:23
17/9/2021,Bueng Kan,8,1749,421910,211455,210455,2662,2662,0,,,19/1/2022 7:23
17/9/2021,Buri Ram,89,14912,1579547,783516,796031,22217,22141,76,,,19/1/2022 7:23
17/9/2021,Pathum Thani,177,36695,1186767,562265,624502,10969,10893,76,60,37,19/1/2022 7:23
17/9/2021,Prachuap Khiri Khan,111,10044,553460,274610,278850,78909,78814,95,,,19/1/2022 7:23
17/9/2021,Prachin Buri,367,12700,494821,244371,250450,7010,7010,0,64,34,19/1/2022 7:23
17/9/2021,Pattani,175,18500,728989,360071,368918,1410,1410,0,,,19/1/2022 7:23
17/9/2021,Phra Nakhon Si Ayutthaya,112,25827,820211,393877,426334,63382,63260,122,44,44,19/1/2022 7:23
17/9/2021,Phayao,4,1707,465194,226350,238844,12520,12407,113,23,14,19/1/2022 7:23
17/9/2021,Phang-nga,95,1858,268130,133856,134274,11169,9671,1498,,,19/1/2022 7:23
17/9/2021,Phatthalung,47,3484,522511,254483,268028,1958,1958,0,,,19/1/2022 7:23
17/9/2021,Phichit,53,3894,530097,258414,271683,7058,7058,0,,,19/1/2022 7:23
17/9/2021,Phitsanulok,36,4235,847460,414773,432687,33623,33466,157,,,19/1/2022 7:23
17/9/2021,Phuket,238,8283,419217,198181,221036,85481,60028,25453,55,26,19/1/2022 7:23
17/9/2021,Maha Sarakham,37,9220,949461,465434,484027,4086,4086,0,,,19/1/2022 7:23
17/9/2021,Mukdahan,4,1994,351274,175455,175819,17246,17246,0,,,19/1/2022 7:23
17/9/2021,Yala,444,16723,541791,269774,272017,710,710,0,50,24,19/1/2022 7:23
17/9/2021,Yasothon,38,4908,533435,266108,267327,3724,3724,0,,,19/1/2022 7:23
17/9/2021,Ranong,75,7985,194674,98251,96423,2582,2582,0,,,19/1/2022 7:23
17/9/2021,Rayong,702,26653,749481,368005,381476,24688,24442,246,35,31,19/1/2022 7:23
17/9/2021,Ratchaburi,501,25379,868959,422400,446559,30897,30897,0,,,19/1/2022 7:23
17/9/2021,Roi Et,46,12585,1296274,642169,654105,3672,3672,0,,,19/1/2022 7:23
17/9/2021,Lop Buri,122,13065,740199,368985,371214,24082,24044,38,,,19/1/2022 7:23
17/9/2021,Lampang,5,2125,725923,353601,372322,9312,9210,102,40,16,19/1/2022 7:23
17/9/2021,Lamphun,9,1657,401450,192935,208515,8920,8828,92,,,19/1/2022 7:23
17/9/2021,Si Sa Ket,134,14208,1456968,725147,731821,15417,15417,0,,,19/1/2022 7:23
17/9/2021,Sakon Nakhon,34,6845,1146233,569519,576714,10521,10521,0,,,19/1/2022 7:23
17/9/2021,Songkhla,314,26064,1431271,697260,734011,1827,1827,0,75,37,19/1/2022 7:23
17/9/2021,Satun,20,1775,324578,161454,163124,1995,1995,0,52,32,19/1/2022 7:23
17/9/2021,Samut Prakarn,1122,101439,1355935,645831,710104,12413,12329,84,,,19/1/2022 7:23
17/9/2021,Samut Songkhram,73,9507,191160,91278,99882,31388,31388,0,28,12,19/1/2022 7:23
17/9/2021,Samut Sakhon,387,102771,585760,282297,303463,7943,7943,0,61,37,19/1/2022 7:23
17/9/2021,Saraburi,329,23955,644131,316501,327630,30780,30737,43,66,93,19/1/2022 7:23
17/9/2021,Sa kaeo,150,11463,561572,280341,281231,4108,4108,0,22,15,19/1/2022 7:23
17/9/2021,Sing Buri,23,2430,204996,97383,107613,9410,9410,0,,,19/1/2022 7:23
17/9/2021,Suphan Buri,68,11726,835999,403285,432714,30584,30584,0,,,19/1/2022 7:23
17/9/2021,Surat Thani,177,9685,1072025,527245,544780,4772,3619,1153,88,32,19/1/2022 7:23
17/9/2021,Surin,56,14410,1376610,684728,691882,9296,9269,27,,,19/1/2022 7:23
17/9/2021,Sukhothai,53,5237,585695,283594,302101,6514,6514,0,,,19/1/2022 7:23
17/9/2021,Nong Khai,58,2993,516903,256356,260547,11497,11490,7,35,15,19/1/2022 7:23
17/9/2021,Nong Bua Lam Phu,13,3641,508929,253795,255134,1880,1880,0,,,19/1/2022 7:23
17/9/2021,Amnat Charoen,8,2668,376291,187148,189143,2964,2964,0,,,19/1/2022 7:23
17/9/2021,Udon Thani,135,13978,1566740,775793,790947,11621,11611,10,,,19/1/2022 7:23
17/9/2021,Uttaradit,50,3628,446754,217769,228985,7108,7108,0,,,19/1/2022 7:23
17/9/2021,Uthai Thani,11,3209,325202,158940,166262,2630,2630,0,,,19/1/2022 7:23
17/9/2021,Ubon Ratchathani,76,15798,1867421,932017,935404,25612,25612,0,52,25,19/1/2022 7:23
17/9/2021,Ang Thong,72,9716,275337,131732,143605,5978,5978,0,,,19/1/2022 7:23
17/9/2021,Chiang Rai,14,3386,1297567,630638,666929,52280,52001,279,23,11,19/1/2022 7:23
17/9/2021,Chiang Mai,126,12001,1787951,863847,924104,149552,148477,1075,45,22,19/1/2022 7:23
17/9/2021,Phetchaburi,135,16936,482635,232935,249700,88893,88804,89,,,19/1/2022 7:23
17/9/2021,Phetchabun,104,8810,978763,482612,496151,26514,26475,39,,,19/1/2022 7:23
17/9/2021,Loei,8,2777,638822,320038,318784,13785,13770,15,18,12,19/1/2022 7:23
17/9/2021,Phrae,10,1492,435288,209765,225523,11993,11993,0,30,22,19/1/2022 7:23
17/9/2021,Mae Hong Son,10,537,285937,144838,141099,11764,11539,225,13,4,19/1/2022 7:23
17/9/2021,,0,153,,,,,,,,,19/1/2022 7:23
18/9/2021,Krabi,135,2839,478854,237878,240976,4086,3912,174,,,19/1/2022 7:23
18/9/2021,Bangkok,2848,368864,5538629,2598539,2940090,448391,422787,25604,59,25,19/1/2022 7:23
18/9/2021,Kanchanaburi,163,15698,894044,448524,445520,190781,190728,53,36,9,19/1/2022 7:23
18/9/2021,Kalasin,20,7433,976025,482401,493624,4757,4757,0,,,19/1/2022 7:23
18/9/2021,Kamphaeng Phet,24,6729,712444,351736,360708,7679,7679,0,,,19/1/2022 7:23
18/9/2021,Khon Kaen,150,12673,1791794,880418,911376,36884,36884,0,,,19/1/2022 7:23
18/9/2021,Chanthaburi,161,8761,536411,262228,274183,24937,24842,95,,,19/1/2022 7:23
18/9/2021,Chachoengsao,224,30225,723178,354451,368727,7480,7480,0,52,34,19/1/2022 7:23
18/9/2021,Chon Buri,849,81235,1581618,771595,810023,119870,119059,811,55,28,19/1/2022 7:23
18/9/2021,Chai Nat,7,2213,320948,154287,166661,11052,11052,0,,,19/1/2022 7:23
18/9/2021,Chaiyaphum,332,9873,1122539,554554,567985,16842,16813,29,,,19/1/2022 7:23
18/9/2021,Chumphon,187,6969,509344,251379,257965,2620,2620,0,,,19/1/2022 7:23
18/9/2021,Trang,31,4911,639876,312767,327109,5191,5191,0,,,19/1/2022 7:23
18/9/2021,Trat,95,3915,228450,112952,115498,33159,33006,153,,,19/1/2022 7:23
18/9/2021,Tak,163,13894,675112,341344,333768,18741,18741,0,,,19/1/2022 7:23
18/9/2021,Nakhon Nayok,79,9170,260238,128796,131442,6150,6150,0,,,19/1/2022 7:23
18/9/2021,Nakhon Pathom,146,31219,921861,442674,479187,17076,17058,18,71,18,19/1/2022 7:23
18/9/2021,Nakhon Phanom,9,4730,717043,357140,359903,9839,9839,0,,,19/1/2022 7:23
18/9/2021,Nakhon Ratchasima,343,22533,2634005,1293977,1340028,158830,157909,921,46,33,19/1/2022 7:23
18/9/2021,Nakhon Si Thammarat,270,11757,1549321,764443,784878,9361,9361,0,,,19/1/2022 7:23
18/9/2021,Nakhon Sawan,104,9870,1036053,505240,530813,18756,18756,0,79,26,19/1/2022 7:23
18/9/2021,Nonthaburi,405,59273,1285994,598164,687830,13326,13275,51,52,63,19/1/2022 7:23
18/9/2021,Narathiwat,484,19492,808908,400179,408729,945,945,0,41,17,19/1/2022 7:23
18/9/2021,Nan,0,2325,475915,238017,237898,21353,21281,72,,,19/1/2022 7:23
18/9/2021,Bueng Kan,2,1751,421910,211455,210455,2662,2662,0,,,19/1/2022 7:23
18/9/2021,Buri Ram,87,14999,1579547,783516,796031,22217,22141,76,,,19/1/2022 7:23
18/9/2021,Pathum Thani,138,36833,1186767,562265,624502,10969,10893,76,68,35,19/1/2022 7:23
18/9/2021,Prachuap Khiri Khan,54,10098,553460,274610,278850,78909,78814,95,,,19/1/2022 7:23
18/9/2021,Prachin Buri,385,13085,494821,244371,250450,7010,7010,0,62,38,19/1/2022 7:23
18/9/2021,Pattani,183,18683,728989,360071,368918,1410,1410,0,,,19/1/2022 7:23
18/9/2021,Phra Nakhon Si Ayutthaya,106,25933,820211,393877,426334,63382,63260,122,55,45,19/1/2022 7:23
18/9/2021,Phayao,1,1708,465194,226350,238844,12520,12407,113,31,21,19/1/2022 7:23
18/9/2021,Phang-nga,27,1885,268130,133856,134274,11169,9671,1498,,,19/1/2022 7:23
18/9/2021,Phatthalung,60,3544,522511,254483,268028,1958,1958,0,,,19/1/2022 7:23
18/9/2021,Phichit,30,3924,530097,258414,271683,7058,7058,0,,,19/1/2022 7:23
18/9/2021,Phitsanulok,50,4285,847460,414773,432687,33623,33466,157,,,19/1/2022 7:23
18/9/2021,Phuket,235,8518,419217,198181,221036,85481,60028,25453,58,19,19/1/2022 7:23
18/9/2021,Maha Sarakham,23,9243,949461,465434,484027,4086,4086,0,,,19/1/2022 7:23
18/9/2021,Mukdahan,3,1997,351274,175455,175819,17246,17246,0,,,19/1/2022 7:23
18/9/2021,Yala,477,17200,541791,269774,272017,710,710,0,49,18,19/1/2022 7:23
18/9/2021,Yasothon,25,4933,533435,266108,267327,3724,3724,0,,,19/1/2022 7:23
18/9/2021,Ranong,142,8127,194674,98251,96423,2582,2582,0,,,19/1/2022 7:23
18/9/2021,Rayong,414,27067,749481,368005,381476,24688,24442,246,47,26,19/1/2022 7:23
18/9/2021,Ratchaburi,378,25757,868959,422400,446559,30897,30897,0,,,19/1/2022 7:23
18/9/2021,Roi Et,39,12624,1296274,642169,654105,3672,3672,0,,,19/1/2022 7:23
18/9/2021,Lop Buri,129,13194,740199,368985,371214,24082,24044,38,,,19/1/2022 7:23
18/9/2021,Lampang,4,2129,725923,353601,372322,9312,9210,102,49,15,19/1/2022 7:23
18/9/2021,Lamphun,48,1705,401450,192935,208515,8920,8828,92,,,19/1/2022 7:23
18/9/2021,Si Sa Ket,82,14290,1456968,725147,731821,15417,15417,0,,,19/1/2022 7:23
18/9/2021,Sakon Nakhon,54,6899,1146233,569519,576714,10521,10521,0,,,19/1/2022 7:23
18/9/2021,Songkhla,370,26434,1431271,697260,734011,1827,1827,0,72,28,19/1/2022 7:23
18/9/2021,Satun,10,1785,324578,161454,163124,1995,1995,0,60,21,19/1/2022 7:23
18/9/2021,Samut Prakarn,1021,102460,1355935,645831,710104,12413,12329,84,,,19/1/2022 7:23
18/9/2021,Samut Songkhram,97,9604,191160,91278,99882,31388,31388,0,28,10,19/1/2022 7:23
18/9/2021,Samut Sakhon,288,103059,585760,282297,303463,7943,7943,0,58,28,19/1/2022 7:23
18/9/2021,Saraburi,289,24244,644131,316501,327630,30780,30737,43,86,78,19/1/2022 7:23
18/9/2021,Sa kaeo,175,11638,561572,280341,281231,4108,4108,0,23,14,19/1/2022 7:23
18/9/2021,Sing Buri,20,2450,204996,97383,107613,9410,9410,0,,,19/1/2022 7:23
18/9/2021,Suphan Buri,83,11809,835999,403285,432714,30584,30584,0,,,19/1/2022 7:23
18/9/2021,Surat Thani,165,9850,1072025,527245,544780,4772,3619,1153,85,26,19/1/2022 7:23
18/9/2021,Surin,63,14473,1376610,684728,691882,9296,9269,27,,,19/1/2022 7:23
18/9/2021,Sukhothai,34,5271,585695,283594,302101,6514,6514,0,,,19/1/2022 7:23
18/9/2021,Nong Khai,29,3022,516903,256356,260547,11497,11490,7,36,16,19/1/2022 7:23
18/9/2021,Nong Bua Lam Phu,15,3656,508929,253795,255134,1880,1880,0,,,19/1/2022 7:23
18/9/2021,Amnat Charoen,16,2684,376291,187148,189143,2964,2964,0,,,19/1/2022 7:23
18/9/2021,Udon Thani,618,14596,1566740,775793,790947,11621,11611,10,,,19/1/2022 7:23
18/9/2021,Uttaradit,21,3649,446754,217769,228985,7108,7108,0,,,19/1/2022 7:23
18/9/2021,Uthai Thani,8,3217,325202,158940,166262,2630,2630,0,,,19/1/2022 7:23
18/9/2021,Ubon Ratchathani,61,15859,1867421,932017,935404,25612,25612,0,50,19,19/1/2022 7:23
18/9/2021,Ang Thong,63,9779,275337,131732,143605,5978,5978,0,,,19/1/2022 7:23
18/9/2021,Chiang Rai,17,3403,1297567,630638,666929,52280,52001,279,22,11,19/1/2022 7:23
18/9/2021,Chiang Mai,42,12043,1787951,863847,924104,149552,148477,1075,48,25,19/1/2022 7:23
18/9/2021,Phetchaburi,102,17038,482635,232935,249700,88893,88804,89,,,19/1/2022 7:23
18/9/2021,Phetchabun,74,8884,978763,482612,496151,26514,26475,39,,,19/1/2022 7:23
18/9/2021,Loei,8,2785,638822,320038,318784,13785,13770,15,25,12,19/1/2022 7:23
18/9/2021,Phrae,10,1502,435288,209765,225523,11993,11993,0,45,23,19/1/2022 7:23
18/9/2021,Mae Hong Son,5,542,285937,144838,141099,11764,11539,225,18,6,19/1/2022 7:23
18/9/2021,,0,153,,,,,,,,,19/1/2022 7:23
19/9/2021,Krabi,96,2935,478854,237878,240976,4086,3912,174,,,19/1/2022 7:23
19/9/2021,Bangkok,2902,371766,5538629,2598539,2940090,448391,422787,25604,52,27,19/1/2022 7:23
19/9/2021,Kanchanaburi,231,15929,894044,448524,445520,190781,190728,53,24,11,19/1/2022 7:23
19/9/2021,Kalasin,23,7456,976025,482401,493624,4757,4757,0,,,19/1/2022 7:23
19/9/2021,Kamphaeng Phet,15,6744,712444,351736,360708,7679,7679,0,,,19/1/2022 7:23
19/9/2021,Khon Kaen,148,12821,1791794,880418,911376,36884,36884,0,,,19/1/2022 7:23
19/9/2021,Chanthaburi,269,9030,536411,262228,274183,24937,24842,95,,,19/1/2022 7:23
19/9/2021,Chachoengsao,195,30420,723178,354451,368727,7480,7480,0,77,35,19/1/2022 7:23
19/9/2021,Chon Buri,926,82161,1581618,771595,810023,119870,119059,811,50,26,19/1/2022 7:23
19/9/2021,Chai Nat,2,2215,320948,154287,166661,11052,11052,0,,,19/1/2022 7:23
19/9/2021,Chaiyaphum,51,9924,1122539,554554,567985,16842,16813,29,,,19/1/2022 7:23
19/9/2021,Chumphon,172,7141,509344,251379,257965,2620,2620,0,,,19/1/2022 7:23
19/9/2021,Trang,63,4974,639876,312767,327109,5191,5191,0,,,19/1/2022 7:23
19/9/2021,Trat,94,4009,228450,112952,115498,33159,33006,153,,,19/1/2022 7:23
19/9/2021,Tak,134,14028,675112,341344,333768,18741,18741,0,,,19/1/2022 7:23
19/9/2021,Nakhon Nayok,49,9219,260238,128796,131442,6150,6150,0,,,19/1/2022 7:23
19/9/2021,Nakhon Pathom,129,31348,921861,442674,479187,17076,17058,18,42,21,19/1/2022 7:23
19/9/2021,Nakhon Phanom,5,4735,717043,357140,359903,9839,9839,0,,,19/1/2022 7:23
19/9/2021,Nakhon Ratchasima,200,22733,2634005,1293977,1340028,158830,157909,921,72,29,19/1/2022 7:23
19/9/2021,Nakhon Si Thammarat,349,12106,1549321,764443,784878,9361,9361,0,,,19/1/2022 7:23
19/9/2021,Nakhon Sawan,173,10043,1036053,505240,530813,18756,18756,0,51,30,19/1/2022 7:23
19/9/2021,Nonthaburi,218,59491,1285994,598164,687830,13326,13275,51,41,10,19/1/2022 7:23
19/9/2021,Narathiwat,356,19848,808908,400179,408729,945,945,0,39,14,19/1/2022 7:23
19/9/2021,Nan,12,2337,475915,238017,237898,21353,21281,72,,,19/1/2022 7:23
19/9/2021,Bueng Kan,3,1754,421910,211455,210455,2662,2662,0,,,19/1/2022 7:23
19/9/2021,Buri Ram,73,15072,1579547,783516,796031,22217,22141,76,,,19/1/2022 7:23
19/9/2021,Pathum Thani,152,36985,1186767,562265,624502,10969,10893,76,73,32,19/1/2022 7:23
19/9/2021,Prachuap Khiri Khan,102,10200,553460,274610,278850,78909,78814,95,,,19/1/2022 7:23
19/9/2021,Prachin Buri,292,13377,494821,244371,250450,7010,7010,0,70,38,19/1/2022 7:23
19/9/2021,Pattani,177,18860,728989,360071,368918,1410,1410,0,,,19/1/2022 7:23
19/9/2021,Phra Nakhon Si Ayutthaya,131,26064,820211,393877,426334,63382,63260,122,64,38,19/1/2022 7:23
19/9/2021,Phayao,2,1710,465194,226350,238844,12520,12407,113,46,16,19/1/2022 7:23
19/9/2021,Phang-nga,56,1941,268130,133856,134274,11169,9671,1498,,,19/1/2022 7:23
19/9/2021,Phatthalung,82,3626,522511,254483,268028,1958,1958,0,,,19/1/2022 7:23
19/9/2021,Phichit,35,3959,530097,258414,271683,7058,7058,0,,,19/1/2022 7:23
19/9/2021,Phitsanulok,45,4330,847460,414773,432687,33623,33466,157,,,19/1/2022 7:23
19/9/2021,Phuket,240,8758,419217,198181,221036,85481,60028,25453,46,18,19/1/2022 7:23
19/9/2021,Maha Sarakham,15,9258,949461,465434,484027,4086,4086,0,,,19/1/2022 7:23
19/9/2021,Mukdahan,3,2000,351274,175455,175819,17246,17246,0,,,19/1/2022 7:23
19/9/2021,Yala,492,17692,541791,269774,272017,710,710,0,39,17,19/1/2022 7:23
19/9/2021,Yasothon,211,5144,533435,266108,267327,3724,3724,0,,,19/1/2022 7:23
19/9/2021,Ranong,77,8204,194674,98251,96423,2582,2582,0,,,19/1/2022 7:23
19/9/2021,Rayong,366,27433,749481,368005,381476,24688,24442,246,49,27,19/1/2022 7:23
19/9/2021,Ratchaburi,485,26242,868959,422400,446559,30897,30897,0,,,19/1/2022 7:23
19/9/2021,Roi Et,45,12669,1296274,642169,654105,3672,3672,0,,,19/1/2022 7:23
19/9/2021,Lop Buri,126,13320,740199,368985,371214,24082,24044,38,,,19/1/2022 7:23
19/9/2021,Lampang,3,2132,725923,353601,372322,9312,9210,102,46,16,19/1/2022 7:23
19/9/2021,Lamphun,26,1731,401450,192935,208515,8920,8828,92,,,19/1/2022 7:23
19/9/2021,Si Sa Ket,47,14337,1456968,725147,731821,15417,15417,0,,,19/1/2022 7:23
19/9/2021,Sakon Nakhon,18,6917,1146233,569519,576714,10521,10521,0,,,19/1/2022 7:23
19/9/2021,Songkhla,445,26879,1431271,697260,734011,1827,1827,0,58,23,19/1/2022 7:23
19/9/2021,Satun,29,1814,324578,161454,163124,1995,1995,0,43,26,19/1/2022 7:23
19/9/2021,Samut Prakarn,1030,103490,1355935,645831,710104,12413,12329,84,,,19/1/2022 7:23
19/9/2021,Samut Songkhram,70,9674,191160,91278,99882,31388,31388,0,20,10,19/1/2022 7:23
19/9/2021,Samut Sakhon,304,103363,585760,282297,303463,7943,7943,0,48,36,19/1/2022 7:23
19/9/2021,Saraburi,196,24440,644131,316501,327630,30780,30737,43,82,74,19/1/2022 7:23
19/9/2021,Sa kaeo,108,11746,561572,280341,281231,4108,4108,0,28,16,19/1/2022 7:23
19/9/2021,Sing Buri,28,2478,204996,97383,107613,9410,9410,0,,,19/1/2022 7:23
19/9/2021,Suphan Buri,93,11902,835999,403285,432714,30584,30584,0,,,19/1/2022 7:23
19/9/2021,Surat Thani,164,10014,1072025,527245,544780,4772,3619,1153,75,24,19/1/2022 7:23
19/9/2021,Surin,60,14533,1376610,684728,691882,9296,9269,27,,,19/1/2022 7:23
19/9/2021,Sukhothai,27,5298,585695,283594,302101,6514,6514,0,,,19/1/2022 7:23
19/9/2021,Nong Khai,15,3037,516903,256356,260547,11497,11490,7,38,16,19/1/2022 7:23
19/9/2021,Nong Bua Lam Phu,3,3659,508929,253795,255134,1880,1880,0,,,19/1/2022 7:23
19/9/2021,Amnat Charoen,9,2693,376291,187148,189143,2964,2964,0,,,19/1/2022 7:23
19/9/2021,Udon Thani,215,14811,1566740,775793,790947,11621,11611,10,,,19/1/2022 7:23
19/9/2021,Uttaradit,34,3683,446754,217769,228985,7108,7108,0,,,19/1/2022 7:23
19/9/2021,Uthai Thani,5,3222,325202,158940,166262,2630,2630,0,,,19/1/2022 7:23
19/9/2021,Ubon Ratchathani,102,15961,1867421,932017,935404,25612,25612,0,46,12,19/1/2022 7:23
19/9/2021,Ang Thong,228,10007,275337,131732,143605,5978,5978,0,,,19/1/2022 7:23
19/9/2021,Chiang Rai,26,3429,1297567,630638,666929,52280,52001,279,26,12,19/1/2022 7:23
19/9/2021,Chiang Mai,44,12087,1787951,863847,924104,149552,148477,1075,54,24,19/1/2022 7:23
19/9/2021,Phetchaburi,124,17162,482635,232935,249700,88893,88804,89,,,19/1/2022 7:23
19/9/2021,Phetchabun,72,8956,978763,482612,496151,26514,26475,39,,,19/1/2022 7:23
19/9/2021,Loei,11,2796,638822,320038,318784,13785,13770,15,19,13,19/1/2022 7:23
19/9/2021,Phrae,9,1511,435288,209765,225523,11993,11993,0,49,20,19/1/2022 7:23
19/9/2021,Mae Hong Son,9,551,285937,144838,141099,11764,11539,225,24,6,19/1/2022 7:23
19/9/2021,,0,153,,,,,,,,,19/1/2022 7:23
20/9/2021,Krabi,143,3078,478854,237878,240976,4086,3912,174,,,19/1/2022 7:23
20/9/2021,Bangkok,2838,374604,5538629,2598539,2940090,448391,422787,25604,54,16,19/1/2022 7:23
20/9/2021,Kanchanaburi,213,16142,894044,448524,445520,190781,190728,53,28,5,19/1/2022 7:23
20/9/2021,Kalasin,9,7465,976025,482401,493624,4757,4757,0,,,19/1/2022 7:23
20/9/2021,Kamphaeng Phet,24,6768,712444,351736,360708,7679,7679,0,,,19/1/2022 7:23
20/9/2021,Khon Kaen,148,12969,1791794,880418,911376,36884,36884,0,,,19/1/2022 7:23
20/9/2021,Chanthaburi,153,9183,536411,262228,274183,24937,24842,95,,,19/1/2022 7:23
20/9/2021,Chachoengsao,143,30563,723178,354451,368727,7480,7480,0,74,26,19/1/2022 7:23
20/9/2021,Chon Buri,535,82696,1581618,771595,810023,119870,119059,811,50,25,19/1/2022 7:23
20/9/2021,Chai Nat,5,2220,320948,154287,166661,11052,11052,0,,,19/1/2022 7:23
20/9/2021,Chaiyaphum,99,10023,1122539,554554,567985,16842,16813,29,,,19/1/2022 7:23
20/9/2021,Chumphon,173,7314,509344,251379,257965,2620,2620,0,,,19/1/2022 7:23
20/9/2021,Trang,51,5025,639876,312767,327109,5191,5191,0,,,19/1/2022 7:23
20/9/2021,Trat,31,4040,228450,112952,115498,33159,33006,153,,,19/1/2022 7:23
20/9/2021,Tak,153,14181,675112,341344,333768,18741,18741,0,,,19/1/2022 7:23
20/9/2021,Nakhon Nayok,23,9242,260238,128796,131442,6150,6150,0,,,19/1/2022 7:23
20/9/2021,Nakhon Pathom,159,31507,921861,442674,479187,17076,17058,18,58,7,19/1/2022 7:23
20/9/2021,Nakhon Phanom,5,4740,717043,357140,359903,9839,9839,0,,,19/1/2022 7:23
20/9/2021,Nakhon Ratchasima,217,22950,2634005,1293977,1340028,158830,157909,921,62,20,19/1/2022 7:23
20/9/2021,Nakhon Si Thammarat,438,12544,1549321,764443,784878,9361,9361,0,,,19/1/2022 7:23
20/9/2021,Nakhon Sawan,95,10138,1036053,505240,530813,18756,18756,0,59,14,19/1/2022 7:23
20/9/2021,Nonthaburi,329,59820,1285994,598164,687830,13326,13275,51,38,6,19/1/2022 7:23
20/9/2021,Narathiwat,315,20163,808908,400179,408729,945,945,0,33,15,19/1/2022 7:23
20/9/2021,Nan,2,2339,475915,238017,237898,21353,21281,72,,,19/1/2022 7:23
20/9/2021,Bueng Kan,0,1754,421910,211455,210455,2662,2662,0,,,19/1/2022 7:23
20/9/2021,Buri Ram,30,15102,1579547,783516,796031,22217,22141,76,,,19/1/2022 7:23
20/9/2021,Pathum Thani,137,37122,1186767,562265,624502,10969,10893,76,62,20,19/1/2022 7:23
20/9/2021,Prachuap Khiri Khan,37,10237,553460,274610,278850,78909,78814,95,,,19/1/2022 7:23
20/9/2021,Prachin Buri,175,13552,494821,244371,250450,7010,7010,0,74,26,19/1/2022 7:23
20/9/2021,Pattani,312,19172,728989,360071,368918,1410,1410,0,,,19/1/2022 7:23
20/9/2021,Phra Nakhon Si Ayutthaya,91,26155,820211,393877,426334,63382,63260,122,44,31,19/1/2022 7:23
20/9/2021,Phayao,1,1711,465194,226350,238844,12520,12407,113,38,17,19/1/2022 7:23
20/9/2021,Phang-nga,16,1957,268130,133856,134274,11169,9671,1498,,,19/1/2022 7:23
20/9/2021,Phatthalung,75,3701,522511,254483,268028,1958,1958,0,,,19/1/2022 7:23
20/9/2021,Phichit,40,3999,530097,258414,271683,7058,7058,0,,,19/1/2022 7:23
20/9/2021,Phitsanulok,21,4351,847460,414773,432687,33623,33466,157,,,19/1/2022 7:23
20/9/2021,Phuket,230,8988,419217,198181,221036,85481,60028,25453,47,22,19/1/2022 7:23
20/9/2021,Maha Sarakham,25,9283,949461,465434,484027,4086,4086,0,,,19/1/2022 7:23
20/9/2021,Mukdahan,3,2003,351274,175455,175819,17246,17246,0,,,19/1/2022 7:23
20/9/2021,Yala,440,18132,541791,269774,272017,710,710,0,40,17,19/1/2022 7:23
20/9/2021,Yasothon,316,5460,533435,266108,267327,3724,3724,0,,,19/1/2022 7:23
20/9/2021,Ranong,68,8272,194674,98251,96423,2582,2582,0,,,19/1/2022 7:23
20/9/2021,Rayong,451,27884,749481,368005,381476,24688,24442,246,52,13,19/1/2022 7:23
20/9/2021,Ratchaburi,424,26666,868959,422400,446559,30897,30897,0,,,19/1/2022 7:23
20/9/2021,Roi Et,19,12688,1296274,642169,654105,3672,3672,0,,,19/1/2022 7:23
20/9/2021,Lop Buri,130,13450,740199,368985,371214,24082,24044,38,,,19/1/2022 7:23
20/9/2021,Lampang,19,2151,725923,353601,372322,9312,9210,102,52,14,19/1/2022 7:23
20/9/2021,Lamphun,37,1768,401450,192935,208515,8920,8828,92,,,19/1/2022 7:23
20/9/2021,Si Sa Ket,59,14396,1456968,725147,731821,15417,15417,0,,,19/1/2022 7:23
20/9/2021,Sakon Nakhon,18,6935,1146233,569519,576714,10521,10521,0,,,19/1/2022 7:23
20/9/2021,Songkhla,334,27213,1431271,697260,734011,1827,1827,0,39,28,19/1/2022 7:23
20/9/2021,Satun,46,1860,324578,161454,163124,1995,1995,0,52,20,19/1/2022 7:23
20/9/2021,Samut Prakarn,943,104433,1355935,645831,710104,12413,12329,84,,,19/1/2022 7:23
20/9/2021,Samut Songkhram,46,9720,191160,91278,99882,31388,31388,0,19,6,19/1/2022 7:23
20/9/2021,Samut Sakhon,325,103688,585760,282297,303463,7943,7943,0,58,26,19/1/2022 7:23
20/9/2021,Saraburi,222,24662,644131,316501,327630,30780,30737,43,77,55,19/1/2022 7:23
20/9/2021,Sa kaeo,170,11916,561572,280341,281231,4108,4108,0,38,14,19/1/2022 7:23
20/9/2021,Sing Buri,12,2490,204996,97383,107613,9410,9410,0,,,19/1/2022 7:23
20/9/2021,Suphan Buri,82,11984,835999,403285,432714,30584,30584,0,,,19/1/2022 7:23
20/9/2021,Surat Thani,96,10110,1072025,527245,544780,4772,3619,1153,67,24,19/1/2022 7:23
20/9/2021,Surin,42,14575,1376610,684728,691882,9296,9269,27,,,19/1/2022 7:23
20/9/2021,Sukhothai,22,5320,585695,283594,302101,6514,6514,0,,,19/1/2022 7:23
20/9/2021,Nong Khai,10,3047,516903,256356,260547,11497,11490,7,37,15,19/1/2022 7:23
20/9/2021,Nong Bua Lam Phu,28,3687,508929,253795,255134,1880,1880,0,,,19/1/2022 7:23
20/9/2021,Amnat Charoen,12,2705,376291,187148,189143,2964,2964,0,,,19/1/2022 7:23
20/9/2021,Udon Thani,448,15259,1566740,775793,790947,11621,11611,10,,,19/1/2022 7:23
20/9/2021,Uttaradit,18,3701,446754,217769,228985,7108,7108,0,,,19/1/2022 7:23
20/9/2021,Uthai Thani,6,3228,325202,158940,166262,2630,2630,0,,,19/1/2022 7:23
20/9/2021,Ubon Ratchathani,74,16035,1867421,932017,935404,25612,25612,0,25,16,19/1/2022 7:23
20/9/2021,Ang Thong,44,10051,275337,131732,143605,5978,5978,0,,,19/1/2022 7:23
20/9/2021,Chiang Rai,16,3445,1297567,630638,666929,52280,52001,279,25,11,19/1/2022 7:23
20/9/2021,Chiang Mai,48,12135,1787951,863847,924104,149552,148477,1075,51,25,19/1/2022 7:23
20/9/2021,Phetchaburi,131,17293,482635,232935,249700,88893,88804,89,,,19/1/2022 7:23
20/9/2021,Phetchabun,29,8985,978763,482612,496151,26514,26475,39,,,19/1/2022 7:23
20/9/2021,Loei,11,2807,638822,320038,318784,13785,13770,15,25,11,19/1/2022 7:23
20/9/2021,Phrae,5,1516,435288,209765,225523,11993,11993,0,46,16,19/1/2022 7:23
20/9/2021,Mae Hong Son,14,565,285937,144838,141099,11764,11539,225,25,9,19/1/2022 7:23
20/9/2021,,0,153,,,,,,,,,19/1/2022 7:23
21/9/2021,Krabi,40,3118,478854,237878,240976,4086,3912,174,,,19/1/2022 7:23
21/9/2021,Bangkok,2561,377165,5538629,2598539,2940090,448391,422787,25604,33,9,19/1/2022 7:23
21/9/2021,Kanchanaburi,105,16247,894044,448524,445520,190781,190728,53,14,8,19/1/2022 7:23
21/9/2021,Kalasin,12,7477,976025,482401,493624,4757,4757,0,,,19/1/2022 7:23
21/9/2021,Kamphaeng Phet,28,6796,712444,351736,360708,7679,7679,0,,,19/1/2022 7:23
21/9/2021,Khon Kaen,186,13155,1791794,880418,911376,36884,36884,0,,,19/1/2022 7:23
21/9/2021,Chanthaburi,160,9343,536411,262228,274183,24937,24842,95,,,19/1/2022 7:23
21/9/2021,Chachoengsao,99,30662,723178,354451,368727,7480,7480,0,47,26,19/1/2022 7:23
21/9/2021,Chon Buri,629,83325,1581618,771595,810023,119870,119059,811,47,28,19/1/2022 7:23
21/9/2021,Chai Nat,6,2226,320948,154287,166661,11052,11052,0,,,19/1/2022 7:23
21/9/2021,Chaiyaphum,66,10089,1122539,554554,567985,16842,16813,29,,,19/1/2022 7:23
21/9/2021,Chumphon,134,7448,509344,251379,257965,2620,2620,0,,,19/1/2022 7:23
21/9/2021,Trang,81,5106,639876,312767,327109,5191,5191,0,,,19/1/2022 7:23
21/9/2021,Trat,89,4129,228450,112952,115498,33159,33006,153,,,19/1/2022 7:23
21/9/2021,Tak,132,14313,675112,341344,333768,18741,18741,0,,,19/1/2022 7:23
21/9/2021,Nakhon Nayok,6,9248,260238,128796,131442,6150,6150,0,,,19/1/2022 7:23
21/9/2021,Nakhon Pathom,112,31619,921861,442674,479187,17076,17058,18,21,13,19/1/2022 7:23
21/9/2021,Nakhon Phanom,3,4743,717043,357140,359903,9839,9839,0,,,19/1/2022 7:23
21/9/2021,Nakhon Ratchasima,193,23143,2634005,1293977,1340028,158830,157909,921,50,17,19/1/2022 7:23
21/9/2021,Nakhon Si Thammarat,217,12761,1549321,764443,784878,9361,9361,0,,,19/1/2022 7:23
21/9/2021,Nakhon Sawan,101,10239,1036053,505240,530813,18756,18756,0,28,20,19/1/2022 7:23
21/9/2021,Nonthaburi,280,60100,1285994,598164,687830,13326,13275,51,28,5,19/1/2022 7:23
21/9/2021,Narathiwat,383,20546,808908,400179,408729,945,945,0,33,17,19/1/2022 7:23
21/9/2021,Nan,0,2339,475915,238017,237898,21353,21281,72,,,19/1/2022 7:23
21/9/2021,Bueng Kan,3,1757,421910,211455,210455,2662,2662,0,,,19/1/2022 7:23
21/9/2021,Buri Ram,52,15154,1579547,783516,796031,22217,22141,76,,,19/1/2022 7:23
21/9/2021,Pathum Thani,136,37258,1186767,562265,624502,10969,10893,76,44,28,19/1/2022 7:23
21/9/2021,Prachuap Khiri Khan,49,10286,553460,274610,278850,78909,78814,95,,,19/1/2022 7:23
21/9/2021,Prachin Buri,215,13767,494821,244371,250450,7010,7010,0,48,23,19/1/2022 7:23
21/9/2021,Pattani,197,19369,728989,360071,368918,1410,1410,0,,,19/1/2022 7:23
21/9/2021,Phra Nakhon Si Ayutthaya,90,26245,820211,393877,426334,63382,63260,122,32,30,19/1/2022 7:23
21/9/2021,Phayao,2,1713,465194,226350,238844,12520,12407,113,37,11,19/1/2022 7:23
21/9/2021,Phang-nga,46,2003,268130,133856,134274,11169,9671,1498,,,19/1/2022 7:23
21/9/2021,Phatthalung,73,3774,522511,254483,268028,1958,1958,0,,,19/1/2022 7:23
21/9/2021,Phichit,17,4016,530097,258414,271683,7058,7058,0,,,19/1/2022 7:23
21/9/2021,Phitsanulok,33,4384,847460,414773,432687,33623,33466,157,,,19/1/2022 7:23
21/9/2021,Phuket,238,9226,419217,198181,221036,85481,60028,25453,47,26,19/1/2022 7:23
21/9/2021,Maha Sarakham,10,9293,949461,465434,484027,4086,4086,0,,,19/1/2022 7:23
21/9/2021,Mukdahan,6,2009,351274,175455,175819,17246,17246,0,,,19/1/2022 7:23
21/9/2021,Yala,284,18416,541791,269774,272017,710,710,0,33,19,19/1/2022 7:23
21/9/2021,Yasothon,4,5464,533435,266108,267327,3724,3724,0,,,19/1/2022 7:23
21/9/2021,Ranong,63,8335,194674,98251,96423,2582,2582,0,,,19/1/2022 7:23
21/9/2021,Rayong,272,28156,749481,368005,381476,24688,24442,246,24,20,19/1/2022 7:23
21/9/2021,Ratchaburi,361,27027,868959,422400,446559,30897,30897,0,,,19/1/2022 7:23
21/9/2021,Roi Et,19,12707,1296274,642169,654105,3672,3672,0,,,19/1/2022 7:23
21/9/2021,Lop Buri,129,13579,740199,368985,371214,24082,24044,38,,,19/1/2022 7:23
21/9/2021,Lampang,7,2158,725923,353601,372322,9312,9210,102,44,14,19/1/2022 7:23
21/9/2021,Lamphun,39,1807,401450,192935,208515,8920,8828,92,,,19/1/2022 7:23
21/9/2021,Si Sa Ket,61,14457,1456968,725147,731821,15417,15417,0,,,19/1/2022 7:23
21/9/2021,Sakon Nakhon,30,6965,1146233,569519,576714,10521,10521,0,,,19/1/2022 7:23
21/9/2021,Songkhla,267,27480,1431271,697260,734011,1827,1827,0,54,29,19/1/2022 7:23
21/9/2021,Satun,38,1898,324578,161454,163124,1995,1995,0,44,33,19/1/2022 7:23
21/9/2021,Samut Prakarn,858,105291,1355935,645831,710104,12413,12329,84,,,19/1/2022 7:23
21/9/2021,Samut Songkhram,74,9794,191160,91278,99882,31388,31388,0,13,8,19/1/2022 7:23
21/9/2021,Samut Sakhon,237,103925,585760,282297,303463,7943,7943,0,50,21,19/1/2022 7:23
21/9/2021,Saraburi,178,24840,644131,316501,327630,30780,30737,43,53,60,19/1/2022 7:23
21/9/2021,Sa kaeo,53,11969,561572,280341,281231,4108,4108,0,23,11,19/1/2022 7:23
21/9/2021,Sing Buri,11,2501,204996,97383,107613,9410,9410,0,,,19/1/2022 7:23
21/9/2021,Suphan Buri,47,12031,835999,403285,432714,30584,30584,0,,,19/1/2022 7:23
21/9/2021,Surat Thani,131,10241,1072025,527245,544780,4772,3619,1153,73,24,19/1/2022 7:23
21/9/2021,Surin,64,14639,1376610,684728,691882,9296,9269,27,,,19/1/2022 7:23
21/9/2021,Sukhothai,16,5336,585695,283594,302101,6514,6514,0,,,19/1/2022 7:23
21/9/2021,Nong Khai,22,3069,516903,256356,260547,11497,11490,7,35,15,19/1/2022 7:23
21/9/2021,Nong Bua Lam Phu,8,3695,508929,253795,255134,1880,1880,0,,,19/1/2022 7:23
21/9/2021,Amnat Charoen,4,2709,376291,187148,189143,2964,2964,0,,,19/1/2022 7:23
21/9/2021,Udon Thani,499,15758,1566740,775793,790947,11621,11611,10,,,19/1/2022 7:23
21/9/2021,Uttaradit,16,3717,446754,217769,228985,7108,7108,0,,,19/1/2022 7:23
21/9/2021,Uthai Thani,3,3231,325202,158940,166262,2630,2630,0,,,19/1/2022 7:23
21/9/2021,Ubon Ratchathani,43,16078,1867421,932017,935404,25612,25612,0,32,16,19/1/2022 7:23
21/9/2021,Ang Thong,33,10084,275337,131732,143605,5978,5978,0,,,19/1/2022 7:23
21/9/2021,Chiang Rai,22,3467,1297567,630638,666929,52280,52001,279,24,9,19/1/2022 7:23
21/9/2021,Chiang Mai,76,12211,1787951,863847,924104,149552,148477,1075,53,19,19/1/2022 7:23
21/9/2021,Phetchaburi,82,17375,482635,232935,249700,88893,88804,89,,,19/1/2022 7:23
21/9/2021,Phetchabun,14,8999,978763,482612,496151,26514,26475,39,,,19/1/2022 7:23
21/9/2021,Loei,37,2844,638822,320038,318784,13785,13770,15,20,8,19/1/2022 7:23
21/9/2021,Phrae,10,1526,435288,209765,225523,11993,11993,0,30,13,19/1/2022 7:23
21/9/2021,Mae Hong Son,17,582,285937,144838,141099,11764,11539,225,35,4,19/1/2022 7:23
21/9/2021,,0,153,,,,,,,,,19/1/2022 7:23
22/9/2021,Krabi,91,3209,478854,237878,240976,4086,3912,174,,,19/1/2022 7:23
22/9/2021,Bangkok,2467,379632,5538629,2598539,2940090,448391,422787,25604,23,10,19/1/2022 7:23
22/9/2021,Kanchanaburi,87,16334,894044,448524,445520,190781,190728,53,22,9,19/1/2022 7:23
22/9/2021,Kalasin,32,7509,976025,482401,493624,4757,4757,0,,,19/1/2022 7:23
22/9/2021,Kamphaeng Phet,26,6822,712444,351736,360708,7679,7679,0,,,19/1/2022 7:23
22/9/2021,Khon Kaen,152,13307,1791794,880418,911376,36884,36884,0,,,19/1/2022 7:23
22/9/2021,Chanthaburi,242,9585,536411,262228,274183,24937,24842,95,,,19/1/2022 7:23
22/9/2021,Chachoengsao,147,30809,723178,354451,368727,7480,7480,0,37,28,19/1/2022 7:23
22/9/2021,Chon Buri,715,84040,1581618,771595,810023,119870,119059,811,41,32,19/1/2022 7:23
22/9/2021,Chai Nat,15,2241,320948,154287,166661,11052,11052,0,,,19/1/2022 7:23
22/9/2021,Chaiyaphum,21,10110,1122539,554554,567985,16842,16813,29,,,19/1/2022 7:23
22/9/2021,Chumphon,135,7583,509344,251379,257965,2620,2620,0,,,19/1/2022 7:23
22/9/2021,Trang,32,5138,639876,312767,327109,5191,5191,0,,,19/1/2022 7:23
22/9/2021,Trat,40,4169,228450,112952,115498,33159,33006,153,,,19/1/2022 7:23
22/9/2021,Tak,207,14520,675112,341344,333768,18741,18741,0,,,19/1/2022 7:23
22/9/2021,Nakhon Nayok,106,9354,260238,128796,131442,6150,6150,0,,,19/1/2022 7:23
22/9/2021,Nakhon Pathom,73,31692,921861,442674,479187,17076,17058,18,34,12,19/1/2022 7:23
22/9/2021,Nakhon Phanom,0,4743,717043,357140,359903,9839,9839,0,,,19/1/2022 7:23
22/9/2021,Nakhon Ratchasima,263,23406,2634005,1293977,1340028,158830,157909,921,40,21,19/1/2022 7:23
22/9/2021,Nakhon Si Thammarat,170,12931,1549321,764443,784878,9361,9361,0,,,19/1/2022 7:23
22/9/2021,Nakhon Sawan,140,10379,1036053,505240,530813,18756,18756,0,42,21,19/1/2022 7:23
22/9/2021,Nonthaburi,123,60223,1285994,598164,687830,13326,13275,51,20,8,19/1/2022 7:23
22/9/2021,Narathiwat,362,20908,808908,400179,408729,945,945,0,36,20,19/1/2022 7:23
22/9/2021,Nan,4,2343,475915,238017,237898,21353,21281,72,,,19/1/2022 7:23
22/9/2021,Bueng Kan,3,1760,421910,211455,210455,2662,2662,0,,,19/1/2022 7:23
22/9/2021,Buri Ram,61,15215,1579547,783516,796031,22217,22141,76,,,19/1/2022 7:23
22/9/2021,Pathum Thani,76,37334,1186767,562265,624502,10969,10893,76,59,31,19/1/2022 7:23
22/9/2021,Prachuap Khiri Khan,37,10323,553460,274610,278850,78909,78814,95,,,19/1/2022 7:23
22/9/2021,Prachin Buri,271,14038,494821,244371,250450,7010,7010,0,41,30,19/1/2022 7:23
22/9/2021,Pattani,257,19626,728989,360071,368918,1410,1410,0,,,19/1/2022 7:23
22/9/2021,Phra Nakhon Si Ayutthaya,122,26367,820211,393877,426334,63382,63260,122,29,31,19/1/2022 7:23
22/9/2021,Phayao,1,1714,465194,226350,238844,12520,12407,113,24,12,19/1/2022 7:23
22/9/2021,Phang-nga,90,2093,268130,133856,134274,11169,9671,1498,,,19/1/2022 7:23
22/9/2021,Phatthalung,42,3816,522511,254483,268028,1958,1958,0,,,19/1/2022 7:23
22/9/2021,Phichit,25,4041,530097,258414,271683,7058,7058,0,,,19/1/2022 7:23
22/9/2021,Phitsanulok,55,4439,847460,414773,432687,33623,33466,157,,,19/1/2022 7:23
22/9/2021,Phuket,256,9482,419217,198181,221036,85481,60028,25453,52,29,19/1/2022 7:23
22/9/2021,Maha Sarakham,36,9329,949461,465434,484027,4086,4086,0,,,19/1/2022 7:23
22/9/2021,Mukdahan,2,2011,351274,175455,175819,17246,17246,0,,,19/1/2022 7:23
22/9/2021,Yala,242,18658,541791,269774,272017,710,710,0,35,22,19/1/2022 7:23
22/9/2021,Yasothon,2,5466,533435,266108,267327,3724,3724,0,,,19/1/2022 7:23
22/9/2021,Ranong,61,8396,194674,98251,96423,2582,2582,0,,,19/1/2022 7:23
22/9/2021,Rayong,423,28579,749481,368005,381476,24688,24442,246,26,20,19/1/2022 7:23
22/9/2021,Ratchaburi,456,27483,868959,422400,446559,30897,30897,0,,,19/1/2022 7:23
22/9/2021,Roi Et,32,12739,1296274,642169,654105,3672,3672,0,,,19/1/2022 7:23
22/9/2021,Lop Buri,73,13652,740199,368985,371214,24082,24044,38,,,19/1/2022 7:23
22/9/2021,Lampang,3,2161,725923,353601,372322,9312,9210,102,43,14,19/1/2022 7:23
22/9/2021,Lamphun,55,1862,401450,192935,208515,8920,8828,92,,,19/1/2022 7:23
22/9/2021,Si Sa Ket,104,14561,1456968,725147,731821,15417,15417,0,,,19/1/2022 7:23
22/9/2021,Sakon Nakhon,23,6988,1146233,569519,576714,10521,10521,0,,,19/1/2022 7:23
22/9/2021,Songkhla,453,27933,1431271,697260,734011,1827,1827,0,52,37,19/1/2022 7:23
22/9/2021,Satun,24,1922,324578,161454,163124,1995,1995,0,53,30,19/1/2022 7:23
22/9/2021,Samut Prakarn,910,106201,1355935,645831,710104,12413,12329,84,,,19/1/2022 7:23
22/9/2021,Samut Songkhram,46,9840,191160,91278,99882,31388,31388,0,13,5,19/1/2022 7:23
22/9/2021,Samut Sakhon,222,104147,585760,282297,303463,7943,7943,0,37,30,19/1/2022 7:23
22/9/2021,Saraburi,188,25028,644131,316501,327630,30780,30737,43,56,49,19/1/2022 7:23
22/9/2021,Sa kaeo,95,12064,561572,280341,281231,4108,4108,0,16,14,19/1/2022 7:23
22/9/2021,Sing Buri,13,2514,204996,97383,107613,9410,9410,0,,,19/1/2022 7:23
22/9/2021,Suphan Buri,55,12086,835999,403285,432714,30584,30584,0,,,19/1/2022 7:23
22/9/2021,Surat Thani,225,10466,1072025,527245,544780,4772,3619,1153,48,28,19/1/2022 7:23
22/9/2021,Surin,52,14691,1376610,684728,691882,9296,9269,27,,,19/1/2022 7:23
22/9/2021,Sukhothai,23,5359,585695,283594,302101,6514,6514,0,,,19/1/2022 7:23
22/9/2021,Nong Khai,11,3080,516903,256356,260547,11497,11490,7,37,16,19/1/2022 7:23
22/9/2021,Nong Bua Lam Phu,8,3703,508929,253795,255134,1880,1880,0,,,19/1/2022 7:23
22/9/2021,Amnat Charoen,12,2721,376291,187148,189143,2964,2964,0,,,19/1/2022 7:23
22/9/2021,Udon Thani,94,15852,1566740,775793,790947,11621,11611,10,,,19/1/2022 7:23
22/9/2021,Uttaradit,30,3747,446754,217769,228985,7108,7108,0,,,19/1/2022 7:23
22/9/2021,Uthai Thani,16,3247,325202,158940,166262,2630,2630,0,,,19/1/2022 7:23
22/9/2021,Ubon Ratchathani,43,16121,1867421,932017,935404,25612,25612,0,32,16,19/1/2022 7:23
22/9/2021,Ang Thong,22,10106,275337,131732,143605,5978,5978,0,,,19/1/2022 7:23
22/9/2021,Chiang Rai,26,3493,1297567,630638,666929,52280,52001,279,20,9,19/1/2022 7:23
22/9/2021,Chiang Mai,25,12236,1787951,863847,924104,149552,148477,1075,44,20,19/1/2022 7:23
22/9/2021,Phetchaburi,127,17502,482635,232935,249700,88893,88804,89,,,19/1/2022 7:23
22/9/2021,Phetchabun,31,9030,978763,482612,496151,26514,26475,39,,,19/1/2022 7:23
22/9/2021,Loei,31,2875,638822,320038,318784,13785,13770,15,18,9,19/1/2022 7:23
22/9/2021,Phrae,3,1529,435288,209765,225523,11993,11993,0,32,15,19/1/2022 7:23
22/9/2021,Mae Hong Son,9,591,285937,144838,141099,11764,11539,225,19,4,19/1/2022 7:23
22/9/2021,,0,153,,,,,,,,,19/1/2022 7:23
23/9/2021,Krabi,119,3328,478854,237878,240976,4086,3912,174,,,19/1/2022 7:23
23/9/2021,Bangkok,2460,382092,5538629,2598539,2940090,448391,422787,25604,18,12,19/1/2022 7:23
23/9/2021,Kanchanaburi,113,16447,894044,448524,445520,190781,190728,53,21,11,19/1/2022 7:23
23/9/2021,Kalasin,18,7527,976025,482401,493624,4757,4757,0,,,19/1/2022 7:23
23/9/2021,Kamphaeng Phet,25,6847,712444,351736,360708,7679,7679,0,,,19/1/2022 7:23
23/9/2021,Khon Kaen,160,13467,1791794,880418,911376,36884,36884,0,,,19/1/2022 7:23
23/9/2021,Chanthaburi,280,9865,536411,262228,274183,24937,24842,95,,,19/1/2022 7:23
23/9/2021,Chachoengsao,177,30986,723178,354451,368727,7480,7480,0,34,27,19/1/2022 7:23
23/9/2021,Chon Buri,743,84783,1581618,771595,810023,119870,119059,811,46,25,19/1/2022 7:23
23/9/2021,Chai Nat,11,2252,320948,154287,166661,11052,11052,0,,,19/1/2022 7:23
23/9/2021,Chaiyaphum,48,10158,1122539,554554,567985,16842,16813,29,,,19/1/2022 7:23
23/9/2021,Chumphon,170,7753,509344,251379,257965,2620,2620,0,,,19/1/2022 7:23
23/9/2021,Trang,44,5182,639876,312767,327109,5191,5191,0,,,19/1/2022 7:23
23/9/2021,Trat,133,4302,228450,112952,115498,33159,33006,153,,,19/1/2022 7:23
23/9/2021,Tak,148,14668,675112,341344,333768,18741,18741,0,,,19/1/2022 7:23
23/9/2021,Nakhon Nayok,62,9416,260238,128796,131442,6150,6150,0,,,19/1/2022 7:23
23/9/2021,Nakhon Pathom,127,31819,921861,442674,479187,17076,17058,18,34,15,19/1/2022 7:23
23/9/2021,Nakhon Phanom,6,4749,717043,357140,359903,9839,9839,0,,,19/1/2022 7:23
23/9/2021,Nakhon Ratchasima,221,23627,2634005,1293977,1340028,158830,157909,921,43,23,19/1/2022 7:23
23/9/2021,Nakhon Si Thammarat,418,13349,1549321,764443,784878,9361,9361,0,,,19/1/2022 7:23
23/9/2021,Nakhon Sawan,117,10496,1036053,505240,530813,18756,18756,0,39,14,19/1/2022 7:23
23/9/2021,Nonthaburi,140,60363,1285994,598164,687830,13326,13275,51,33,7,19/1/2022 7:23
23/9/2021,Narathiwat,419,21327,808908,400179,408729,945,945,0,43,26,19/1/2022 7:23
23/9/2021,Nan,7,2350,475915,238017,237898,21353,21281,72,,,19/1/2022 7:23
23/9/2021,Bueng Kan,5,1765,421910,211455,210455,2662,2662,0,,,19/1/2022 7:23
23/9/2021,Buri Ram,75,15290,1579547,783516,796031,22217,22141,76,,,19/1/2022 7:23
23/9/2021,Pathum Thani,111,37445,1186767,562265,624502,10969,10893,76,62,16,19/1/2022 7:23
23/9/2021,Prachuap Khiri Khan,151,10474,553460,274610,278850,78909,78814,95,,,19/1/2022 7:23
23/9/2021,Prachin Buri,232,14270,494821,244371,250450,7010,7010,0,55,32,19/1/2022 7:23
23/9/2021,Pattani,233,19859,728989,360071,368918,1410,1410,0,,,19/1/2022 7:23
23/9/2021,Phra Nakhon Si Ayutthaya,158,26525,820211,393877,426334,63382,63260,122,29,27,19/1/2022 7:23
23/9/2021,Phayao,0,1714,465194,226350,238844,12520,12407,113,25,15,19/1/2022 7:23
23/9/2021,Phang-nga,44,2137,268130,133856,134274,11169,9671,1498,,,19/1/2022 7:23
23/9/2021,Phatthalung,29,3845,522511,254483,268028,1958,1958,0,,,19/1/2022 7:23
23/9/2021,Phichit,32,4073,530097,258414,271683,7058,7058,0,,,19/1/2022 7:23
23/9/2021,Phitsanulok,57,4496,847460,414773,432687,33623,33466,157,,,19/1/2022 7:23
23/9/2021,Phuket,240,9722,419217,198181,221036,85481,60028,25453,58,27,19/1/2022 7:23
23/9/2021,Maha Sarakham,39,9368,949461,465434,484027,4086,4086,0,,,19/1/2022 7:23
23/9/2021,Mukdahan,5,2016,351274,175455,175819,17246,17246,0,,,19/1/2022 7:23
23/9/2021,Yala,669,19327,541791,269774,272017,710,710,0,43,29,19/1/2022 7:23
23/9/2021,Yasothon,14,5480,533435,266108,267327,3724,3724,0,,,19/1/2022 7:23
23/9/2021,Ranong,82,8478,194674,98251,96423,2582,2582,0,,,19/1/2022 7:23
23/9/2021,Rayong,549,29128,749481,368005,381476,24688,24442,246,30,21,19/1/2022 7:23
23/9/2021,Ratchaburi,323,27806,868959,422400,446559,30897,30897,0,,,19/1/2022 7:23
23/9/2021,Roi Et,21,12760,1296274,642169,654105,3672,3672,0,,,19/1/2022 7:23
23/9/2021,Lop Buri,125,13777,740199,368985,371214,24082,24044,38,,,19/1/2022 7:23
23/9/2021,Lampang,4,2165,725923,353601,372322,9312,9210,102,42,16,19/1/2022 7:23
23/9/2021,Lamphun,67,1929,401450,192935,208515,8920,8828,92,,,19/1/2022 7:23
23/9/2021,Si Sa Ket,49,14610,1456968,725147,731821,15417,15417,0,,,19/1/2022 7:23
23/9/2021,Sakon Nakhon,24,7012,1146233,569519,576714,10521,10521,0,,,19/1/2022 7:23
23/9/2021,Songkhla,388,28321,1431271,697260,734011,1827,1827,0,68,39,19/1/2022 7:23
23/9/2021,Satun,20,1942,324578,161454,163124,1995,1995,0,49,36,19/1/2022 7:23
23/9/2021,Samut Prakarn,995,107196,1355935,645831,710104,12413,12329,84,,,19/1/2022 7:23
23/9/2021,Samut Songkhram,52,9892,191160,91278,99882,31388,31388,0,9,5,19/1/2022 7:23
23/9/2021,Samut Sakhon,350,104497,585760,282297,303463,7943,7943,0,55,28,19/1/2022 7:23
23/9/2021,Saraburi,257,25285,644131,316501,327630,30780,30737,43,47,45,19/1/2022 7:23
23/9/2021,Sa kaeo,508,12572,561572,280341,281231,4108,4108,0,24,15,19/1/2022 7:23
23/9/2021,Sing Buri,13,2527,204996,97383,107613,9410,9410,0,,,19/1/2022 7:23
23/9/2021,Suphan Buri,65,12151,835999,403285,432714,30584,30584,0,,,19/1/2022 7:23
23/9/2021,Surat Thani,241,10707,1072025,527245,544780,4772,3619,1153,74,30,19/1/2022 7:23
23/9/2021,Surin,49,14740,1376610,684728,691882,9296,9269,27,,,19/1/2022 7:23
23/9/2021,Sukhothai,27,5386,585695,283594,302101,6514,6514,0,,,19/1/2022 7:23
23/9/2021,Nong Khai,26,3106,516903,256356,260547,11497,11490,7,39,12,19/1/2022 7:23
23/9/2021,Nong Bua Lam Phu,3,3706,508929,253795,255134,1880,1880,0,,,19/1/2022 7:23
23/9/2021,Amnat Charoen,5,2726,376291,187148,189143,2964,2964,0,,,19/1/2022 7:23
23/9/2021,Udon Thani,183,16035,1566740,775793,790947,11621,11611,10,,,19/1/2022 7:23
23/9/2021,Uttaradit,25,3772,446754,217769,228985,7108,7108,0,,,19/1/2022 7:23
23/9/2021,Uthai Thani,8,3255,325202,158940,166262,2630,2630,0,,,19/1/2022 7:23
23/9/2021,Ubon Ratchathani,73,16194,1867421,932017,935404,25612,25612,0,28,10,19/1/2022 7:23
23/9/2021,Ang Thong,34,10140,275337,131732,143605,5978,5978,0,,,19/1/2022 7:23
23/9/2021,Chiang Rai,36,3529,1297567,630638,666929,52280,52001,279,19,12,19/1/2022 7:23
23/9/2021,Chiang Mai,123,12359,1787951,863847,924104,149552,148477,1075,45,22,19/1/2022 7:23
23/9/2021,Phetchaburi,177,17679,482635,232935,249700,88893,88804,89,,,19/1/2022 7:23
23/9/2021,Phetchabun,64,9094,978763,482612,496151,26514,26475,39,,,19/1/2022 7:23
23/9/2021,Loei,18,2893,638822,320038,318784,13785,13770,15,14,12,19/1/2022 7:23
23/9/2021,Phrae,2,1531,435288,209765,225523,11993,11993,0,30,17,19/1/2022 7:23
23/9/2021,Mae Hong Son,10,601,285937,144838,141099,11764,11539,225,19,4,19/1/2022 7:23
23/9/2021,,0,153,,,,,,,,,19/1/2022 7:23
24/9/2021,Krabi,99,3427,478854,237878,240976,4086,3912,174,,,19/1/2022 7:23
24/9/2021,Bangkok,2245,384337,5538629,2598539,2940090,448391,422787,25604,30,11,19/1/2022 7:23
24/9/2021,Kanchanaburi,204,16651,894044,448524,445520,190781,190728,53,24,11,19/1/2022 7:23
24/9/2021,Kalasin,21,7548,976025,482401,493624,4757,4757,0,,,19/1/2022 7:23
24/9/2021,Kamphaeng Phet,24,6871,712444,351736,360708,7679,7679,0,,,19/1/2022 7:23
24/9/2021,Khon Kaen,165,13632,1791794,880418,911376,36884,36884,0,,,19/1/2022 7:23
24/9/2021,Chanthaburi,183,10048,536411,262228,274183,24937,24842,95,,,19/1/2022 7:23
24/9/2021,Chachoengsao,162,31148,723178,354451,368727,7480,7480,0,41,28,19/1/2022 7:23
24/9/2021,Chon Buri,898,85681,1581618,771595,810023,119870,119059,811,39,23,19/1/2022 7:23
24/9/2021,Chai Nat,9,2261,320948,154287,166661,11052,11052,0,,,19/1/2022 7:23
24/9/2021,Chaiyaphum,91,10249,1122539,554554,567985,16842,16813,29,,,19/1/2022 7:23
24/9/2021,Chumphon,201,7954,509344,251379,257965,2620,2620,0,,,19/1/2022 7:23
24/9/2021,Trang,80,5262,639876,312767,327109,5191,5191,0,,,19/1/2022 7:23
24/9/2021,Trat,132,4434,228450,112952,115498,33159,33006,153,,,19/1/2022 7:23
24/9/2021,Tak,294,14962,675112,341344,333768,18741,18741,0,,,19/1/2022 7:23
24/9/2021,Nakhon Nayok,42,9458,260238,128796,131442,6150,6150,0,,,19/1/2022 7:23
24/9/2021,Nakhon Pathom,70,31889,921861,442674,479187,17076,17058,18,40,13,19/1/2022 7:23
24/9/2021,Nakhon Phanom,3,4752,717043,357140,359903,9839,9839,0,,,19/1/2022 7:23
24/9/2021,Nakhon Ratchasima,272,23899,2634005,1293977,1340028,158830,157909,921,48,12,19/1/2022 7:23
24/9/2021,Nakhon Si Thammarat,245,13594,1549321,764443,784878,9361,9361,0,,,19/1/2022 7:23
24/9/2021,Nakhon Sawan,121,10617,1036053,505240,530813,18756,18756,0,21,9,19/1/2022 7:23
24/9/2021,Nonthaburi,217,60580,1285994,598164,687830,13326,13275,51,28,7,19/1/2022 7:23
24/9/2021,Narathiwat,440,21767,808908,400179,408729,945,945,0,56,27,19/1/2022 7:23
24/9/2021,Nan,5,2355,475915,238017,237898,21353,21281,72,,,19/1/2022 7:23
24/9/2021,Bueng Kan,4,1769,421910,211455,210455,2662,2662,0,,,19/1/2022 7:23
24/9/2021,Buri Ram,67,15357,1579547,783516,796031,22217,22141,76,,,19/1/2022 7:23
24/9/2021,Pathum Thani,176,37621,1186767,562265,624502,10969,10893,76,32,19,19/1/2022 7:23
24/9/2021,Prachuap Khiri Khan,55,10529,553460,274610,278850,78909,78814,95,,,19/1/2022 7:23
24/9/2021,Prachin Buri,232,14502,494821,244371,250450,7010,7010,0,56,28,19/1/2022 7:23
24/9/2021,Pattani,250,20109,728989,360071,368918,1410,1410,0,,,19/1/2022 7:23
24/9/2021,Phra Nakhon Si Ayutthaya,158,26683,820211,393877,426334,63382,63260,122,22,26,19/1/2022 7:23
24/9/2021,Phayao,0,1714,465194,226350,238844,12520,12407,113,30,16,19/1/2022 7:23
24/9/2021,Phang-nga,39,2176,268130,133856,134274,11169,9671,1498,,,19/1/2022 7:23
24/9/2021,Phatthalung,89,3934,522511,254483,268028,1958,1958,0,,,19/1/2022 7:23
24/9/2021,Phichit,13,4086,530097,258414,271683,7058,7058,0,,,19/1/2022 7:23
24/9/2021,Phitsanulok,57,4553,847460,414773,432687,33623,33466,157,,,19/1/2022 7:23
24/9/2021,Phuket,228,9950,419217,198181,221036,85481,60028,25453,59,22,19/1/2022 7:23
24/9/2021,Maha Sarakham,34,9402,949461,465434,484027,4086,4086,0,,,19/1/2022 7:23
24/9/2021,Mukdahan,3,2019,351274,175455,175819,17246,17246,0,,,19/1/2022 7:23
24/9/2021,Yala,675,20002,541791,269774,272017,710,710,0,60,33,19/1/2022 7:23
24/9/2021,Yasothon,1,5481,533435,266108,267327,3724,3724,0,,,19/1/2022 7:23
24/9/2021,Ranong,85,8563,194674,98251,96423,2582,2582,0,,,19/1/2022 7:23
24/9/2021,Rayong,556,29684,749481,368005,381476,24688,24442,246,29,19,19/1/2022 7:23
24/9/2021,Ratchaburi,365,28171,868959,422400,446559,30897,30897,0,,,19/1/2022 7:23
24/9/2021,Roi Et,17,12777,1296274,642169,654105,3672,3672,0,,,19/1/2022 7:23
24/9/2021,Lop Buri,130,13907,740199,368985,371214,24082,24044,38,,,19/1/2022 7:23
24/9/2021,Lampang,0,2165,725923,353601,372322,9312,9210,102,48,14,19/1/2022 7:23
24/9/2021,Lamphun,58,1987,401450,192935,208515,8920,8828,92,,,19/1/2022 7:23
24/9/2021,Si Sa Ket,75,14685,1456968,725147,731821,15417,15417,0,,,19/1/2022 7:23
24/9/2021,Sakon Nakhon,11,7023,1146233,569519,576714,10521,10521,0,,,19/1/2022 7:23
24/9/2021,Songkhla,555,28876,1431271,697260,734011,1827,1827,0,74,32,19/1/2022 7:23
24/9/2021,Satun,38,1980,324578,161454,163124,1995,1995,0,65,24,19/1/2022 7:23
24/9/2021,Samut Prakarn,758,107954,1355935,645831,710104,12413,12329,84,,,19/1/2022 7:23
24/9/2021,Samut Songkhram,58,9950,191160,91278,99882,31388,31388,0,12,6,19/1/2022 7:23
24/9/2021,Samut Sakhon,261,104758,585760,282297,303463,7943,7943,0,45,79,19/1/2022 7:23
24/9/2021,Saraburi,208,25493,644131,316501,327630,30780,30737,43,40,35,19/1/2022 7:23
24/9/2021,Sa kaeo,227,12799,561572,280341,281231,4108,4108,0,29,10,19/1/2022 7:23
24/9/2021,Sing Buri,14,2541,204996,97383,107613,9410,9410,0,,,19/1/2022 7:23
24/9/2021,Suphan Buri,74,12225,835999,403285,432714,30584,30584,0,,,19/1/2022 7:23
24/9/2021,Surat Thani,189,10896,1072025,527245,544780,4772,3619,1153,61,25,19/1/2022 7:23
24/9/2021,Surin,47,14787,1376610,684728,691882,9296,9269,27,,,19/1/2022 7:23
24/9/2021,Sukhothai,21,5407,585695,283594,302101,6514,6514,0,,,19/1/2022 7:23
24/9/2021,Nong Khai,7,3113,516903,256356,260547,11497,11490,7,29,13,19/1/2022 7:23
24/9/2021,Nong Bua Lam Phu,9,3715,508929,253795,255134,1880,1880,0,,,19/1/2022 7:23
24/9/2021,Amnat Charoen,6,2732,376291,187148,189143,2964,2964,0,,,19/1/2022 7:23
24/9/2021,Udon Thani,139,16174,1566740,775793,790947,11621,11611,10,,,19/1/2022 7:23
24/9/2021,Uttaradit,29,3801,446754,217769,228985,7108,7108,0,,,19/1/2022 7:23
24/9/2021,Uthai Thani,18,3273,325202,158940,166262,2630,2630,0,,,19/1/2022 7:23
24/9/2021,Ubon Ratchathani,91,16285,1867421,932017,935404,25612,25612,0,25,10,19/1/2022 7:23
24/9/2021,Ang Thong,57,10197,275337,131732,143605,5978,5978,0,,,19/1/2022 7:23
24/9/2021,Chiang Rai,20,3549,1297567,630638,666929,52280,52001,279,27,13,19/1/2022 7:23
24/9/2021,Chiang Mai,59,12418,1787951,863847,924104,149552,148477,1075,45,24,19/1/2022 7:23
24/9/2021,Phetchaburi,140,17819,482635,232935,249700,88893,88804,89,,,19/1/2022 7:23
24/9/2021,Phetchabun,54,9148,978763,482612,496151,26514,26475,39,,,19/1/2022 7:23
24/9/2021,Loei,5,2898,638822,320038,318784,13785,13770,15,21,7,19/1/2022 7:23
24/9/2021,Phrae,4,1535,435288,209765,225523,11993,11993,0,33,14,19/1/2022 7:23
24/9/2021,Mae Hong Son,8,609,285937,144838,141099,11764,11539,225,18,6,19/1/2022 7:23
24/9/2021,,0,153,,,,,,,,,19/1/2022 7:23
25/9/2021,Krabi,177,3604,478854,237878,240976,4086,3912,174,,,19/1/2022 7:23
25/9/2021,Bangkok,2146,386483,5538629,2598539,2940090,448391,422787,25604,19,9,19/1/2022 7:23
25/9/2021,Kanchanaburi,140,16791,894044,448524,445520,190781,190728,53,22,8,19/1/2022 7:23
25/9/2021,Kalasin,18,7566,976025,482401,493624,4757,4757,0,,,19/1/2022 7:23
25/9/2021,Kamphaeng Phet,20,6891,712444,351736,360708,7679,7679,0,,,19/1/2022 7:23
25/9/2021,Khon Kaen,156,13788,1791794,880418,911376,36884,36884,0,,,19/1/2022 7:23
25/9/2021,Chanthaburi,253,10301,536411,262228,274183,24937,24842,95,,,19/1/2022 7:23
25/9/2021,Chachoengsao,150,31298,723178,354451,368727,7480,7480,0,42,24,19/1/2022 7:23
25/9/2021,Chon Buri,744,86425,1581618,771595,810023,119870,119059,811,38,14,19/1/2022 7:23
25/9/2021,Chai Nat,10,2271,320948,154287,166661,11052,11052,0,,,19/1/2022 7:23
25/9/2021,Chaiyaphum,57,10306,1122539,554554,567985,16842,16813,29,,,19/1/2022 7:23
25/9/2021,Chumphon,155,8109,509344,251379,257965,2620,2620,0,,,19/1/2022 7:23
25/9/2021,Trang,97,5359,639876,312767,327109,5191,5191,0,,,19/1/2022 7:23
25/9/2021,Trat,105,4539,228450,112952,115498,33159,33006,153,,,19/1/2022 7:23
25/9/2021,Tak,229,15191,675112,341344,333768,18741,18741,0,,,19/1/2022 7:23
25/9/2021,Nakhon Nayok,61,9519,260238,128796,131442,6150,6150,0,,,19/1/2022 7:23
25/9/2021,Nakhon Pathom,114,32003,921861,442674,479187,17076,17058,18,37,9,19/1/2022 7:23
25/9/2021,Nakhon Phanom,8,4760,717043,357140,359903,9839,9839,0,,,19/1/2022 7:23
25/9/2021,Nakhon Ratchasima,148,24047,2634005,1293977,1340028,158830,157909,921,35,12,19/1/2022 7:23
25/9/2021,Nakhon Si Thammarat,326,13920,1549321,764443,784878,9361,9361,0,,,19/1/2022 7:23
25/9/2021,Nakhon Sawan,78,10695,1036053,505240,530813,18756,18756,0,10,58,19/1/2022 7:23
25/9/2021,Nonthaburi,193,60773,1285994,598164,687830,13326,13275,51,23,6,19/1/2022 7:23
25/9/2021,Narathiwat,427,22194,808908,400179,408729,945,945,0,56,11,19/1/2022 7:23
25/9/2021,Nan,1,2356,475915,238017,237898,21353,21281,72,,,19/1/2022 7:23
25/9/2021,Bueng Kan,2,1771,421910,211455,210455,2662,2662,0,,,19/1/2022 7:23
25/9/2021,Buri Ram,68,15425,1579547,783516,796031,22217,22141,76,,,19/1/2022 7:23
25/9/2021,Pathum Thani,129,37750,1186767,562265,624502,10969,10893,76,36,28,19/1/2022 7:23
25/9/2021,Prachuap Khiri Khan,36,10565,553460,274610,278850,78909,78814,95,,,19/1/2022 7:23
25/9/2021,Prachin Buri,243,14745,494821,244371,250450,7010,7010,0,59,22,19/1/2022 7:23
25/9/2021,Pattani,270,20379,728989,360071,368918,1410,1410,0,,,19/1/2022 7:23
25/9/2021,Phra Nakhon Si Ayutthaya,203,26886,820211,393877,426334,63382,63260,122,22,27,19/1/2022 7:23
25/9/2021,Phayao,2,1716,465194,226350,238844,12520,12407,113,31,11,19/1/2022 7:23
25/9/2021,Phang-nga,52,2228,268130,133856,134274,11169,9671,1498,,,19/1/2022 7:23
25/9/2021,Phatthalung,74,4008,522511,254483,268028,1958,1958,0,,,19/1/2022 7:23
25/9/2021,Phichit,26,4112,530097,258414,271683,7058,7058,0,,,19/1/2022 7:23
25/9/2021,Phitsanulok,56,4609,847460,414773,432687,33623,33466,157,,,19/1/2022 7:23
25/9/2021,Phuket,225,10175,419217,198181,221036,85481,60028,25453,49,18,19/1/2022 7:23
25/9/2021,Maha Sarakham,36,9438,949461,465434,484027,4086,4086,0,,,19/1/2022 7:23
25/9/2021,Mukdahan,5,2024,351274,175455,175819,17246,17246,0,,,19/1/2022 7:23
25/9/2021,Yala,632,20634,541791,269774,272017,710,710,0,67,21,19/1/2022 7:23
25/9/2021,Yasothon,5,5486,533435,266108,267327,3724,3724,0,,,19/1/2022 7:23
25/9/2021,Ranong,74,8637,194674,98251,96423,2582,2582,0,,,19/1/2022 7:23
25/9/2021,Rayong,454,30138,749481,368005,381476,24688,24442,246,27,17,19/1/2022 7:23
25/9/2021,Ratchaburi,359,28530,868959,422400,446559,30897,30897,0,,,19/1/2022 7:23
25/9/2021,Roi Et,23,12800,1296274,642169,654105,3672,3672,0,,,19/1/2022 7:23
25/9/2021,Lop Buri,132,14039,740199,368985,371214,24082,24044,38,,,19/1/2022 7:23
25/9/2021,Lampang,5,2170,725923,353601,372322,9312,9210,102,46,13,19/1/2022 7:23
25/9/2021,Lamphun,10,1997,401450,192935,208515,8920,8828,92,,,19/1/2022 7:23
25/9/2021,Si Sa Ket,29,14714,1456968,725147,731821,15417,15417,0,,,19/1/2022 7:23
25/9/2021,Sakon Nakhon,13,7036,1146233,569519,576714,10521,10521,0,,,19/1/2022 7:23
25/9/2021,Songkhla,401,29277,1431271,697260,734011,1827,1827,0,59,23,19/1/2022 7:23
25/9/2021,Satun,9,1989,324578,161454,163124,1995,1995,0,51,25,19/1/2022 7:23
25/9/2021,Samut Prakarn,738,108692,1355935,645831,710104,12413,12329,84,,,19/1/2022 7:23
25/9/2021,Samut Songkhram,72,10022,191160,91278,99882,31388,31388,0,13,4,19/1/2022 7:23
25/9/2021,Samut Sakhon,317,105075,585760,282297,303463,7943,7943,0,55,24,19/1/2022 7:23
25/9/2021,Saraburi,242,25735,644131,316501,327630,30780,30737,43,28,33,19/1/2022 7:23
25/9/2021,Sa kaeo,102,12901,561572,280341,281231,4108,4108,0,16,9,19/1/2022 7:23
25/9/2021,Sing Buri,13,2554,204996,97383,107613,9410,9410,0,,,19/1/2022 7:23
25/9/2021,Suphan Buri,91,12316,835999,403285,432714,30584,30584,0,,,19/1/2022 7:23
25/9/2021,Surat Thani,258,11154,1072025,527245,544780,4772,3619,1153,74,22,19/1/2022 7:23
25/9/2021,Surin,57,14844,1376610,684728,691882,9296,9269,27,,,19/1/2022 7:23
25/9/2021,Sukhothai,30,5437,585695,283594,302101,6514,6514,0,,,19/1/2022 7:23
25/9/2021,Nong Khai,27,3140,516903,256356,260547,11497,11490,7,32,13,19/1/2022 7:23
25/9/2021,Nong Bua Lam Phu,13,3728,508929,253795,255134,1880,1880,0,,,19/1/2022 7:23
25/9/2021,Amnat Charoen,8,2740,376291,187148,189143,2964,2964,0,,,19/1/2022 7:23
25/9/2021,Udon Thani,128,16302,1566740,775793,790947,11621,11611,10,,,19/1/2022 7:23
25/9/2021,Uttaradit,18,3819,446754,217769,228985,7108,7108,0,,,19/1/2022 7:23
25/9/2021,Uthai Thani,16,3289,325202,158940,166262,2630,2630,0,,,19/1/2022 7:23
25/9/2021,Ubon Ratchathani,89,16374,1867421,932017,935404,25612,25612,0,19,13,19/1/2022 7:23
25/9/2021,Ang Thong,34,10231,275337,131732,143605,5978,5978,0,,,19/1/2022 7:23
25/9/2021,Chiang Rai,34,3583,1297567,630638,666929,52280,52001,279,31,8,19/1/2022 7:23
25/9/2021,Chiang Mai,84,12502,1787951,863847,924104,149552,148477,1075,51,14,19/1/2022 7:23
25/9/2021,Phetchaburi,155,17974,482635,232935,249700,88893,88804,89,,,19/1/2022 7:23
25/9/2021,Phetchabun,22,9170,978763,482612,496151,26514,26475,39,,,19/1/2022 7:23
25/9/2021,Loei,24,2922,638822,320038,318784,13785,13770,15,10,8,19/1/2022 7:23
25/9/2021,Phrae,11,1546,435288,209765,225523,11993,11993,0,30,13,19/1/2022 7:23
25/9/2021,Mae Hong Son,6,615,285937,144838,141099,11764,11539,225,23,3,19/1/2022 7:23
25/9/2021,,0,153,,,,,,,,,19/1/2022 7:23
26/9/2021,Krabi,136,3740,478854,237878,240976,4086,3912,174,,,19/1/2022 7:23
26/9/2021,Bangkok,1987,388470,5538629,2598539,2940090,448391,422787,25604,25,18,19/1/2022 7:23
26/9/2021,Kanchanaburi,177,16968,894044,448524,445520,190781,190728,53,16,15,19/1/2022 7:23
26/9/2021,Kalasin,15,7581,976025,482401,493624,4757,4757,0,,,19/1/2022 7:23
26/9/2021,Kamphaeng Phet,28,6919,712444,351736,360708,7679,7679,0,,,19/1/2022 7:23
26/9/2021,Khon Kaen,145,13933,1791794,880418,911376,36884,36884,0, ,24,19/1/2022 7:23
26/9/2021,Chanthaburi,235,10536,536411,262228,274183,24937,24842,95,,,19/1/2022 7:23
26/9/2021,Chachoengsao,130,31428,723178,354451,368727,7480,7480,0,28,29,19/1/2022 7:23
26/9/2021,Chon Buri,651,87076,1581618,771595,810023,119870,119059,811,34,25,19/1/2022 7:23
26/9/2021,Chai Nat,2,2273,320948,154287,166661,11052,11052,0,,,19/1/2022 7:23
26/9/2021,Chaiyaphum,46,10352,1122539,554554,567985,16842,16813,29,,,19/1/2022 7:23
26/9/2021,Chumphon,221,8330,509344,251379,257965,2620,2620,0,,,19/1/2022 7:23
26/9/2021,Trang,52,5411,639876,312767,327109,5191,5191,0,,,19/1/2022 7:23
26/9/2021,Trat,104,4643,228450,112952,115498,33159,33006,153,,,19/1/2022 7:23
26/9/2021,Tak,131,15322,675112,341344,333768,18741,18741,0,,,19/1/2022 7:23
26/9/2021,Nakhon Nayok,25,9544,260238,128796,131442,6150,6150,0,,,19/1/2022 7:23
26/9/2021,Nakhon Pathom,128,32131,921861,442674,479187,17076,17058,18,23,27,19/1/2022 7:23
26/9/2021,Nakhon Phanom,6,4766,717043,357140,359903,9839,9839,0,,,19/1/2022 7:23
26/9/2021,Nakhon Ratchasima,243,24290,2634005,1293977,1340028,158830,157909,921,31,21,19/1/2022 7:23
26/9/2021,Nakhon Si Thammarat,493,14413,1549321,764443,784878,9361,9361,0,,,19/1/2022 7:23
26/9/2021,Nakhon Sawan,100,10795,1036053,505240,530813,18756,18756,0,63,25,19/1/2022 7:23
26/9/2021,Nonthaburi,246,61019,1285994,598164,687830,13326,13275,51,17,9,19/1/2022 7:23
26/9/2021,Narathiwat,372,22566,808908,400179,408729,945,945,0,24,10,19/1/2022 7:23
26/9/2021,Nan,0,2356,475915,238017,237898,21353,21281,72,,,19/1/2022 7:23
26/9/2021,Bueng Kan,0,1771,421910,211455,210455,2662,2662,0,,,19/1/2022 7:23
26/9/2021,Buri Ram,65,15490,1579547,783516,796031,22217,22141,76,,,19/1/2022 7:23
26/9/2021,Pathum Thani,158,37908,1186767,562265,624502,10969,10893,76,52,21,19/1/2022 7:23
26/9/2021,Prachuap Khiri Khan,158,10723,553460,274610,278850,78909,78814,95,,,19/1/2022 7:23
26/9/2021,Prachin Buri,249,14994,494821,244371,250450,7010,7010,0,34,24,19/1/2022 7:23
26/9/2021,Pattani,269,20648,728989,360071,368918,1410,1410,0,,,19/1/2022 7:23
26/9/2021,Phra Nakhon Si Ayutthaya,161,27047,820211,393877,426334,63382,63260,122,21,35,19/1/2022 7:23
26/9/2021,Phayao,1,1717,465194,226350,238844,12520,12407,113,19,14,19/1/2022 7:23
26/9/2021,Phang-nga,66,2294,268130,133856,134274,11169,9671,1498,,,19/1/2022 7:23
26/9/2021,Phatthalung,101,4109,522511,254483,268028,1958,1958,0,,,19/1/2022 7:23
26/9/2021,Phichit,29,4141,530097,258414,271683,7058,7058,0,,,19/1/2022 7:23
26/9/2021,Phitsanulok,34,4643,847460,414773,432687,33623,33466,157,,,19/1/2022 7:23
26/9/2021,Phuket,219,10394,419217,198181,221036,85481,60028,25453,47,19,19/1/2022 7:23
26/9/2021,Maha Sarakham,28,9466,949461,465434,484027,4086,4086,0,,,19/1/2022 7:23
26/9/2021,Mukdahan,0,2024,351274,175455,175819,17246,17246,0,,,19/1/2022 7:23
26/9/2021,Yala,558,21192,541791,269774,272017,710,710,0,44,17,19/1/2022 7:23
26/9/2021,Yasothon,2,5488,533435,266108,267327,3724,3724,0,,,19/1/2022 7:23
26/9/2021,Ranong,47,8684,194674,98251,96423,2582,2582,0,,,19/1/2022 7:23
26/9/2021,Rayong,518,30656,749481,368005,381476,24688,24442,246,20,24,19/1/2022 7:23
26/9/2021,Ratchaburi,297,28827,868959,422400,446559,30897,30897,0,,,19/1/2022 7:23
26/9/2021,Roi Et,30,12830,1296274,642169,654105,3672,3672,0,,,19/1/2022 7:23
26/9/2021,Lop Buri,132,14171,740199,368985,371214,24082,24044,38,,,19/1/2022 7:23
26/9/2021,Lampang,14,2184,725923,353601,372322,9312,9210,102,42,14,19/1/2022 7:23
26/9/2021,Lamphun,11,2008,401450,192935,208515,8920,8828,92,,,19/1/2022 7:23
26/9/2021,Si Sa Ket,25,14739,1456968,725147,731821,15417,15417,0,,,19/1/2022 7:23
26/9/2021,Sakon Nakhon,12,7048,1146233,569519,576714,10521,10521,0,,,19/1/2022 7:23
26/9/2021,Songkhla,409,29686,1431271,697260,734011,1827,1827,0,41,25,19/1/2022 7:23
26/9/2021,Satun,37,2026,324578,161454,163124,1995,1995,0,50,22,19/1/2022 7:23
26/9/2021,Samut Prakarn,713,109405,1355935,645831,710104,12413,12329,84,,,19/1/2022 7:23
26/9/2021,Samut Songkhram,64,10086,191160,91278,99882,31388,31388,0,6,6,19/1/2022 7:23
26/9/2021,Samut Sakhon,412,105487,585760,282297,303463,7943,7943,0,46,64,19/1/2022 7:23
26/9/2021,Saraburi,219,25954,644131,316501,327630,30780,30737,43,34,68,19/1/2022 7:23
26/9/2021,Sa kaeo,130,13031,561572,280341,281231,4108,4108,0,12,12,19/1/2022 7:23
26/9/2021,Sing Buri,24,2578,204996,97383,107613,9410,9410,0,,,19/1/2022 7:23
26/9/2021,Suphan Buri,62,12378,835999,403285,432714,30584,30584,0,,,19/1/2022 7:23
26/9/2021,Surat Thani,227,11381,1072025,527245,544780,4772,3619,1153,46,27,19/1/2022 7:23
26/9/2021,Surin,20,14864,1376610,684728,691882,9296,9269,27,,,19/1/2022 7:23
26/9/2021,Sukhothai,17,5454,585695,283594,302101,6514,6514,0,,,19/1/2022 7:23
26/9/2021,Nong Khai,10,3150,516903,256356,260547,11497,11490,7,31,12,19/1/2022 7:23
26/9/2021,Nong Bua Lam Phu,11,3739,508929,253795,255134,1880,1880,0,,,19/1/2022 7:23
26/9/2021,Amnat Charoen,9,2749,376291,187148,189143,2964,2964,0,,,19/1/2022 7:23
26/9/2021,Udon Thani,635,16937,1566740,775793,790947,11621,11611,10,,,19/1/2022 7:23
26/9/2021,Uttaradit,13,3832,446754,217769,228985,7108,7108,0,,,19/1/2022 7:23
26/9/2021,Uthai Thani,7,3296,325202,158940,166262,2630,2630,0,,,19/1/2022 7:23
26/9/2021,Ubon Ratchathani,58,16432,1867421,932017,935404,25612,25612,0,25,19,19/1/2022 7:23
26/9/2021,Ang Thong,135,10366,275337,131732,143605,5978,5978,0,,,19/1/2022 7:23
26/9/2021,Chiang Rai,20,3603,1297567,630638,666929,52280,52001,279,17,10,19/1/2022 7:23
26/9/2021,Chiang Mai,70,12572,1787951,863847,924104,149552,148477,1075,24,18,19/1/2022 7:23
26/9/2021,Phetchaburi,125,18099,482635,232935,249700,88893,88804,89,,,19/1/2022 7:23
26/9/2021,Phetchabun,43,9213,978763,482612,496151,26514,26475,39,,,19/1/2022 7:23
26/9/2021,Loei,6,2928,638822,320038,318784,13785,13770,15,15,11,19/1/2022 7:23
26/9/2021,Phrae,1,1547,435288,209765,225523,11993,11993,0,29,16,19/1/2022 7:23
26/9/2021,Mae Hong Son,19,634,285937,144838,141099,11764,11539,225,13,4,19/1/2022 7:23
26/9/2021,,0,153,,,,,,,,,19/1/2022 7:23
27/9/2021,Krabi,155,3895,478854,237878,240976,4086,3912,174,,,19/1/2022 7:23
27/9/2021,Bangkok,1788,390258,5538629,2598539,2940090,448391,422787,25604,35,34,19/1/2022 7:23
27/9/2021,Kanchanaburi,185,17153,894044,448524,445520,190781,190728,53,25,19,19/1/2022 7:23
27/9/2021,Kalasin,15,7596,976025,482401,493624,4757,4757,0,,,19/1/2022 7:23
27/9/2021,Kamphaeng Phet,17,6936,712444,351736,360708,7679,7679,0,,,19/1/2022 7:23
27/9/2021,Khon Kaen,203,14136,1791794,880418,911376,36884,36884,0,53,27,19/1/2022 7:23
27/9/2021,Chanthaburi,185,10721,536411,262228,274183,24937,24842,95,,,19/1/2022 7:23
27/9/2021,Chachoengsao,79,31507,723178,354451,368727,7480,7480,0,44,30,19/1/2022 7:23
27/9/2021,Chon Buri,587,87663,1581618,771595,810023,119870,119059,811,46,37,19/1/2022 7:23
27/9/2021,Chai Nat,7,2280,320948,154287,166661,11052,11052,0,,,19/1/2022 7:23
27/9/2021,Chaiyaphum,29,10381,1122539,554554,567985,16842,16813,29,,,19/1/2022 7:23
27/9/2021,Chumphon,172,8502,509344,251379,257965,2620,2620,0,,,19/1/2022 7:23
27/9/2021,Trang,92,5503,639876,312767,327109,5191,5191,0,,,19/1/2022 7:23
27/9/2021,Trat,32,4675,228450,112952,115498,33159,33006,153,,,19/1/2022 7:23
27/9/2021,Tak,172,15494,675112,341344,333768,18741,18741,0,,,19/1/2022 7:23
27/9/2021,Nakhon Nayok,30,9574,260238,128796,131442,6150,6150,0,,,19/1/2022 7:23
27/9/2021,Nakhon Pathom,86,32217,921861,442674,479187,17076,17058,18,66,31,19/1/2022 7:23
27/9/2021,Nakhon Phanom,6,4772,717043,357140,359903,9839,9839,0,,,19/1/2022 7:23
27/9/2021,Nakhon Ratchasima,228,24518,2634005,1293977,1340028,158830,157909,921,46,24,19/1/2022 7:23
27/9/2021,Nakhon Si Thammarat,262,14675,1549321,764443,784878,9361,9361,0,,,19/1/2022 7:23
27/9/2021,Nakhon Sawan,62,10857,1036053,505240,530813,18756,18756,0,49,20,19/1/2022 7:23
27/9/2021,Nonthaburi,272,61291,1285994,598164,687830,13326,13275,51,35,13,19/1/2022 7:23
27/9/2021,Narathiwat,301,22867,808908,400179,408729,945,945,0,21,8,19/1/2022 7:23
27/9/2021,Nan,4,2360,475915,238017,237898,21353,21281,72,,,19/1/2022 7:23
27/9/2021,Bueng Kan,3,1774,421910,211455,210455,2662,2662,0,,,19/1/2022 7:23
27/9/2021,Buri Ram,51,15541,1579547,783516,796031,22217,22141,76,,,19/1/2022 7:23
27/9/2021,Pathum Thani,122,38030,1186767,562265,624502,10969,10893,76,38,31,19/1/2022 7:23
27/9/2021,Prachuap Khiri Khan,48,10771,553460,274610,278850,78909,78814,95,,,19/1/2022 7:23
27/9/2021,Prachin Buri,198,15192,494821,244371,250450,7010,7010,0,41,30,19/1/2022 7:23
27/9/2021,Pattani,305,20953,728989,360071,368918,1410,1410,0,,,19/1/2022 7:23
27/9/2021,Phra Nakhon Si Ayutthaya,93,27140,820211,393877,426334,63382,63260,122,35, ,19/1/2022 7:23
27/9/2021,Phayao,0,1717,465194,226350,238844,12520,12407,113,25,13,19/1/2022 7:23
27/9/2021,Phang-nga,67,2361,268130,133856,134274,11169,9671,1498,,,19/1/2022 7:23
27/9/2021,Phatthalung,65,4174,522511,254483,268028,1958,1958,0,,,19/1/2022 7:23
27/9/2021,Phichit,14,4155,530097,258414,271683,7058,7058,0,,,19/1/2022 7:23
27/9/2021,Phitsanulok,16,4659,847460,414773,432687,33623,33466,157,,,19/1/2022 7:23
27/9/2021,Phuket,192,10586,419217,198181,221036,85481,60028,25453,46,23,19/1/2022 7:23
27/9/2021,Maha Sarakham,28,9494,949461,465434,484027,4086,4086,0,,,19/1/2022 7:23
27/9/2021,Mukdahan,2,2026,351274,175455,175819,17246,17246,0,,,19/1/2022 7:23
27/9/2021,Yala,445,21637,541791,269774,272017,710,710,0,35,18,19/1/2022 7:23
27/9/2021,Yasothon,5,5493,533435,266108,267327,3724,3724,0,,,19/1/2022 7:23
27/9/2021,Ranong,39,8723,194674,98251,96423,2582,2582,0,,,19/1/2022 7:23
27/9/2021,Rayong,355,31011,749481,368005,381476,24688,24442,246,33,32,19/1/2022 7:23
27/9/2021,Ratchaburi,274,29101,868959,422400,446559,30897,30897,0,,,19/1/2022 7:23
27/9/2021,Roi Et,33,12863,1296274,642169,654105,3672,3672,0,,,19/1/2022 7:23
27/9/2021,Lop Buri,131,14302,740199,368985,371214,24082,24044,38,,,19/1/2022 7:23
27/9/2021,Lampang,9,2193,725923,353601,372322,9312,9210,102,45,15,19/1/2022 7:23
27/9/2021,Lamphun,11,2019,401450,192935,208515,8920,8828,92,,,19/1/2022 7:23
27/9/2021,Si Sa Ket,11,14750,1456968,725147,731821,15417,15417,0,,,19/1/2022 7:23
27/9/2021,Sakon Nakhon,16,7064,1146233,569519,576714,10521,10521,0,,,19/1/2022 7:23
27/9/2021,Songkhla,466,30152,1431271,697260,734011,1827,1827,0,50,21,19/1/2022 7:23
27/9/2021,Satun,46,2072,324578,161454,163124,1995,1995,0,36,27,19/1/2022 7:23
27/9/2021,Samut Prakarn,652,110057,1355935,645831,710104,12413,12329,84,,,19/1/2022 7:23
27/9/2021,Samut Songkhram,53,10139,191160,91278,99882,31388,31388,0,14,14,19/1/2022 7:23
27/9/2021,Samut Sakhon,291,105778,585760,282297,303463,7943,7943,0,41,38,19/1/2022 7:23
27/9/2021,Saraburi,165,26119,644131,316501,327630,30780,30737,43,58,78,19/1/2022 7:23
27/9/2021,Sa kaeo,91,13122,561572,280341,281231,4108,4108,0,19,19,19/1/2022 7:23
27/9/2021,Sing Buri,16,2594,204996,97383,107613,9410,9410,0,,,19/1/2022 7:23
27/9/2021,Suphan Buri,57,12435,835999,403285,432714,30584,30584,0,,,19/1/2022 7:23
27/9/2021,Surat Thani,205,11586,1072025,527245,544780,4772,3619,1153,68,27,19/1/2022 7:23
27/9/2021,Surin,31,14895,1376610,684728,691882,9296,9269,27,,,19/1/2022 7:23
27/9/2021,Sukhothai,6,5460,585695,283594,302101,6514,6514,0,,,19/1/2022 7:23
27/9/2021,Nong Khai,8,3158,516903,256356,260547,11497,11490,7,30,12,19/1/2022 7:23
27/9/2021,Nong Bua Lam Phu,1,3740,508929,253795,255134,1880,1880,0,,,19/1/2022 7:23
27/9/2021,Amnat Charoen,12,2761,376291,187148,189143,2964,2964,0,,,19/1/2022 7:23
27/9/2021,Udon Thani,276,17213,1566740,775793,790947,11621,11611,10,,,19/1/2022 7:23
27/9/2021,Uttaradit,15,3847,446754,217769,228985,7108,7108,0,,,19/1/2022 7:23
27/9/2021,Uthai Thani,5,3301,325202,158940,166262,2630,2630,0,,,19/1/2022 7:23
27/9/2021,Ubon Ratchathani,99,16531,1867421,932017,935404,25612,25612,0,42,27,19/1/2022 7:23
27/9/2021,Ang Thong,20,10386,275337,131732,143605,5978,5978,0,,,19/1/2022 7:23
27/9/2021,Chiang Rai,31,3634,1297567,630638,666929,52280,52001,279,24,11,19/1/2022 7:23
27/9/2021,Chiang Mai,62,12634,1787951,863847,924104,149552,148477,1075,44,22,19/1/2022 7:23
27/9/2021,Phetchaburi,123,18222,482635,232935,249700,88893,88804,89,,,19/1/2022 7:23
27/9/2021,Phetchabun,17,9230,978763,482612,496151,26514,26475,39,,,19/1/2022 7:23
27/9/2021,Loei,22,2950,638822,320038,318784,13785,13770,15,16, ,19/1/2022 7:23
27/9/2021,Phrae,7,1554,435288,209765,225523,11993,11993,0,34,13,19/1/2022 7:23
27/9/2021,Mae Hong Son,9,643,285937,144838,141099,11764,11539,225,17, ,19/1/2022 7:23
27/9/2021,,0,153,,,,,,,,,19/1/2022 7:23
28/9/2021,Krabi,132,4027,478854,237878,240976,4086,3912,174,,,19/1/2022 7:23
28/9/2021,Bangkok,1561,391819,5538629,2598539,2940090,448391,422787,25604,66,50,19/1/2022 7:23
28/9/2021,Kanchanaburi,97,17250,894044,448524,445520,190781,190728,53,40,23,19/1/2022 7:23
28/9/2021,Kalasin,17,7613,976025,482401,493624,4757,4757,0,,,19/1/2022 7:23
28/9/2021,Kamphaeng Phet,8,6944,712444,351736,360708,7679,7679,0,,,19/1/2022 7:23
28/9/2021,Khon Kaen,129,14265,1791794,880418,911376,36884,36884,0,55,29,19/1/2022 7:23
28/9/2021,Chanthaburi,170,10891,536411,262228,274183,24937,24842,95,,,19/1/2022 7:23
28/9/2021,Chachoengsao,120,31627,723178,354451,368727,7480,7480,0,48,38,19/1/2022 7:23
28/9/2021,Chon Buri,713,88376,1581618,771595,810023,119870,119059,811,65,40,19/1/2022 7:23
28/9/2021,Chai Nat,2,2282,320948,154287,166661,11052,11052,0,,,19/1/2022 7:23
28/9/2021,Chaiyaphum,18,10399,1122539,554554,567985,16842,16813,29,,,19/1/2022 7:23
28/9/2021,Chumphon,157,8659,509344,251379,257965,2620,2620,0,,,19/1/2022 7:23
28/9/2021,Trang,56,5559,639876,312767,327109,5191,5191,0,,,19/1/2022 7:23
28/9/2021,Trat,77,4752,228450,112952,115498,33159,33006,153,,,19/1/2022 7:23
28/9/2021,Tak,94,15588,675112,341344,333768,18741,18741,0,,,19/1/2022 7:23
28/9/2021,Nakhon Nayok,15,9589,260238,128796,131442,6150,6150,0,,,19/1/2022 7:23
28/9/2021,Nakhon Pathom,65,32282,921861,442674,479187,17076,17058,18,58,44,19/1/2022 7:23
28/9/2021,Nakhon Phanom,3,4775,717043,357140,359903,9839,9839,0,,,19/1/2022 7:23
28/9/2021,Nakhon Ratchasima,276,24794,2634005,1293977,1340028,158830,157909,921,52,22,19/1/2022 7:23
28/9/2021,Nakhon Si Thammarat,389,15064,1549321,764443,784878,9361,9361,0,,,19/1/2022 7:23
28/9/2021,Nakhon Sawan,78,10935,1036053,505240,530813,18756,18756,0,37,27,19/1/2022 7:23
28/9/2021,Nonthaburi,135,61426,1285994,598164,687830,13326,13275,51,46,19,19/1/2022 7:23
28/9/2021,Narathiwat,347,23214,808908,400179,408729,945,945,0,16,14,19/1/2022 7:23
28/9/2021,Nan,0,2360,475915,238017,237898,21353,21281,72,,,19/1/2022 7:23
28/9/2021,Bueng Kan,5,1779,421910,211455,210455,2662,2662,0,,,19/1/2022 7:23
28/9/2021,Buri Ram,47,15588,1579547,783516,796031,22217,22141,76,,,19/1/2022 7:23
28/9/2021,Pathum Thani,80,38110,1186767,562265,624502,10969,10893,76,54,33,19/1/2022 7:23
28/9/2021,Prachuap Khiri Khan,46,10817,553460,274610,278850,78909,78814,95,,,19/1/2022 7:23
28/9/2021,Prachin Buri,191,15383,494821,244371,250450,7010,7010,0,53,41,19/1/2022 7:23
28/9/2021,Pattani,413,21366,728989,360071,368918,1410,1410,0,,,19/1/2022 7:23
28/9/2021,Phra Nakhon Si Ayutthaya,104,27244,820211,393877,426334,63382,63260,122,45,41,19/1/2022 7:23
28/9/2021,Phayao,0,1717,465194,226350,238844,12520,12407,113,26,16,19/1/2022 7:23
28/9/2021,Phang-nga,30,2391,268130,133856,134274,11169,9671,1498,,,19/1/2022 7:23
28/9/2021,Phatthalung,60,4234,522511,254483,268028,1958,1958,0,,,19/1/2022 7:23
28/9/2021,Phichit,15,4170,530097,258414,271683,7058,7058,0,,,19/1/2022 7:23
28/9/2021,Phitsanulok,43,4702,847460,414773,432687,33623,33466,157,,,19/1/2022 7:23
28/9/2021,Phuket,183,10769,419217,198181,221036,85481,60028,25453,46,22,19/1/2022 7:23
28/9/2021,Maha Sarakham,58,9552,949461,465434,484027,4086,4086,0,,,19/1/2022 7:23
28/9/2021,Mukdahan,11,2037,351274,175455,175819,17246,17246,0,,,19/1/2022 7:23
28/9/2021,Yala,291,21928,541791,269774,272017,710,710,0,33,18,19/1/2022 7:23
28/9/2021,Yasothon,24,5517,533435,266108,267327,3724,3724,0,,,19/1/2022 7:23
28/9/2021,Ranong,46,8769,194674,98251,96423,2582,2582,0,,,19/1/2022 7:23
28/9/2021,Rayong,259,31270,749481,368005,381476,24688,24442,246,61,32,19/1/2022 7:23
28/9/2021,Ratchaburi,229,29330,868959,422400,446559,30897,30897,0,,,19/1/2022 7:23
28/9/2021,Roi Et,13,12876,1296274,642169,654105,3672,3672,0,,,19/1/2022 7:23
28/9/2021,Lop Buri,52,14354,740199,368985,371214,24082,24044,38,,,19/1/2022 7:23
28/9/2021,Lampang,22,2215,725923,353601,372322,9312,9210,102,49,18,19/1/2022 7:23
28/9/2021,Lamphun,42,2061,401450,192935,208515,8920,8828,92,,,19/1/2022 7:23
28/9/2021,Si Sa Ket,33,14783,1456968,725147,731821,15417,15417,0,,,19/1/2022 7:23
28/9/2021,Sakon Nakhon,8,7072,1146233,569519,576714,10521,10521,0,,,19/1/2022 7:23
28/9/2021,Songkhla,281,30433,1431271,697260,734011,1827,1827,0,38,30,19/1/2022 7:23
28/9/2021,Satun,43,2115,324578,161454,163124,1995,1995,0,50,20,19/1/2022 7:23
28/9/2021,Samut Prakarn,723,110780,1355935,645831,710104,12413,12329,84,,,19/1/2022 7:23
28/9/2021,Samut Songkhram,57,10196,191160,91278,99882,31388,31388,0,36,14,19/1/2022 7:23
28/9/2021,Samut Sakhon,137,105915,585760,282297,303463,7943,7943,0,66,62,19/1/2022 7:23
28/9/2021,Saraburi,82,26201,644131,316501,327630,30780,30737,43,67,85,19/1/2022 7:23
28/9/2021,Sa kaeo,56,13178,561572,280341,281231,4108,4108,0,33,19,19/1/2022 7:23
28/9/2021,Sing Buri,23,2617,204996,97383,107613,9410,9410,0,,,19/1/2022 7:23
28/9/2021,Suphan Buri,56,12491,835999,403285,432714,30584,30584,0,,,19/1/2022 7:23
28/9/2021,Surat Thani,202,11788,1072025,527245,544780,4772,3619,1153,56,27,19/1/2022 7:23
28/9/2021,Surin,20,14915,1376610,684728,691882,9296,9269,27,,,19/1/2022 7:23
28/9/2021,Sukhothai,15,5475,585695,283594,302101,6514,6514,0,,,19/1/2022 7:23
28/9/2021,Nong Khai,1,3159,516903,256356,260547,11497,11490,7,30,10,19/1/2022 7:23
28/9/2021,Nong Bua Lam Phu,1,3741,508929,253795,255134,1880,1880,0,,,19/1/2022 7:23
28/9/2021,Amnat Charoen,12,2773,376291,187148,189143,2964,2964,0,,,19/1/2022 7:23
28/9/2021,Udon Thani,435,17648,1566740,775793,790947,11621,11611,10,,,19/1/2022 7:23
28/9/2021,Uttaradit,20,3867,446754,217769,228985,7108,7108,0,,,19/1/2022 7:23
28/9/2021,Uthai Thani,10,3311,325202,158940,166262,2630,2630,0,,,19/1/2022 7:23
28/9/2021,Ubon Ratchathani,47,16578,1867421,932017,935404,25612,25612,0,61,26,19/1/2022 7:23
28/9/2021,Ang Thong,10,10396,275337,131732,143605,5978,5978,0,,,19/1/2022 7:23
28/9/2021,Chiang Rai,17,3651,1297567,630638,666929,52280,52001,279,22,16,19/1/2022 7:23
28/9/2021,Chiang Mai,90,12724,1787951,863847,924104,149552,148477,1075,40,28,19/1/2022 7:23
28/9/2021,Phetchaburi,125,18347,482635,232935,249700,88893,88804,89,,,19/1/2022 7:23
28/9/2021,Phetchabun,30,9260,978763,482612,496151,26514,26475,39,,,19/1/2022 7:23
28/9/2021,Loei,1,2951,638822,320038,318784,13785,13770,15,,,19/1/2022 7:23
28/9/2021,Phrae,12,1566,435288,209765,225523,11993,11993,0,31,17,19/1/2022 7:23
28/9/2021,Mae Hong Son,19,662,285937,144838,141099,11764,11539,225,,,19/1/2022 7:23
28/9/2021,,0,153,,,,,,,,,19/1/2022 7:23
29/9/2021,Krabi,161,4188,478854,237878,240976,4086,3912,174,,,19/1/2022 7:23
29/9/2021,Bangkok,1590,393409,5538629,2598539,2940090,448391,422787,25604,98,38,19/1/2022 7:23
29/9/2021,Kanchanaburi,80,17330,894044,448524,445520,190781,190728,53,48,30,19/1/2022 7:23
29/9/2021,Kalasin,26,7639,976025,482401,493624,4757,4757,0,,,19/1/2022 7:23
29/9/2021,Kamphaeng Phet,19,6963,712444,351736,360708,7679,7679,0,,,19/1/2022 7:23
29/9/2021,Khon Kaen,130,14395,1791794,880418,911376,36884,36884,0,63,43,19/1/2022 7:23
29/9/2021,Chanthaburi,228,11119,536411,262228,274183,24937,24842,95,,,19/1/2022 7:23
29/9/2021,Chachoengsao,140,31767,723178,354451,368727,7480,7480,0,59,36,19/1/2022 7:23
29/9/2021,Chon Buri,774,89150,1581618,771595,810023,119870,119059,811,72,34,19/1/2022 7:23
29/9/2021,Chai Nat,21,2303,320948,154287,166661,11052,11052,0,,,19/1/2022 7:23
29/9/2021,Chaiyaphum,24,10423,1122539,554554,567985,16842,16813,29,,,19/1/2022 7:23
29/9/2021,Chumphon,194,8853,509344,251379,257965,2620,2620,0,,,19/1/2022 7:23
29/9/2021,Trang,80,5639,639876,312767,327109,5191,5191,0,,,19/1/2022 7:23
29/9/2021,Trat,68,4820,228450,112952,115498,33159,33006,153,,,19/1/2022 7:23
29/9/2021,Tak,151,15739,675112,341344,333768,18741,18741,0,,,19/1/2022 7:23
29/9/2021,Nakhon Nayok,88,9677,260238,128796,131442,6150,6150,0,,,19/1/2022 7:23
29/9/2021,Nakhon Pathom,54,32336,921861,442674,479187,17076,17058,18,91,36,19/1/2022 7:23
29/9/2021,Nakhon Phanom,4,4779,717043,357140,359903,9839,9839,0,,,19/1/2022 7:23
29/9/2021,Nakhon Ratchasima,191,24985,2634005,1293977,1340028,158830,157909,921,50,28,19/1/2022 7:23
29/9/2021,Nakhon Si Thammarat,205,15269,1549321,764443,784878,9361,9361,0,,,19/1/2022 7:23
29/9/2021,Nakhon Sawan,104,11039,1036053,505240,530813,18756,18756,0,53,37,19/1/2022 7:23
29/9/2021,Nonthaburi,173,61599,1285994,598164,687830,13326,13275,51,67,13,19/1/2022 7:23
29/9/2021,Narathiwat,513,23727,808908,400179,408729,945,945,0,31,19,19/1/2022 7:23
29/9/2021,Nan,1,2361,475915,238017,237898,21353,21281,72,,,19/1/2022 7:23
29/9/2021,Bueng Kan,4,1783,421910,211455,210455,2662,2662,0,,,19/1/2022 7:23
29/9/2021,Buri Ram,48,15636,1579547,783516,796031,22217,22141,76,,,19/1/2022 7:23
29/9/2021,Pathum Thani,81,38191,1186767,562265,624502,10969,10893,76,62,36,19/1/2022 7:23
29/9/2021,Prachuap Khiri Khan,72,10889,553460,274610,278850,78909,78814,95,,,19/1/2022 7:23
29/9/2021,Prachin Buri,257,15640,494821,244371,250450,7010,7010,0,68,38,19/1/2022 7:23
29/9/2021,Pattani,200,21566,728989,360071,368918,1410,1410,0,,,19/1/2022 7:23
29/9/2021,Phra Nakhon Si Ayutthaya,93,27337,820211,393877,426334,63382,63260,122,42,44,19/1/2022 7:23
29/9/2021,Phayao,0,1717,465194,226350,238844,12520,12407,113,35,18,19/1/2022 7:23
29/9/2021,Phang-nga,88,2479,268130,133856,134274,11169,9671,1498,,,19/1/2022 7:23
29/9/2021,Phatthalung,54,4288,522511,254483,268028,1958,1958,0,,,19/1/2022 7:23
29/9/2021,Phichit,9,4179,530097,258414,271683,7058,7058,0,,,19/1/2022 7:23
29/9/2021,Phitsanulok,38,4740,847460,414773,432687,33623,33466,157,,,19/1/2022 7:23
29/9/2021,Phuket,197,10966,419217,198181,221036,85481,60028,25453,48,20,19/1/2022 7:23
29/9/2021,Maha Sarakham,34,9586,949461,465434,484027,4086,4086,0,,,19/1/2022 7:23
29/9/2021,Mukdahan,8,2045,351274,175455,175819,17246,17246,0,,,19/1/2022 7:23
29/9/2021,Yala,452,22380,541791,269774,272017,710,710,0,36,17,19/1/2022 7:23
29/9/2021,Yasothon,4,5521,533435,266108,267327,3724,3724,0,,,19/1/2022 7:23
29/9/2021,Ranong,28,8797,194674,98251,96423,2582,2582,0,,,19/1/2022 7:23
29/9/2021,Rayong,545,31815,749481,368005,381476,24688,24442,246,68,28,19/1/2022 7:23
29/9/2021,Ratchaburi,282,29612,868959,422400,446559,30897,30897,0,,,19/1/2022 7:23
29/9/2021,Roi Et,17,12893,1296274,642169,654105,3672,3672,0,,,19/1/2022 7:23
29/9/2021,Lop Buri,72,14426,740199,368985,371214,24082,24044,38,,,19/1/2022 7:23
29/9/2021,Lampang,11,2226,725923,353601,372322,9312,9210,102,56,21,19/1/2022 7:23
29/9/2021,Lamphun,40,2101,401450,192935,208515,8920,8828,92,,,19/1/2022 7:23
29/9/2021,Si Sa Ket,21,14804,1456968,725147,731821,15417,15417,0,,,19/1/2022 7:23
29/9/2021,Sakon Nakhon,35,7107,1146233,569519,576714,10521,10521,0,,,19/1/2022 7:23
29/9/2021,Songkhla,517,30950,1431271,697260,734011,1827,1827,0,60,29,19/1/2022 7:23
29/9/2021,Satun,38,2153,324578,161454,163124,1995,1995,0,37,26,19/1/2022 7:23
29/9/2021,Samut Prakarn,587,111367,1355935,645831,710104,12413,12329,84,,,19/1/2022 7:23
29/9/2021,Samut Songkhram,30,10226,191160,91278,99882,31388,31388,0,40,16,19/1/2022 7:23
29/9/2021,Samut Sakhon,99,106014,585760,282297,303463,7943,7943,0,111,46,19/1/2022 7:23
29/9/2021,Saraburi,155,26356,644131,316501,327630,30780,30737,43,71,71,19/1/2022 7:23
29/9/2021,Sa kaeo,220,13398,561572,280341,281231,4108,4108,0,37,23,19/1/2022 7:23
29/9/2021,Sing Buri,20,2637,204996,97383,107613,9410,9410,0,,,19/1/2022 7:23
29/9/2021,Suphan Buri,86,12577,835999,403285,432714,30584,30584,0,,,19/1/2022 7:23
29/9/2021,Surat Thani,220,12008,1072025,527245,544780,4772,3619,1153,56,27,19/1/2022 7:23
29/9/2021,Surin,22,14937,1376610,684728,691882,9296,9269,27,,,19/1/2022 7:23
29/9/2021,Sukhothai,36,5511,585695,283594,302101,6514,6514,0,,,19/1/2022 7:23
29/9/2021,Nong Khai,5,3164,516903,256356,260547,11497,11490,7,25,8,19/1/2022 7:23
29/9/2021,Nong Bua Lam Phu,7,3748,508929,253795,255134,1880,1880,0,,,19/1/2022 7:23
29/9/2021,Amnat Charoen,4,2777,376291,187148,189143,2964,2964,0,,,19/1/2022 7:23
29/9/2021,Udon Thani,121,17769,1566740,775793,790947,11621,11611,10,,,19/1/2022 7:23
29/9/2021,Uttaradit,13,3880,446754,217769,228985,7108,7108,0,,,19/1/2022 7:23
29/9/2021,Uthai Thani,23,3334,325202,158940,166262,2630,2630,0,,,19/1/2022 7:23
29/9/2021,Ubon Ratchathani,138,16716,1867421,932017,935404,25612,25612,0,58,34,19/1/2022 7:23
29/9/2021,Ang Thong,36,10432,275337,131732,143605,5978,5978,0,,,19/1/2022 7:23
29/9/2021,Chiang Rai,29,3680,1297567,630638,666929,52280,52001,279,40,16,19/1/2022 7:23
29/9/2021,Chiang Mai,59,12783,1787951,863847,924104,149552,148477,1075,55,29,19/1/2022 7:23
29/9/2021,Phetchaburi,125,18472,482635,232935,249700,88893,88804,89,,,19/1/2022 7:23
29/9/2021,Phetchabun,47,9307,978763,482612,496151,26514,26475,39,,,19/1/2022 7:23
29/9/2021,Loei,42,2993,638822,320038,318784,13785,13770,15,,,19/1/2022 7:23
29/9/2021,Phrae,14,1580,435288,209765,225523,11993,11993,0,40,19,19/1/2022 7:23
29/9/2021,Mae Hong Son,12,674,285937,144838,141099,11764,11539,225, ,2,19/1/2022 7:23
29/9/2021,,0,153,,,,,,,,,19/1/2022 7:23
30/9/2021,Krabi,176,4364,478854,237878,240976,4086,3912,174,,,19/1/2022 7:23
30/9/2021,Bangkok,1634,395043,5538629,2598539,2940090,448391,422787,25604,79,28,19/1/2022 7:23
30/9/2021,Kanchanaburi,170,17500,894044,448524,445520,190781,190728,53,55,27,19/1/2022 7:23
30/9/2021,Kalasin,25,7664,976025,482401,493624,4757,4757,0,,,19/1/2022 7:23
30/9/2021,Kamphaeng Phet,10,6973,712444,351736,360708,7679,7679,0,,,19/1/2022 7:23
30/9/2021,Khon Kaen,190,14585,1791794,880418,911376,36884,36884,0,77,37,19/1/2022 7:23
30/9/2021,Chanthaburi,263,11382,536411,262228,274183,24937,24842,95,,,19/1/2022 7:23
30/9/2021,Chachoengsao,146,31913,723178,354451,368727,7480,7480,0,72,29,19/1/2022 7:23
30/9/2021,Chon Buri,725,89875,1581618,771595,810023,119870,119059,811,64,33,19/1/2022 7:23
30/9/2021,Chai Nat,2,2305,320948,154287,166661,11052,11052,0,,,19/1/2022 7:23
30/9/2021,Chaiyaphum,55,10478,1122539,554554,567985,16842,16813,29,,,19/1/2022 7:23
30/9/2021,Chumphon,132,8985,509344,251379,257965,2620,2620,0,,,19/1/2022 7:23
30/9/2021,Trang,76,5715,639876,312767,327109,5191,5191,0,,,19/1/2022 7:23
30/9/2021,Trat,91,4911,228450,112952,115498,33159,33006,153,,,19/1/2022 7:23
30/9/2021,Tak,166,15905,675112,341344,333768,18741,18741,0,,,19/1/2022 7:23
30/9/2021,Nakhon Nayok,78,9755,260238,128796,131442,6150,6150,0,,,19/1/2022 7:23
30/9/2021,Nakhon Pathom,85,32421,921861,442674,479187,17076,17058,18,67,21,19/1/2022 7:23
30/9/2021,Nakhon Phanom,8,4787,717043,357140,359903,9839,9839,0,,,19/1/2022 7:23
30/9/2021,Nakhon Ratchasima,92,25077,2634005,1293977,1340028,158830,157909,921,60,31,19/1/2022 7:23
30/9/2021,Nakhon Si Thammarat,458,15727,1549321,764443,784878,9361,9361,0,,,19/1/2022 7:23
30/9/2021,Nakhon Sawan,129,11168,1036053,505240,530813,18756,18756,0,73,37,19/1/2022 7:23
30/9/2021,Nonthaburi,155,61754,1285994,598164,687830,13326,13275,51,52,10,19/1/2022 7:23
30/9/2021,Narathiwat,618,24345,808908,400179,408729,945,945,0,39,13,19/1/2022 7:23
30/9/2021,Nan,0,2361,475915,238017,237898,21353,21281,72,,,19/1/2022 7:23
30/9/2021,Bueng Kan,2,1785,421910,211455,210455,2662,2662,0,,,19/1/2022 7:23
30/9/2021,Buri Ram,36,15672,1579547,783516,796031,22217,22141,76,,,19/1/2022 7:23
30/9/2021,Pathum Thani,54,38245,1186767,562265,624502,10969,10893,76,79,38,19/1/2022 7:23
30/9/2021,Prachuap Khiri Khan,99,10988,553460,274610,278850,78909,78814,95,,,19/1/2022 7:23
30/9/2021,Prachin Buri,240,15880,494821,244371,250450,7010,7010,0,70,35,19/1/2022 7:23
30/9/2021,Pattani,176,21742,728989,360071,368918,1410,1410,0,,,19/1/2022 7:23
30/9/2021,Phra Nakhon Si Ayutthaya,148,27485,820211,393877,426334,63382,63260,122,47,38,19/1/2022 7:23
30/9/2021,Phayao,0,1717,465194,226350,238844,12520,12407,113,42,18,19/1/2022 7:23
30/9/2021,Phang-nga,57,2536,268130,133856,134274,11169,9671,1498,,,19/1/2022 7:23
30/9/2021,Phatthalung,90,4378,522511,254483,268028,1958,1958,0,,,19/1/2022 7:23
30/9/2021,Phichit,17,4196,530097,258414,271683,7058,7058,0,,,19/1/2022 7:23
30/9/2021,Phitsanulok,52,4792,847460,414773,432687,33623,33466,157,,,19/1/2022 7:23
30/9/2021,Phuket,190,11156,419217,198181,221036,85481,60028,25453,42,20,19/1/2022 7:23
30/9/2021,Maha Sarakham,43,9629,949461,465434,484027,4086,4086,0,,,19/1/2022 7:23
30/9/2021,Mukdahan,10,2055,351274,175455,175819,17246,17246,0,,,19/1/2022 7:23
30/9/2021,Yala,563,22943,541791,269774,272017,710,710,0,33,18,19/1/2022 7:23
30/9/2021,Yasothon,5,5526,533435,266108,267327,3724,3724,0,,,19/1/2022 7:23
30/9/2021,Ranong,53,8850,194674,98251,96423,2582,2582,0,,,19/1/2022 7:23
30/9/2021,Rayong,380,32195,749481,368005,381476,24688,24442,246,68,30,19/1/2022 7:23
30/9/2021,Ratchaburi,342,29954,868959,422400,446559,30897,30897,0,,,19/1/2022 7:23
30/9/2021,Roi Et,30,12923,1296274,642169,654105,3672,3672,0,,,19/1/2022 7:23
30/9/2021,Lop Buri,86,14512,740199,368985,371214,24082,24044,38,,,19/1/2022 7:23
30/9/2021,Lampang,7,2233,725923,353601,372322,9312,9210,102,61,21,19/1/2022 7:23
30/9/2021,Lamphun,33,2134,401450,192935,208515,8920,8828,92,,,19/1/2022 7:23
30/9/2021,Si Sa Ket,44,14848,1456968,725147,731821,15417,15417,0,,,19/1/2022 7:23
30/9/2021,Sakon Nakhon,6,7113,1146233,569519,576714,10521,10521,0,,,19/1/2022 7:23
30/9/2021,Songkhla,567,31517,1431271,697260,734011,1827,1827,0,56,27,19/1/2022 7:23
30/9/2021,Satun,43,2196,324578,161454,163124,1995,1995,0,47,26,19/1/2022 7:23
30/9/2021,Samut Prakarn,771,112138,1355935,645831,710104,12413,12329,84,,,19/1/2022 7:23
30/9/2021,Samut Songkhram,56,10282,191160,91278,99882,31388,31388,0,41,10,19/1/2022 7:23
30/9/2021,Samut Sakhon,444,106458,585760,282297,303463,7943,7943,0,83,39,19/1/2022 7:23
30/9/2021,Saraburi,217,26573,644131,316501,327630,30780,30737,43,72,66,19/1/2022 7:23
30/9/2021,Sa kaeo,196,13594,561572,280341,281231,4108,4108,0,52,18,19/1/2022 7:23
30/9/2021,Sing Buri,10,2647,204996,97383,107613,9410,9410,0,,,19/1/2022 7:23
30/9/2021,Suphan Buri,56,12633,835999,403285,432714,30584,30584,0,,,19/1/2022 7:23
30/9/2021,Surat Thani,233,12241,1072025,527245,544780,4772,3619,1153,83,25,19/1/2022 7:23
30/9/2021,Surin,44,14981,1376610,684728,691882,9296,9269,27,,,19/1/2022 7:23
30/9/2021,Sukhothai,27,5538,585695,283594,302101,6514,6514,0,,,19/1/2022 7:23
30/9/2021,Nong Khai,5,3169,516903,256356,260547,11497,11490,7,20,9,19/1/2022 7:23
30/9/2021,Nong Bua Lam Phu,7,3755,508929,253795,255134,1880,1880,0,,,19/1/2022 7:23
30/9/2021,Amnat Charoen,8,2785,376291,187148,189143,2964,2964,0,,,19/1/2022 7:23
30/9/2021,Udon Thani,123,17892,1566740,775793,790947,11621,11611,10,,,19/1/2022 7:23
30/9/2021,Uttaradit,10,3890,446754,217769,228985,7108,7108,0,,,19/1/2022 7:23
30/9/2021,Uthai Thani,25,3359,325202,158940,166262,2630,2630,0,,,19/1/2022 7:23
30/9/2021,Ubon Ratchathani,177,16893,1867421,932017,935404,25612,25612,0,74,31,19/1/2022 7:23
30/9/2021,Ang Thong,18,10450,275337,131732,143605,5978,5978,0,,,19/1/2022 7:23
30/9/2021,Chiang Rai,33,3713,1297567,630638,666929,52280,52001,279,39,13,19/1/2022 7:23
30/9/2021,Chiang Mai,85,12868,1787951,863847,924104,149552,148477,1075,58,27,19/1/2022 7:23
30/9/2021,Phetchaburi,115,18587,482635,232935,249700,88893,88804,89,,,19/1/2022 7:23
30/9/2021,Phetchabun,61,9368,978763,482612,496151,26514,26475,39,,,19/1/2022 7:23
30/9/2021,Loei,21,3014,638822,320038,318784,13785,13770,15,,,19/1/2022 7:23
30/9/2021,Phrae,16,1596,435288,209765,225523,11993,11993,0,48,19,19/1/2022 7:23
30/9/2021,Mae Hong Son,30,704,285937,144838,141099,11764,11539,225,10,4,19/1/2022 7:23
30/9/2021,,0,153,,,,,,,,,19/1/2022 7:23
1/10/2021,Krabi,103,4467,479040,237966,241074,6644,6408,236,,,19/1/2022 7:23
1/10/2021,Bangkok,1434,396477,5534354,2596396,2937958,535508,483200,52308,58,24,19/1/2022 7:23
1/10/2021,Kanchanaburi,177,17677,894097,448418,445679,467938,467816,122,51,13,19/1/2022 7:23
1/10/2021,Kalasin,14,7678,975928,482318,493610,31863,31863,0,,,19/1/2022 7:23
1/10/2021,Kamphaeng Phet,15,6988,712417,351684,360733,10935,10935,0,,,19/1/2022 7:23
1/10/2021,Khon Kaen,177,14762,1791477,880238,911239,78172,78172,0,74,32,19/1/2022 7:23
1/10/2021,Chanthaburi,270,11652,536488,262258,274230,49181,49069,112,,,19/1/2022 7:23
1/10/2021,Chachoengsao,126,32039,723575,354550,369025,192208,192208,0,52,30,19/1/2022 7:23
1/10/2021,Chon Buri,821,90696,1582463,771883,810580,224103,223216,887,57,32,19/1/2022 7:23
1/10/2021,Chai Nat,0,2305,320853,154238,166615,25249,25249,0,,,19/1/2022 7:23
1/10/2021,Chaiyaphum,41,10519,1122445,554477,567968,24350,24317,33,,,19/1/2022 7:23
1/10/2021,Chumphon,160,9145,509477,251470,258007,7560,7560,0,,,19/1/2022 7:23
1/10/2021,Trang,99,5814,639979,312812,327167,7387,7387,0,,,19/1/2022 7:23
1/10/2021,Trat,98,5009,228426,112944,115482,51815,51639,176,,,19/1/2022 7:23
1/10/2021,Tak,245,16150,675561,341512,334049,23928,23928,0,,,19/1/2022 7:23
1/10/2021,Nakhon Nayok,53,9808,260324,128842,131482,21362,21362,0,,,19/1/2022 7:23
1/10/2021,Nakhon Pathom,83,32504,922078,442736,479342,37242,37188,54,45,20,19/1/2022 7:23
1/10/2021,Nakhon Phanom,5,4792,717013,357096,359917,22046,22046,0,,,19/1/2022 7:23
1/10/2021,Nakhon Ratchasima,168,25245,2634213,1294009,1340204,236917,235237,1680,63,27,19/1/2022 7:23
1/10/2021,Nakhon Si Thammarat,378,16105,1549297,764402,784895,10942,10942,0,,,19/1/2022 7:23
1/10/2021,Nakhon Sawan,117,11285,1035673,505014,530659,28921,28763,158,71,25,19/1/2022 7:23
1/10/2021,Nonthaburi,184,61938,1286596,598356,688240,32482,32370,112,49,8,19/1/2022 7:23
1/10/2021,Narathiwat,518,24863,809130,400257,408873,1549,1549,0,27,16,19/1/2022 7:23
1/10/2021,Nan,3,2364,475962,238027,237935,57643,57453,190,,,19/1/2022 7:23
1/10/2021,Bueng Kan,1,1786,421923,211450,210473,7313,7296,17,,,19/1/2022 7:23
1/10/2021,Buri Ram,24,15696,1579696,783590,796106,48708,48574,134,,,19/1/2022 7:23
1/10/2021,Pathum Thani,121,38366,1187933,562786,625147,26324,26147,177,67,27,19/1/2022 7:23
1/10/2021,Prachuap Khiri Khan,139,11127,553609,274647,278962,262017,261857,160,,,19/1/2022 7:23
1/10/2021,Prachin Buri,353,16233,495017,244513,250504,17246,17246,0,66,37,19/1/2022 7:23
1/10/2021,Pattani,409,22151,729218,360169,369049,1157,1157,0,,,19/1/2022 7:23
1/10/2021,Phra Nakhon Si Ayutthaya,140,27625,820377,393914,426463,161519,160956,563,68,36,19/1/2022 7:23
1/10/2021,Phayao,2,1719,465061,226262,238799,21386,21386,0,43,17,19/1/2022 7:23
1/10/2021,Phang-nga,75,2611,268081,133851,134230,28887,21873,7014,,,19/1/2022 7:23
1/10/2021,Phatthalung,170,4548,522590,254511,268079,3107,3107,0,,,19/1/2022 7:23
1/10/2021,Phichit,12,4208,529974,258338,271636,11935,11935,0,,,19/1/2022 7:23
1/10/2021,Phitsanulok,84,4876,847418,414640,432778,52678,52480,198,,,19/1/2022 7:23
1/10/2021,Phuket,221,11377,419194,198106,221088,91363,64142,27221,50,22,19/1/2022 7:23
1/10/2021,Maha Sarakham,37,9666,949130,465310,483820,12910,12885,25,,,19/1/2022 7:23
1/10/2021,Mukdahan,20,2075,351338,175540,175798,38043,38043,0,,,19/1/2022 7:23
1/10/2021,Yala,525,23468,542002,269804,272198,1327,1327,0,34,24,19/1/2022 7:23
1/10/2021,Yasothon,13,5539,533454,266097,267357,6476,6476,0,,,19/1/2022 7:23
1/10/2021,Ranong,41,8891,194681,98240,96441,5367,5367,0,,,19/1/2022 7:23
1/10/2021,Rayong,472,32667,750107,368398,381709,51424,51159,265,54,19,19/1/2022 7:23
1/10/2021,Ratchaburi,224,30178,868830,422350,446480,88889,88772,117,,,19/1/2022 7:23
1/10/2021,Roi Et,20,12943,1296284,642133,654151,17276,17276,0,,,19/1/2022 7:23
1/10/2021,Lop Buri,82,14594,739712,368713,370999,47834,47796,38,,,19/1/2022 7:23
1/10/2021,Lampang,23,2256,725564,353383,372181,28742,28577,165,63,18,19/1/2022 7:23
1/10/2021,Lamphun,39,2173,401381,192875,208506,18167,18018,149,,,19/1/2022 7:23
1/10/2021,Si Sa Ket,149,14997,1457005,725113,731892,29110,29110,0,,,19/1/2022 7:23
1/10/2021,Sakon Nakhon,22,7135,1146320,569525,576795,37911,37911,0,,,19/1/2022 7:23
1/10/2021,Songkhla,451,31968,1431655,697409,734246,9362,9358,4,54,31,19/1/2022 7:23
1/10/2021,Satun,45,2241,324638,161492,163146,4965,4960,5,48,36,19/1/2022 7:23
1/10/2021,Samut Prakarn,861,112999,1356083,645776,710307,30524,30346,178,,,19/1/2022 7:23
1/10/2021,Samut Songkhram,43,10325,191082,91247,99835,44761,44761,0,24,11,19/1/2022 7:23
1/10/2021,Samut Sakhon,202,106660,586194,282490,303704,20981,20981,0,65,31,19/1/2022 7:23
1/10/2021,Saraburi,157,26730,644040,316399,327641,62770,62680,90,80,60,19/1/2022 7:23
1/10/2021,Sa kaeo,326,13920,561690,280406,281284,11217,10519,698,38,16,19/1/2022 7:23
1/10/2021,Sing Buri,14,2661,204869,97319,107550,15147,15124,23,,,19/1/2022 7:23
1/10/2021,Suphan Buri,74,12707,835825,403209,432616,112708,112708,0,,,19/1/2022 7:23
1/10/2021,Surat Thani,193,12434,1072403,527376,545027,9650,6323,3327, ,29,19/1/2022 7:23
1/10/2021,Surin,41,15022,1376625,684726,691899,19225,19203,22,,,19/1/2022 7:23
1/10/2021,Sukhothai,26,5564,585595,283519,302076,18172,17814,358,,,19/1/2022 7:23
1/10/2021,Nong Khai,4,3173,516972,256377,260595,29617,29500,117,23,10,19/1/2022 7:23
1/10/2021,Nong Bua Lam Phu,1,3756,508984,253786,255198,3417,3402,15,,,19/1/2022 7:23
1/10/2021,Amnat Charoen,0,2785,376306,187145,189161,4821,4821,0,,,19/1/2022 7:23
1/10/2021,Udon Thani,114,18006,1566668,775641,791027,44698,44548,150,,,19/1/2022 7:23
1/10/2021,Uttaradit,10,3900,446617,217679,228938,16832,16832,0,,,19/1/2022 7:23
1/10/2021,Uthai Thani,16,3375,325234,158965,166269,4910,4910,0,,,19/1/2022 7:23
1/10/2021,Ubon Ratchathani,114,17007,1867597,932041,935556,60742,60742,0,72,18,19/1/2022 7:23
1/10/2021,Ang Thong,56,10506,275167,131646,143521,15302,15302,0,,,19/1/2022 7:23
1/10/2021,Chiang Rai,35,3748,1298092,630910,667182,116319,115525,794,34,14,19/1/2022 7:23
1/10/2021,Chiang Mai,64,12932,1788340,863999,924341,214715,212787,1928,57,26,19/1/2022 7:23
1/10/2021,Phetchaburi,122,18709,482659,232915,249744,301889,301778,111,,,19/1/2022 7:23
1/10/2021,Phetchabun,36,9404,978584,482468,496116,84525,84467,58,,,19/1/2022 7:23
1/10/2021,Loei,10,3024,638788,319998,318790,83583,83511,72,,,19/1/2022 7:23
1/10/2021,Phrae,4,1600,435038,209644,225394,19532,19532,0,45,20,19/1/2022 7:23
1/10/2021,Mae Hong Son,8,712,285804,144781,141023,33309,33043,266,17,4,19/1/2022 7:23
1/10/2021,,20,173,,,,,,,,,19/1/2022 7:23
2/10/2021,Krabi,139,4606,479040,237966,241074,6644,6408,236,,,19/1/2022 7:23
2/10/2021,Bangkok,1251,397728,5534354,2596396,2937958,535508,483200,52308,57,36,19/1/2022 7:23
2/10/2021,Kanchanaburi,126,17803,894097,448418,445679,467938,467816,122,31,12,19/1/2022 7:23
2/10/2021,Kalasin,25,7703,975928,482318,493610,31863,31863,0,,,19/1/2022 7:23
2/10/2021,Kamphaeng Phet,16,7004,712417,351684,360733,10935,10935,0,,,19/1/2022 7:23
2/10/2021,Khon Kaen,193,14955,1791477,880238,911239,78172,78172,0,72,27,19/1/2022 7:23
2/10/2021,Chanthaburi,265,11917,536488,262258,274230,49181,49069,112,,,19/1/2022 7:23
2/10/2021,Chachoengsao,178,32217,723575,354550,369025,192208,192208,0,49,30,19/1/2022 7:23
2/10/2021,Chon Buri,638,91334,1582463,771883,810580,224103,223216,887,47,27,19/1/2022 7:23
2/10/2021,Chai Nat,3,2308,320853,154238,166615,25249,25249,0,,,19/1/2022 7:23
2/10/2021,Chaiyaphum,122,10641,1122445,554477,567968,24350,24317,33,,,19/1/2022 7:23
2/10/2021,Chumphon,164,9309,509477,251470,258007,7560,7560,0,,,19/1/2022 7:23
2/10/2021,Trang,88,5902,639979,312812,327167,7387,7387,0,,,19/1/2022 7:23
2/10/2021,Trat,109,5118,228426,112944,115482,51815,51639,176,,,19/1/2022 7:23
2/10/2021,Tak,219,16369,675561,341512,334049,23928,23928,0,,,19/1/2022 7:23
2/10/2021,Nakhon Nayok,49,9857,260324,128842,131482,21362,21362,0,,,19/1/2022 7:23
2/10/2021,Nakhon Pathom,74,32578,922078,442736,479342,37242,37188,54,46,25,19/1/2022 7:23
2/10/2021,Nakhon Phanom,9,4801,717013,357096,359917,22046,22046,0,,,19/1/2022 7:23
2/10/2021,Nakhon Ratchasima,250,25495,2634213,1294009,1340204,236917,235237,1680,61,26,19/1/2022 7:23
2/10/2021,Nakhon Si Thammarat,526,16631,1549297,764402,784895,10942,10942,0,,,19/1/2022 7:23
2/10/2021,Nakhon Sawan,98,11383,1035673,505014,530659,28921,28763,158,47,22,19/1/2022 7:23
2/10/2021,Nonthaburi,183,62121,1286596,598356,688240,32482,32370,112,34,10,19/1/2022 7:23
2/10/2021,Narathiwat,496,25359,809130,400257,408873,1549,1549,0,36,15,19/1/2022 7:23
2/10/2021,Nan,0,2364,475962,238027,237935,57643,57453,190,,,19/1/2022 7:23
2/10/2021,Bueng Kan,2,1788,421923,211450,210473,7313,7296,17,,,19/1/2022 7:23
2/10/2021,Buri Ram,30,15726,1579696,783590,796106,48708,48574,134,,,19/1/2022 7:23
2/10/2021,Pathum Thani,106,38472,1187933,562786,625147,26324,26147,177,59,22,19/1/2022 7:23
2/10/2021,Prachuap Khiri Khan,201,11328,553609,274647,278962,262017,261857,160,,,19/1/2022 7:23
2/10/2021,Prachin Buri,349,16582,495017,244513,250504,17246,17246,0,68,32,19/1/2022 7:23
2/10/2021,Pattani,311,22462,729218,360169,369049,1157,1157,0,,,19/1/2022 7:23
2/10/2021,Phra Nakhon Si Ayutthaya,154,27779,820377,393914,426463,161519,160956,563,52,34,19/1/2022 7:23
2/10/2021,Phayao,0,1719,465061,226262,238799,21386,21386,0,38,15,19/1/2022 7:23
2/10/2021,Phang-nga,61,2672,268081,133851,134230,28887,21873,7014,,,19/1/2022 7:23
2/10/2021,Phatthalung,60,4608,522590,254511,268079,3107,3107,0,,,19/1/2022 7:23
2/10/2021,Phichit,13,4221,529974,258338,271636,11935,11935,0,,,19/1/2022 7:23
2/10/2021,Phitsanulok,45,4921,847418,414640,432778,52678,52480,198,,,19/1/2022 7:23
2/10/2021,Phuket,248,11625,419194,198106,221088,91363,64142,27221,54,22,19/1/2022 7:23
2/10/2021,Maha Sarakham,61,9727,949130,465310,483820,12910,12885,25,,,19/1/2022 7:23
2/10/2021,Mukdahan,4,2079,351338,175540,175798,38043,38043,0,,,19/1/2022 7:23
2/10/2021,Yala,739,24207,542002,269804,272198,1327,1327,0,44,25,19/1/2022 7:23
2/10/2021,Yasothon,14,5553,533454,266097,267357,6476,6476,0,,,19/1/2022 7:23
2/10/2021,Ranong,44,8935,194681,98240,96441,5367,5367,0,,,19/1/2022 7:23
2/10/2021,Rayong,451,33118,750107,368398,381709,51424,51159,265,31,24,19/1/2022 7:23
2/10/2021,Ratchaburi,242,30420,868830,422350,446480,88889,88772,117,,,19/1/2022 7:23
2/10/2021,Roi Et,24,12967,1296284,642133,654151,17276,17276,0,,,19/1/2022 7:23
2/10/2021,Lop Buri,74,14668,739712,368713,370999,47834,47796,38,,,19/1/2022 7:23
2/10/2021,Lampang,11,2267,725564,353383,372181,28742,28577,165,54,16,19/1/2022 7:23
2/10/2021,Lamphun,43,2216,401381,192875,208506,18167,18018,149,,,19/1/2022 7:23
2/10/2021,Si Sa Ket,24,15021,1457005,725113,731892,29110,29110,0,,,19/1/2022 7:23
2/10/2021,Sakon Nakhon,25,7160,1146320,569525,576795,37911,37911,0,,,19/1/2022 7:23
2/10/2021,Songkhla,434,32402,1431655,697409,734246,9362,9358,4,60,34,19/1/2022 7:23
2/10/2021,Satun,43,2284,324638,161492,163146,4965,4960,5,59,34,19/1/2022 7:23
2/10/2021,Samut Prakarn,646,113645,1356083,645776,710307,30524,30346,178,,,19/1/2022 7:23
2/10/2021,Samut Songkhram,64,10389,191082,91247,99835,44761,44761,0,30,14,19/1/2022 7:23
2/10/2021,Samut Sakhon,151,106811,586194,282490,303704,20981,20981,0,60,31,19/1/2022 7:23
2/10/2021,Saraburi,172,26902,644040,316399,327641,62770,62680,90,69,71,19/1/2022 7:23
2/10/2021,Sa kaeo,94,14014,561690,280406,281284,11217,10519,698,35,18,19/1/2022 7:23
2/10/2021,Sing Buri,8,2669,204869,97319,107550,15147,15124,23,,,19/1/2022 7:23
2/10/2021,Suphan Buri,101,12808,835825,403209,432616,112708,112708,0,,,19/1/2022 7:23
2/10/2021,Surat Thani,251,12685,1072403,527376,545027,9650,6323,3327,84,29,19/1/2022 7:23
2/10/2021,Surin,39,15061,1376625,684726,691899,19225,19203,22,,,19/1/2022 7:23
2/10/2021,Sukhothai,17,5581,585595,283519,302076,18172,17814,358,,,19/1/2022 7:23
2/10/2021,Nong Khai,39,3212,516972,256377,260595,29617,29500,117,23,12,19/1/2022 7:23
2/10/2021,Nong Bua Lam Phu,16,3772,508984,253786,255198,3417,3402,15,,,19/1/2022 7:23
2/10/2021,Amnat Charoen,7,2792,376306,187145,189161,4821,4821,0,,,19/1/2022 7:23
2/10/2021,Udon Thani,226,18232,1566668,775641,791027,44698,44548,150,,,19/1/2022 7:23
2/10/2021,Uttaradit,12,3912,446617,217679,228938,16832,16832,0,,,19/1/2022 7:23
2/10/2021,Uthai Thani,14,3389,325234,158965,166269,4910,4910,0,,,19/1/2022 7:23
2/10/2021,Ubon Ratchathani,172,17179,1867597,932041,935556,60742,60742,0,46,26,19/1/2022 7:23
2/10/2021,Ang Thong,39,10545,275167,131646,143521,15302,15302,0,,,19/1/2022 7:23
2/10/2021,Chiang Rai,30,3778,1298092,630910,667182,116319,115525,794,39,12,19/1/2022 7:23
2/10/2021,Chiang Mai,73,13005,1788340,863999,924341,214715,212787,1928,52,23,19/1/2022 7:23
2/10/2021,Phetchaburi,99,18808,482659,232915,249744,301889,301778,111,,,19/1/2022 7:23
2/10/2021,Phetchabun,34,9438,978584,482468,496116,84525,84467,58,,,19/1/2022 7:23
2/10/2021,Loei,12,3036,638788,319998,318790,83583,83511,72,,,19/1/2022 7:23
2/10/2021,Phrae,0,1600,435038,209644,225394,19532,19532,0,36,19,19/1/2022 7:23
2/10/2021,Mae Hong Son,26,738,285804,144781,141023,33309,33043,266,16,3,19/1/2022 7:23
2/10/2021,,0,173,,,,,,,,,19/1/2022 7:23
3/10/2021,Krabi,100,4706,479040,237966,241074,6644,6408,236,,,19/1/2022 7:23
3/10/2021,Bangkok,1221,398949,5534354,2596396,2937958,535508,483200,52308,72,33,19/1/2022 7:23
3/10/2021,Kanchanaburi,131,17934,894097,448418,445679,467938,467816,122,26,15,19/1/2022 7:23
3/10/2021,Kalasin,33,7736,975928,482318,493610,31863,31863,0,,,19/1/2022 7:23
3/10/2021,Kamphaeng Phet,28,7032,712417,351684,360733,10935,10935,0,,,19/1/2022 7:23
3/10/2021,Khon Kaen,176,15131,1791477,880238,911239,78172,78172,0,62,36,19/1/2022 7:23
3/10/2021,Chanthaburi,264,12181,536488,262258,274230,49181,49069,112,,,19/1/2022 7:23
3/10/2021,Chachoengsao,149,32366,723575,354550,369025,192208,192208,0,61,31,19/1/2022 7:23
3/10/2021,Chon Buri,643,91977,1582463,771883,810580,224103,223216,887,56,33,19/1/2022 7:23
3/10/2021,Chai Nat,1,2309,320853,154238,166615,25249,25249,0,,,19/1/2022 7:23
3/10/2021,Chaiyaphum,46,10687,1122445,554477,567968,24350,24317,33,,,19/1/2022 7:23
3/10/2021,Chumphon,143,9452,509477,251470,258007,7560,7560,0,,,19/1/2022 7:23
3/10/2021,Trang,68,5970,639979,312812,327167,7387,7387,0,,,19/1/2022 7:23
3/10/2021,Trat,82,5200,228426,112944,115482,51815,51639,176,,,19/1/2022 7:23
3/10/2021,Tak,119,16488,675561,341512,334049,23928,23928,0,,,19/1/2022 7:23
3/10/2021,Nakhon Nayok,57,9914,260324,128842,131482,21362,21362,0,,,19/1/2022 7:23
3/10/2021,Nakhon Pathom,98,32676,922078,442736,479342,37242,37188,54,52,25,19/1/2022 7:23
3/10/2021,Nakhon Phanom,6,4807,717013,357096,359917,22046,22046,0,,,19/1/2022 7:23
3/10/2021,Nakhon Ratchasima,288,25783,2634213,1294009,1340204,236917,235237,1680,60,29,19/1/2022 7:23
3/10/2021,Nakhon Si Thammarat,378,17009,1549297,764402,784895,10942,10942,0,,,19/1/2022 7:23
3/10/2021,Nakhon Sawan,97,11480,1035673,505014,530659,28921,28763,158,47,27,19/1/2022 7:23
3/10/2021,Nonthaburi,180,62301,1286596,598356,688240,32482,32370,112,39,14,19/1/2022 7:23
3/10/2021,Narathiwat,442,25801,809130,400257,408873,1549,1549,0,35,25,19/1/2022 7:23
3/10/2021,Nan,0,2364,475962,238027,237935,57643,57453,190,,,19/1/2022 7:23
3/10/2021,Bueng Kan,0,1788,421923,211450,210473,7313,7296,17,,,19/1/2022 7:23
3/10/2021,Buri Ram,32,15758,1579696,783590,796106,48708,48574,134,,,19/1/2022 7:23
3/10/2021,Pathum Thani,117,38589,1187933,562786,625147,26324,26147,177,51,28,19/1/2022 7:23
3/10/2021,Prachuap Khiri Khan,94,11422,553609,274647,278962,262017,261857,160,,,19/1/2022 7:23
3/10/2021,Prachin Buri,362,16944,495017,244513,250504,17246,17246,0,60,37,19/1/2022 7:23
3/10/2021,Pattani,412,22874,729218,360169,369049,1157,1157,0,,,19/1/2022 7:23
3/10/2021,Phra Nakhon Si Ayutthaya,128,27907,820377,393914,426463,161519,160956,563,37,40,19/1/2022 7:23
3/10/2021,Phayao,3,1722,465061,226262,238799,21386,21386,0,38,20,19/1/2022 7:23
3/10/2021,Phang-nga,46,2718,268081,133851,134230,28887,21873,7014,,,19/1/2022 7:23
3/10/2021,Phatthalung,47,4655,522590,254511,268079,3107,3107,0,,,19/1/2022 7:23
3/10/2021,Phichit,12,4233,529974,258338,271636,11935,11935,0,,,19/1/2022 7:23
3/10/2021,Phitsanulok,26,4947,847418,414640,432778,52678,52480,198,,,19/1/2022 7:23
3/10/2021,Phuket,181,11806,419194,198106,221088,91363,64142,27221,49,20,19/1/2022 7:23
3/10/2021,Maha Sarakham,35,9762,949130,465310,483820,12910,12885,25,,,19/1/2022 7:23
3/10/2021,Mukdahan,17,2096,351338,175540,175798,38043,38043,0,,,19/1/2022 7:23
3/10/2021,Yala,783,24990,542002,269804,272198,1327,1327,0,54,25,19/1/2022 7:23
3/10/2021,Yasothon,8,5561,533454,266097,267357,6476,6476,0,,,19/1/2022 7:23
3/10/2021,Ranong,43,8978,194681,98240,96441,5367,5367,0,,,19/1/2022 7:23
3/10/2021,Rayong,533,33651,750107,368398,381709,51424,51159,265,53,32,19/1/2022 7:23
3/10/2021,Ratchaburi,253,30673,868830,422350,446480,88889,88772,117,,,19/1/2022 7:23
3/10/2021,Roi Et,18,12985,1296284,642133,654151,17276,17276,0,,,19/1/2022 7:23
3/10/2021,Lop Buri,91,14759,739712,368713,370999,47834,47796,38,,,19/1/2022 7:23
3/10/2021,Lampang,18,2285,725564,353383,372181,28742,28577,165,49,20,19/1/2022 7:23
3/10/2021,Lamphun,9,2225,401381,192875,208506,18167,18018,149,,,19/1/2022 7:23
3/10/2021,Si Sa Ket,26,15047,1457005,725113,731892,29110,29110,0,,,19/1/2022 7:23
3/10/2021,Sakon Nakhon,21,7181,1146320,569525,576795,37911,37911,0,,,19/1/2022 7:23
3/10/2021,Songkhla,353,32755,1431655,697409,734246,9362,9358,4,67,32,19/1/2022 7:23
3/10/2021,Satun,52,2336,324638,161492,163146,4965,4960,5,54,32,19/1/2022 7:23
3/10/2021,Samut Prakarn,796,114441,1356083,645776,710307,30524,30346,178,,,19/1/2022 7:23
3/10/2021,Samut Songkhram,48,10437,191082,91247,99835,44761,44761,0,31,20,19/1/2022 7:23
3/10/2021,Samut Sakhon,144,106955,586194,282490,303704,20981,20981,0,57,34,19/1/2022 7:23
3/10/2021,Saraburi,191,27093,644040,316399,327641,62770,62680,90,59,72,19/1/2022 7:23
3/10/2021,Sa kaeo,111,14125,561690,280406,281284,11217,10519,698,34,21,19/1/2022 7:23
3/10/2021,Sing Buri,16,2685,204869,97319,107550,15147,15124,23,,,19/1/2022 7:23
3/10/2021,Suphan Buri,52,12860,835825,403209,432616,112708,112708,0,,,19/1/2022 7:23
3/10/2021,Surat Thani,195,12880,1072403,527376,545027,9650,6323,3327,73,29,19/1/2022 7:23
3/10/2021,Surin,65,15126,1376625,684726,691899,19225,19203,22,,,19/1/2022 7:23
3/10/2021,Sukhothai,14,5595,585595,283519,302076,18172,17814,358,,,19/1/2022 7:23
3/10/2021,Nong Khai,8,3220,516972,256377,260595,29617,29500,117,30,13,19/1/2022 7:23
3/10/2021,Nong Bua Lam Phu,27,3799,508984,253786,255198,3417,3402,15,,,19/1/2022 7:23
3/10/2021,Amnat Charoen,5,2797,376306,187145,189161,4821,4821,0,,,19/1/2022 7:23
3/10/2021,Udon Thani,208,18440,1566668,775641,791027,44698,44548,150,,,19/1/2022 7:23
3/10/2021,Uttaradit,9,3921,446617,217679,228938,16832,16832,0,,,19/1/2022 7:23
3/10/2021,Uthai Thani,13,3402,325234,158965,166269,4910,4910,0,,,19/1/2022 7:23
3/10/2021,Ubon Ratchathani,177,17356,1867597,932041,935556,60742,60742,0,60,24,19/1/2022 7:23
3/10/2021,Ang Thong,30,10575,275167,131646,143521,15302,15302,0,,,19/1/2022 7:23
3/10/2021,Chiang Rai,13,3791,1298092,630910,667182,116319,115525,794,33,15,19/1/2022 7:23
3/10/2021,Chiang Mai,88,13093,1788340,863999,924341,214715,212787,1928,51,26,19/1/2022 7:23
3/10/2021,Phetchaburi,82,18890,482659,232915,249744,301889,301778,111,,,19/1/2022 7:23
3/10/2021,Phetchabun,38,9476,978584,482468,496116,84525,84467,58,,,19/1/2022 7:23
3/10/2021,Loei,10,3046,638788,319998,318790,83583,83511,72,,,19/1/2022 7:23
3/10/2021,Phrae,4,1604,435038,209644,225394,19532,19532,0,49,24,19/1/2022 7:23
3/10/2021,Mae Hong Son,14,752,285804,144781,141023,33309,33043,266,13,5,19/1/2022 7:23
3/10/2021,,0,173,,,,,,,,,19/1/2022 7:23
4/10/2021,Krabi,122,4828,479040,237966,241074,6644,6408,236,,,19/1/2022 7:23
4/10/2021,Bangkok,1144,400093,5534354,2596396,2937958,535508,483200,52308,73,43,19/1/2022 7:23
4/10/2021,Kanchanaburi,139,18073,894097,448418,445679,467938,467816,122,29,27,19/1/2022 7:23
4/10/2021,Kalasin,4,7740,975928,482318,493610,31863,31863,0,,,19/1/2022 7:23
4/10/2021,Kamphaeng Phet,49,7081,712417,351684,360733,10935,10935,0,,,19/1/2022 7:23
4/10/2021,Khon Kaen,160,15291,1791477,880238,911239,78172,78172,0,74,37,19/1/2022 7:23
4/10/2021,Chanthaburi,259,12440,536488,262258,274230,49181,49069,112,,,19/1/2022 7:23
4/10/2021,Chachoengsao,71,32437,723575,354550,369025,192208,192208,0,51,35,19/1/2022 7:23
4/10/2021,Chon Buri,594,92571,1582463,771883,810580,224103,223216,887,50, ,19/1/2022 7:23
4/10/2021,Chai Nat,1,2310,320853,154238,166615,25249,25249,0,,,19/1/2022 7:23
4/10/2021,Chaiyaphum,58,10745,1122445,554477,567968,24350,24317,33,,,19/1/2022 7:23
4/10/2021,Chumphon,136,9588,509477,251470,258007,7560,7560,0,,,19/1/2022 7:23
4/10/2021,Trang,99,6069,639979,312812,327167,7387,7387,0,,,19/1/2022 7:23
4/10/2021,Trat,48,5248,228426,112944,115482,51815,51639,176,,,19/1/2022 7:23
4/10/2021,Tak,170,16658,675561,341512,334049,23928,23928,0,,,19/1/2022 7:23
4/10/2021,Nakhon Nayok,12,9926,260324,128842,131482,21362,21362,0,,,19/1/2022 7:23
4/10/2021,Nakhon Pathom,109,32785,922078,442736,479342,37242,37188,54,53,37,19/1/2022 7:23
4/10/2021,Nakhon Phanom,6,4813,717013,357096,359917,22046,22046,0,,,19/1/2022 7:23
4/10/2021,Nakhon Ratchasima,111,25894,2634213,1294009,1340204,236917,235237,1680,68,29,19/1/2022 7:23
4/10/2021,Nakhon Si Thammarat,314,17323,1549297,764402,784895,10942,10942,0,,,19/1/2022 7:23
4/10/2021,Nakhon Sawan,102,11582,1035673,505014,530659,28921,28763,158,51,25,19/1/2022 7:23
4/10/2021,Nonthaburi,198,62499,1286596,598356,688240,32482,32370,112,50,18,19/1/2022 7:23
4/10/2021,Narathiwat,315,26116,809130,400257,408873,1549,1549,0,56,11,19/1/2022 7:23
4/10/2021,Nan,0,2364,475962,238027,237935,57643,57453,190,,,19/1/2022 7:23
4/10/2021,Bueng Kan,6,1794,421923,211450,210473,7313,7296,17,,,19/1/2022 7:23
4/10/2021,Buri Ram,33,15791,1579696,783590,796106,48708,48574,134,,,19/1/2022 7:23
4/10/2021,Pathum Thani,50,38639,1187933,562786,625147,26324,26147,177,52,36,19/1/2022 7:23
4/10/2021,Prachuap Khiri Khan,79,11501,553609,274647,278962,262017,261857,160,,,19/1/2022 7:23
4/10/2021,Prachin Buri,270,17214,495017,244513,250504,17246,17246,0,63,38,19/1/2022 7:23
4/10/2021,Pattani,406,23280,729218,360169,369049,1157,1157,0,,,19/1/2022 7:23
4/10/2021,Phra Nakhon Si Ayutthaya,90,27997,820377,393914,426463,161519,160956,563,53,45,19/1/2022 7:23
4/10/2021,Phayao,3,1725,465061,226262,238799,21386,21386,0,49,20,19/1/2022 7:23
4/10/2021,Phang-nga,58,2776,268081,133851,134230,28887,21873,7014,,,19/1/2022 7:23
4/10/2021,Phatthalung,440,5095,522590,254511,268079,3107,3107,0,,,19/1/2022 7:23
4/10/2021,Phichit,15,4248,529974,258338,271636,11935,11935,0,,,19/1/2022 7:23
4/10/2021,Phitsanulok,19,4966,847418,414640,432778,52678,52480,198,,,19/1/2022 7:23
4/10/2021,Phuket,180,11986,419194,198106,221088,91363,64142,27221,49,21,19/1/2022 7:23
4/10/2021,Maha Sarakham,38,9800,949130,465310,483820,12910,12885,25,,,19/1/2022 7:23
4/10/2021,Mukdahan,24,2120,351338,175540,175798,38043,38043,0,,,19/1/2022 7:23
4/10/2021,Yala,764,25754,542002,269804,272198,1327,1327,0,55,15,19/1/2022 7:23
4/10/2021,Yasothon,5,5566,533454,266097,267357,6476,6476,0,,,19/1/2022 7:23
4/10/2021,Ranong,31,9009,194681,98240,96441,5367,5367,0,,,19/1/2022 7:23
4/10/2021,Rayong,297,33948,750107,368398,381709,51424,51159,265,67,32,19/1/2022 7:23
4/10/2021,Ratchaburi,300,30973,868830,422350,446480,88889,88772,117,,,19/1/2022 7:23
4/10/2021,Roi Et,17,13002,1296284,642133,654151,17276,17276,0,,,19/1/2022 7:23
4/10/2021,Lop Buri,92,14851,739712,368713,370999,47834,47796,38,,,19/1/2022 7:23
4/10/2021,Lampang,9,2294,725564,353383,372181,28742,28577,165,59,19,19/1/2022 7:23
4/10/2021,Lamphun,28,2253,401381,192875,208506,18167,18018,149,,,19/1/2022 7:23
4/10/2021,Si Sa Ket,26,15073,1457005,725113,731892,29110,29110,0,,,19/1/2022 7:23
4/10/2021,Sakon Nakhon,27,7208,1146320,569525,576795,37911,37911,0,,,19/1/2022 7:23
4/10/2021,Songkhla,485,33240,1431655,697409,734246,9362,9358,4,64,38,19/1/2022 7:23
4/10/2021,Satun,41,2377,324638,161492,163146,4965,4960,5,62,21,19/1/2022 7:23
4/10/2021,Samut Prakarn,386,114827,1356083,645776,710307,30524,30346,178,,,19/1/2022 7:23
4/10/2021,Samut Songkhram,35,10472,191082,91247,99835,44761,44761,0,44,28,19/1/2022 7:23
4/10/2021,Samut Sakhon,145,107100,586194,282490,303704,20981,20981,0,60,47,19/1/2022 7:23
4/10/2021,Saraburi,197,27290,644040,316399,327641,62770,62680,90,73,75,19/1/2022 7:23
4/10/2021,Sa kaeo,77,14202,561690,280406,281284,11217,10519,698,44,21,19/1/2022 7:23
4/10/2021,Sing Buri,8,2693,204869,97319,107550,15147,15124,23,,,19/1/2022 7:23
4/10/2021,Suphan Buri,54,12914,835825,403209,432616,112708,112708,0,,,19/1/2022 7:23
4/10/2021,Surat Thani,227,13107,1072403,527376,545027,9650,6323,3327,63,26,19/1/2022 7:23
4/10/2021,Surin,60,15186,1376625,684726,691899,19225,19203,22,,,19/1/2022 7:23
4/10/2021,Sukhothai,7,5602,585595,283519,302076,18172,17814,358,,,19/1/2022 7:23
4/10/2021,Nong Khai,17,3237,516972,256377,260595,29617,29500,117,31,15,19/1/2022 7:23
4/10/2021,Nong Bua Lam Phu,29,3828,508984,253786,255198,3417,3402,15,,,19/1/2022 7:23
4/10/2021,Amnat Charoen,0,2797,376306,187145,189161,4821,4821,0,,,19/1/2022 7:23
4/10/2021,Udon Thani,217,18657,1566668,775641,791027,44698,44548,150,,,19/1/2022 7:23
4/10/2021,Uttaradit,8,3929,446617,217679,228938,16832,16832,0,,,19/1/2022 7:23
4/10/2021,Uthai Thani,3,3405,325234,158965,166269,4910,4910,0,,,19/1/2022 7:23
4/10/2021,Ubon Ratchathani,92,17448,1867597,932041,935556,60742,60742,0,55,15,19/1/2022 7:23
4/10/2021,Ang Thong,42,10617,275167,131646,143521,15302,15302,0,,,19/1/2022 7:23
4/10/2021,Chiang Rai,18,3809,1298092,630910,667182,116319,115525,794,43,19,19/1/2022 7:23
4/10/2021,Chiang Mai,94,13187,1788340,863999,924341,214715,212787,1928,55,27,19/1/2022 7:23
4/10/2021,Phetchaburi,80,18970,482659,232915,249744,301889,301778,111,,,19/1/2022 7:23
4/10/2021,Phetchabun,40,9516,978584,482468,496116,84525,84467,58,,,19/1/2022 7:23
4/10/2021,Loei,18,3064,638788,319998,318790,83583,83511,72,,,19/1/2022 7:23
4/10/2021,Phrae,2,1606,435038,209644,225394,19532,19532,0,57,18,19/1/2022 7:23
4/10/2021,Mae Hong Son,20,772,285804,144781,141023,33309,33043,266,24,11,19/1/2022 7:23
4/10/2021,,0,173,,,,,,,,,19/1/2022 7:23
5/10/2021,Krabi,159,4987,479040,237966,241074,6644,6408,236,,,19/1/2022 7:23
5/10/2021,Bangkok,1330,401423,5534354,2596396,2937958,535508,483200,52308,83,26,19/1/2022 7:23
5/10/2021,Kanchanaburi,166,18239,894097,448418,445679,467938,467816,122,44,10,19/1/2022 7:23
5/10/2021,Kalasin,28,7768,975928,482318,493610,31863,31863,0,,,19/1/2022 7:23
5/10/2021,Kamphaeng Phet,18,7099,712417,351684,360733,10935,10935,0,,,19/1/2022 7:23
5/10/2021,Khon Kaen,110,15401,1791477,880238,911239,78172,78172,0,73,31,19/1/2022 7:23
5/10/2021,Chanthaburi,174,12614,536488,262258,274230,49181,49069,112,,,19/1/2022 7:23
5/10/2021,Chachoengsao,97,32534,723575,354550,369025,192208,192208,0,65,29,19/1/2022 7:23
5/10/2021,Chon Buri,562,93133,1582463,771883,810580,224103,223216,887, ,52,19/1/2022 7:23
5/10/2021,Chai Nat,6,2316,320853,154238,166615,25249,25249,0,,,19/1/2022 7:23
5/10/2021,Chaiyaphum,12,10757,1122445,554477,567968,24350,24317,33,,,19/1/2022 7:23
5/10/2021,Chumphon,149,9737,509477,251470,258007,7560,7560,0,,,19/1/2022 7:23
5/10/2021,Trang,95,6164,639979,312812,327167,7387,7387,0,,,19/1/2022 7:23
5/10/2021,Trat,87,5335,228426,112944,115482,51815,51639,176,,,19/1/2022 7:23
5/10/2021,Tak,229,16887,675561,341512,334049,23928,23928,0,,,19/1/2022 7:23
5/10/2021,Nakhon Nayok,15,9941,260324,128842,131482,21362,21362,0,,,19/1/2022 7:23
5/10/2021,Nakhon Pathom,107,32892,922078,442736,479342,37242,37188,54,74,15,19/1/2022 7:23
5/10/2021,Nakhon Phanom,2,4815,717013,357096,359917,22046,22046,0,,,19/1/2022 7:23
5/10/2021,Nakhon Ratchasima,131,26025,2634213,1294009,1340204,236917,235237,1680,59,18,19/1/2022 7:23
5/10/2021,Nakhon Si Thammarat,457,17780,1549297,764402,784895,10942,10942,0,,,19/1/2022 7:23
5/10/2021,Nakhon Sawan,86,11668,1035673,505014,530659,28921,28763,158,47,23,19/1/2022 7:23
5/10/2021,Nonthaburi,159,62658,1286596,598356,688240,32482,32370,112,51,19,19/1/2022 7:23
5/10/2021,Narathiwat,461,26577,809130,400257,408873,1549,1549,0,25,12,19/1/2022 7:23
5/10/2021,Nan,0,2364,475962,238027,237935,57643,57453,190,,,19/1/2022 7:23
5/10/2021,Bueng Kan,3,1797,421923,211450,210473,7313,7296,17,,,19/1/2022 7:23
5/10/2021,Buri Ram,55,15846,1579696,783590,796106,48708,48574,134,,,19/1/2022 7:23
5/10/2021,Pathum Thani,41,38680,1187933,562786,625147,26324,26147,177,66,17,19/1/2022 7:23
5/10/2021,Prachuap Khiri Khan,78,11579,553609,274647,278962,262017,261857,160,,,19/1/2022 7:23
5/10/2021,Prachin Buri,179,17393,495017,244513,250504,17246,17246,0,64,29,19/1/2022 7:23
5/10/2021,Pattani,532,23812,729218,360169,369049,1157,1157,0,,,19/1/2022 7:23
5/10/2021,Phra Nakhon Si Ayutthaya,127,28124,820377,393914,426463,161519,160956,563,56,30,19/1/2022 7:23
5/10/2021,Phayao,1,1726,465061,226262,238799,21386,21386,0,55,23,19/1/2022 7:23
5/10/2021,Phang-nga,69,2845,268081,133851,134230,28887,21873,7014,,,19/1/2022 7:23
5/10/2021,Phatthalung,74,5169,522590,254511,268079,3107,3107,0,,,19/1/2022 7:23
5/10/2021,Phichit,4,4252,529974,258338,271636,11935,11935,0,,,19/1/2022 7:23
5/10/2021,Phitsanulok,28,4994,847418,414640,432778,52678,52480,198,,,19/1/2022 7:23
5/10/2021,Phuket,177,12163,419194,198106,221088,91363,64142,27221,48,21,19/1/2022 7:23
5/10/2021,Maha Sarakham,57,9857,949130,465310,483820,12910,12885,25,,,19/1/2022 7:23
5/10/2021,Mukdahan,6,2126,351338,175540,175798,38043,38043,0,,,19/1/2022 7:23
5/10/2021,Yala,431,26185,542002,269804,272198,1327,1327,0,33,15,19/1/2022 7:23
5/10/2021,Yasothon,5,5571,533454,266097,267357,6476,6476,0,,,19/1/2022 7:23
5/10/2021,Ranong,18,9027,194681,98240,96441,5367,5367,0,,,19/1/2022 7:23
5/10/2021,Rayong,318,34266,750107,368398,381709,51424,51159,265,82,23,19/1/2022 7:23
5/10/2021,Ratchaburi,258,31231,868830,422350,446480,88889,88772,117,,,19/1/2022 7:23
5/10/2021,Roi Et,2,13004,1296284,642133,654151,17276,17276,0,,,19/1/2022 7:23
5/10/2021,Lop Buri,65,14916,739712,368713,370999,47834,47796,38,,,19/1/2022 7:23
5/10/2021,Lampang,6,2300,725564,353383,372181,28742,28577,165,58,19,19/1/2022 7:23
5/10/2021,Lamphun,18,2271,401381,192875,208506,18167,18018,149,,,19/1/2022 7:23
5/10/2021,Si Sa Ket,67,15140,1457005,725113,731892,29110,29110,0,,,19/1/2022 7:23
5/10/2021,Sakon Nakhon,67,7275,1146320,569525,576795,37911,37911,0,,,19/1/2022 7:23
5/10/2021,Songkhla,468,33708,1431655,697409,734246,9362,9358,4,69,27,19/1/2022 7:23
5/10/2021,Satun,40,2417,324638,161492,163146,4965,4960,5,39,28,19/1/2022 7:23
5/10/2021,Samut Prakarn,593,115420,1356083,645776,710307,30524,30346,178,,,19/1/2022 7:23
5/10/2021,Samut Songkhram,49,10521,191082,91247,99835,44761,44761,0,59,13,19/1/2022 7:23
5/10/2021,Samut Sakhon,357,107457,586194,282490,303704,20981,20981,0,82,24,19/1/2022 7:23
5/10/2021,Saraburi,112,27402,644040,316399,327641,62770,62680,90,75,58,19/1/2022 7:23
5/10/2021,Sa kaeo,111,14313,561690,280406,281284,11217,10519,698,40,10,19/1/2022 7:23
5/10/2021,Sing Buri,5,2698,204869,97319,107550,15147,15124,23,,,19/1/2022 7:23
5/10/2021,Suphan Buri,58,12972,835825,403209,432616,112708,112708,0,,,19/1/2022 7:23
5/10/2021,Surat Thani,161,13268,1072403,527376,545027,9650,6323,3327,72,29,19/1/2022 7:23
5/10/2021,Surin,61,15247,1376625,684726,691899,19225,19203,22,,,19/1/2022 7:23
5/10/2021,Sukhothai,8,5610,585595,283519,302076,18172,17814,358,,,19/1/2022 7:23
5/10/2021,Nong Khai,4,3241,516972,256377,260595,29617,29500,117,37,14,19/1/2022 7:23
5/10/2021,Nong Bua Lam Phu,15,3843,508984,253786,255198,3417,3402,15,,,19/1/2022 7:23
5/10/2021,Amnat Charoen,8,2805,376306,187145,189161,4821,4821,0,,,19/1/2022 7:23
5/10/2021,Udon Thani,173,18830,1566668,775641,791027,44698,44548,150,,,19/1/2022 7:23
5/10/2021,Uttaradit,10,3939,446617,217679,228938,16832,16832,0,,,19/1/2022 7:23
5/10/2021,Uthai Thani,8,3413,325234,158965,166269,4910,4910,0,,,19/1/2022 7:23
5/10/2021,Ubon Ratchathani,65,17513,1867597,932041,935556,60742,60742,0,28,16,19/1/2022 7:23
5/10/2021,Ang Thong,24,10641,275167,131646,143521,15302,15302,0,,,19/1/2022 7:23
5/10/2021,Chiang Rai,20,3829,1298092,630910,667182,116319,115525,794,55,18,19/1/2022 7:23
5/10/2021,Chiang Mai,64,13251,1788340,863999,924341,214715,212787,1928,59,27,19/1/2022 7:23
5/10/2021,Phetchaburi,48,19018,482659,232915,249744,301889,301778,111,,,19/1/2022 7:23
5/10/2021,Phetchabun,43,9559,978584,482468,496116,84525,84467,58,,,19/1/2022 7:23
5/10/2021,Loei,26,3090,638788,319998,318790,83583,83511,72,,,19/1/2022 7:23
5/10/2021,Phrae,3,1609,435038,209644,225394,19532,19532,0,45,21,19/1/2022 7:23
5/10/2021,Mae Hong Son,9,781,285804,144781,141023,33309,33043,266,46,10,19/1/2022 7:23
5/10/2021,,0,173,,,,,,,,,19/1/2022 7:23
6/10/2021,Krabi,52,5039,479040,237966,241074,6644,6408,236,,,19/1/2022 7:23
6/10/2021,Bangkok,1213,402636,5534354,2596396,2937958,535508,483200,52308,64,34,19/1/2022 7:23
6/10/2021,Kanchanaburi,112,18351,894097,448418,445679,467938,467816,122,22,13,19/1/2022 7:23
6/10/2021,Kalasin,41,7809,975928,482318,493610,31863,31863,0,,,19/1/2022 7:23
6/10/2021,Kamphaeng Phet,31,7130,712417,351684,360733,10935,10935,0,,,19/1/2022 7:23
6/10/2021,Khon Kaen,141,15542,1791477,880238,911239,78172,78172,0,58,38,19/1/2022 7:23
6/10/2021,Chanthaburi,245,12859,536488,262258,274230,49181,49069,112,,,19/1/2022 7:23
6/10/2021,Chachoengsao,172,32706,723575,354550,369025,192208,192208,0,56,35,19/1/2022 7:23
6/10/2021,Chon Buri,606,93739,1582463,771883,810580,224103,223216,887,75,29,19/1/2022 7:23
6/10/2021,Chai Nat,5,2321,320853,154238,166615,25249,25249,0,,,19/1/2022 7:23
6/10/2021,Chaiyaphum,11,10768,1122445,554477,567968,24350,24317,33,,,19/1/2022 7:23
6/10/2021,Chumphon,150,9887,509477,251470,258007,7560,7560,0,,,19/1/2022 7:23
6/10/2021,Trang,64,6228,639979,312812,327167,7387,7387,0,,,19/1/2022 7:23
6/10/2021,Trat,120,5455,228426,112944,115482,51815,51639,176,,,19/1/2022 7:23
6/10/2021,Tak,199,17086,675561,341512,334049,23928,23928,0,,,19/1/2022 7:23
6/10/2021,Nakhon Nayok,51,9992,260324,128842,131482,21362,21362,0,,,19/1/2022 7:23
6/10/2021,Nakhon Pathom,71,32963,922078,442736,479342,37242,37188,54,35,19,19/1/2022 7:23
6/10/2021,Nakhon Phanom,5,4820,717013,357096,359917,22046,22046,0,,,19/1/2022 7:23
6/10/2021,Nakhon Ratchasima,127,26152,2634213,1294009,1340204,236917,235237,1680,46,26,19/1/2022 7:23
6/10/2021,Nakhon Si Thammarat,259,18039,1549297,764402,784895,10942,10942,0,,,19/1/2022 7:23
6/10/2021,Nakhon Sawan,150,11818,1035673,505014,530659,28921,28763,158,46,18,19/1/2022 7:23
6/10/2021,Nonthaburi,151,62809,1286596,598356,688240,32482,32370,112,30,23,19/1/2022 7:23
6/10/2021,Narathiwat,513,27090,809130,400257,408873,1549,1549,0,26,12,19/1/2022 7:23
6/10/2021,Nan,1,2365,475962,238027,237935,57643,57453,190,,,19/1/2022 7:23
6/10/2021,Bueng Kan,15,1812,421923,211450,210473,7313,7296,17,,,19/1/2022 7:23
6/10/2021,Buri Ram,46,15892,1579696,783590,796106,48708,48574,134,,,19/1/2022 7:23
6/10/2021,Pathum Thani,65,38745,1187933,562786,625147,26324,26147,177,44,26,19/1/2022 7:23
6/10/2021,Prachuap Khiri Khan,125,11704,553609,274647,278962,262017,261857,160,,,19/1/2022 7:23
6/10/2021,Prachin Buri,313,17706,495017,244513,250504,17246,17246,0,55,33,19/1/2022 7:23
6/10/2021,Pattani,309,24121,729218,360169,369049,1157,1157,0,,,19/1/2022 7:23
6/10/2021,Phra Nakhon Si Ayutthaya,52,28176,820377,393914,426463,161519,160956,563,29,35,19/1/2022 7:23
6/10/2021,Phayao,1,1727,465061,226262,238799,21386,21386,0,48,17,19/1/2022 7:23
6/10/2021,Phang-nga,94,2939,268081,133851,134230,28887,21873,7014,,,19/1/2022 7:23
6/10/2021,Phatthalung,118,5287,522590,254511,268079,3107,3107,0,,,19/1/2022 7:23
6/10/2021,Phichit,23,4275,529974,258338,271636,11935,11935,0,,,19/1/2022 7:23
6/10/2021,Phitsanulok,36,5030,847418,414640,432778,52678,52480,198,,,19/1/2022 7:23
6/10/2021,Phuket,179,12342,419194,198106,221088,91363,64142,27221,50,25,19/1/2022 7:23
6/10/2021,Maha Sarakham,51,9908,949130,465310,483820,12910,12885,25,,,19/1/2022 7:23
6/10/2021,Mukdahan,9,2135,351338,175540,175798,38043,38043,0,,,19/1/2022 7:23
6/10/2021,Yala,447,26632,542002,269804,272198,1327,1327,0,35,15,19/1/2022 7:23
6/10/2021,Yasothon,3,5574,533454,266097,267357,6476,6476,0,,,19/1/2022 7:23
6/10/2021,Ranong,21,9048,194681,98240,96441,5367,5367,0,,,19/1/2022 7:23
6/10/2021,Rayong,379,34645,750107,368398,381709,51424,51159,265,56,24,19/1/2022 7:23
6/10/2021,Ratchaburi,253,31484,868830,422350,446480,88889,88772,117,,,19/1/2022 7:23
6/10/2021,Roi Et,8,13012,1296284,642133,654151,17276,17276,0,,,19/1/2022 7:23
6/10/2021,Lop Buri,56,14972,739712,368713,370999,47834,47796,38,,,19/1/2022 7:23
6/10/2021,Lampang,16,2316,725564,353383,372181,28742,28577,165,58,16,19/1/2022 7:23
6/10/2021,Lamphun,27,2298,401381,192875,208506,18167,18018,149,,,19/1/2022 7:23
6/10/2021,Si Sa Ket,28,15168,1457005,725113,731892,29110,29110,0,,,19/1/2022 7:23
6/10/2021,Sakon Nakhon,20,7295,1146320,569525,576795,37911,37911,0,,,19/1/2022 7:23
6/10/2021,Songkhla,666,34374,1431655,697409,734246,9362,9358,4,53,24,19/1/2022 7:23
6/10/2021,Satun,22,2439,324638,161492,163146,4965,4960,5,52,24,19/1/2022 7:23
6/10/2021,Samut Prakarn,629,116049,1356083,645776,710307,30524,30346,178,,,19/1/2022 7:23
6/10/2021,Samut Songkhram,23,10544,191082,91247,99835,44761,44761,0,29,16,19/1/2022 7:23
6/10/2021,Samut Sakhon,121,107578,586194,282490,303704,20981,20981,0,47,35,19/1/2022 7:23
6/10/2021,Saraburi,140,27542,644040,316399,327641,62770,62680,90,53,71,19/1/2022 7:23
6/10/2021,Sa kaeo,93,14406,561690,280406,281284,11217,10519,698,16,18,19/1/2022 7:23
6/10/2021,Sing Buri,9,2707,204869,97319,107550,15147,15124,23,,,19/1/2022 7:23
6/10/2021,Suphan Buri,43,13015,835825,403209,432616,112708,112708,0,,,19/1/2022 7:23
6/10/2021,Surat Thani,225,13493,1072403,527376,545027,9650,6323,3327,60,23,19/1/2022 7:23
6/10/2021,Surin,56,15303,1376625,684726,691899,19225,19203,22,,,19/1/2022 7:23
6/10/2021,Sukhothai,19,5629,585595,283519,302076,18172,17814,358,,,19/1/2022 7:23
6/10/2021,Nong Khai,14,3255,516972,256377,260595,29617,29500,117,35,12,19/1/2022 7:23
6/10/2021,Nong Bua Lam Phu,12,3855,508984,253786,255198,3417,3402,15,,,19/1/2022 7:23
6/10/2021,Amnat Charoen,1,2806,376306,187145,189161,4821,4821,0,,,19/1/2022 7:23
6/10/2021,Udon Thani,196,19026,1566668,775641,791027,44698,44548,150,,,19/1/2022 7:23
6/10/2021,Uttaradit,7,3946,446617,217679,228938,16832,16832,0,,,19/1/2022 7:23
6/10/2021,Uthai Thani,11,3424,325234,158965,166269,4910,4910,0,,,19/1/2022 7:23
6/10/2021,Ubon Ratchathani,102,17615,1867597,932041,935556,60742,60742,0,31,25,19/1/2022 7:23
6/10/2021,Ang Thong,10,10651,275167,131646,143521,15302,15302,0,,,19/1/2022 7:23
6/10/2021,Chiang Rai,19,3848,1298092,630910,667182,116319,115525,794,51,20,19/1/2022 7:23
6/10/2021,Chiang Mai,83,13334,1788340,863999,924341,214715,212787,1928,57,27,19/1/2022 7:23
6/10/2021,Phetchaburi,129,19147,482659,232915,249744,301889,301778,111,,,19/1/2022 7:23
6/10/2021,Phetchabun,26,9585,978584,482468,496116,84525,84467,58,,,19/1/2022 7:23
6/10/2021,Loei,8,3098,638788,319998,318790,83583,83511,72,,,19/1/2022 7:23
6/10/2021,Phrae,7,1616,435038,209644,225394,19532,19532,0,46,17,19/1/2022 7:23
6/10/2021,Mae Hong Son,11,792,285804,144781,141023,33309,33043,266,44,14,19/1/2022 7:23
6/10/2021,,0,173,,,,,,,,,19/1/2022 7:23
7/10/2021,Krabi,54,5093,479040,237966,241074,6644,6408,236,,,19/1/2022 7:23
7/10/2021,Bangkok,1291,403927,5534354,2596396,2937958,535508,483200,52308,69,51,19/1/2022 7:23
7/10/2021,Kanchanaburi,154,18505,894097,448418,445679,467938,467816,122,27,14,19/1/2022 7:23
7/10/2021,Kalasin,75,7884,975928,482318,493610,31863,31863,0,,,19/1/2022 7:23
7/10/2021,Kamphaeng Phet,36,7166,712417,351684,360733,10935,10935,0,,,19/1/2022 7:23
7/10/2021,Khon Kaen,115,15657,1791477,880238,911239,78172,78172,0,68,40,19/1/2022 7:23
7/10/2021,Chanthaburi,450,13309,536488,262258,274230,49181,49069,112,,,19/1/2022 7:23
7/10/2021,Chachoengsao,141,32847,723575,354550,369025,192208,192208,0,52,37,19/1/2022 7:23
7/10/2021,Chon Buri,754,94493,1582463,771883,810580,224103,223216,887,43,32,19/1/2022 7:23
7/10/2021,Chai Nat,3,2324,320853,154238,166615,25249,25249,0,,,19/1/2022 7:23
7/10/2021,Chaiyaphum,28,10796,1122445,554477,567968,24350,24317,33,,,19/1/2022 7:23
7/10/2021,Chumphon,154,10041,509477,251470,258007,7560,7560,0,,,19/1/2022 7:23
7/10/2021,Trang,99,6327,639979,312812,327167,7387,7387,0,,,19/1/2022 7:23
7/10/2021,Trat,108,5563,228426,112944,115482,51815,51639,176,,,19/1/2022 7:23
7/10/2021,Tak,236,17322,675561,341512,334049,23928,23928,0,,,19/1/2022 7:23
7/10/2021,Nakhon Nayok,48,10040,260324,128842,131482,21362,21362,0,,,19/1/2022 7:23
7/10/2021,Nakhon Pathom,113,33076,922078,442736,479342,37242,37188,54,57,28,19/1/2022 7:23
7/10/2021,Nakhon Phanom,5,4825,717013,357096,359917,22046,22046,0,,,19/1/2022 7:23
7/10/2021,Nakhon Ratchasima,253,26405,2634213,1294009,1340204,236917,235237,1680,57,35,19/1/2022 7:23
7/10/2021,Nakhon Si Thammarat,313,18352,1549297,764402,784895,10942,10942,0,,,19/1/2022 7:23
7/10/2021,Nakhon Sawan,162,11980,1035673,505014,530659,28921,28763,158,31,24,19/1/2022 7:23
7/10/2021,Nonthaburi,155,62964,1286596,598356,688240,32482,32370,112,43,28,19/1/2022 7:23
7/10/2021,Narathiwat,332,27422,809130,400257,408873,1549,1549,0,28,17,19/1/2022 7:23
7/10/2021,Nan,0,2365,475962,238027,237935,57643,57453,190,,,19/1/2022 7:23
7/10/2021,Bueng Kan,4,1816,421923,211450,210473,7313,7296,17,,,19/1/2022 7:23
7/10/2021,Buri Ram,61,15953,1579696,783590,796106,48708,48574,134,,,19/1/2022 7:23
7/10/2021,Pathum Thani,82,38827,1187933,562786,625147,26324,26147,177,50,48,19/1/2022 7:23
7/10/2021,Prachuap Khiri Khan,127,11831,553609,274647,278962,262017,261857,160,,,19/1/2022 7:23
7/10/2021,Prachin Buri,330,18036,495017,244513,250504,17246,17246,0,58,42,19/1/2022 7:23
7/10/2021,Pattani,281,24402,729218,360169,369049,1157,1157,0,,,19/1/2022 7:23
7/10/2021,Phra Nakhon Si Ayutthaya,90,28266,820377,393914,426463,161519,160956,563,36,47,19/1/2022 7:23
7/10/2021,Phayao,5,1732,465061,226262,238799,21386,21386,0,39,27,19/1/2022 7:23
7/10/2021,Phang-nga,96,3035,268081,133851,134230,28887,21873,7014,,,19/1/2022 7:23
7/10/2021,Phatthalung,63,5350,522590,254511,268079,3107,3107,0,,,19/1/2022 7:23
7/10/2021,Phichit,15,4290,529974,258338,271636,11935,11935,0,,,19/1/2022 7:23
7/10/2021,Phitsanulok,41,5071,847418,414640,432778,52678,52480,198,,,19/1/2022 7:23
7/10/2021,Phuket,120,12462,419194,198106,221088,91363,64142,27221,55,23,19/1/2022 7:23
7/10/2021,Maha Sarakham,89,9997,949130,465310,483820,12910,12885,25,,,19/1/2022 7:23
7/10/2021,Mukdahan,7,2142,351338,175540,175798,38043,38043,0,,,19/1/2022 7:23
7/10/2021,Yala,741,27373,542002,269804,272198,1327,1327,0,35,19,19/1/2022 7:23
7/10/2021,Yasothon,1,5575,533454,266097,267357,6476,6476,0,,,19/1/2022 7:23
7/10/2021,Ranong,36,9084,194681,98240,96441,5367,5367,0,,,19/1/2022 7:23
7/10/2021,Rayong,400,35045,750107,368398,381709,51424,51159,265,56,29,19/1/2022 7:23
7/10/2021,Ratchaburi,244,31728,868830,422350,446480,88889,88772,117,,,19/1/2022 7:23
7/10/2021,Roi Et,26,13038,1296284,642133,654151,17276,17276,0,,,19/1/2022 7:23
7/10/2021,Lop Buri,82,15054,739712,368713,370999,47834,47796,38,,,19/1/2022 7:23
7/10/2021,Lampang,23,2339,725564,353383,372181,28742,28577,165,48,23,19/1/2022 7:23
7/10/2021,Lamphun,32,2330,401381,192875,208506,18167,18018,149,,,19/1/2022 7:23
7/10/2021,Si Sa Ket,27,15195,1457005,725113,731892,29110,29110,0,,,19/1/2022 7:23
7/10/2021,Sakon Nakhon,19,7314,1146320,569525,576795,37911,37911,0,,,19/1/2022 7:23
7/10/2021,Songkhla,608,34982,1431655,697409,734246,9362,9358,4,46,23,19/1/2022 7:23
7/10/2021,Satun,41,2480,324638,161492,163146,4965,4960,5,37,39,19/1/2022 7:23
7/10/2021,Samut Prakarn,838,116887,1356083,645776,710307,30524,30346,178,,,19/1/2022 7:23
7/10/2021,Samut Songkhram,23,10567,191082,91247,99835,44761,44761,0,41,21,19/1/2022 7:23
7/10/2021,Samut Sakhon,131,107709,586194,282490,303704,20981,20981,0,57,52,19/1/2022 7:23
7/10/2021,Saraburi,178,27720,644040,316399,327641,62770,62680,90,69,83,19/1/2022 7:23
7/10/2021,Sa kaeo,158,14564,561690,280406,281284,11217,10519,698,30,27,19/1/2022 7:23
7/10/2021,Sing Buri,5,2712,204869,97319,107550,15147,15124,23,,,19/1/2022 7:23
7/10/2021,Suphan Buri,56,13071,835825,403209,432616,112708,112708,0,,,19/1/2022 7:23
7/10/2021,Surat Thani,241,13734,1072403,527376,545027,9650,6323,3327,64,24,19/1/2022 7:23
7/10/2021,Surin,38,15341,1376625,684726,691899,19225,19203,22,,,19/1/2022 7:23
7/10/2021,Sukhothai,7,5636,585595,283519,302076,18172,17814,358,,,19/1/2022 7:23
7/10/2021,Nong Khai,8,3263,516972,256377,260595,29617,29500,117,29,11,19/1/2022 7:23
7/10/2021,Nong Bua Lam Phu,44,3899,508984,253786,255198,3417,3402,15,,,19/1/2022 7:23
7/10/2021,Amnat Charoen,5,2811,376306,187145,189161,4821,4821,0,,,19/1/2022 7:23
7/10/2021,Udon Thani,191,19217,1566668,775641,791027,44698,44548,150,,,19/1/2022 7:23
7/10/2021,Uttaradit,6,3952,446617,217679,228938,16832,16832,0,,,19/1/2022 7:23
7/10/2021,Uthai Thani,8,3432,325234,158965,166269,4910,4910,0,,,19/1/2022 7:23
7/10/2021,Ubon Ratchathani,50,17665,1867597,932041,935556,60742,60742,0,58,30,19/1/2022 7:23
7/10/2021,Ang Thong,37,10688,275167,131646,143521,15302,15302,0,,,19/1/2022 7:23
7/10/2021,Chiang Rai,25,3873,1298092,630910,667182,116319,115525,794,58,21,19/1/2022 7:23
7/10/2021,Chiang Mai,127,13461,1788340,863999,924341,214715,212787,1928,60,31,19/1/2022 7:23
7/10/2021,Phetchaburi,139,19286,482659,232915,249744,301889,301778,111,,,19/1/2022 7:23
7/10/2021,Phetchabun,38,9623,978584,482468,496116,84525,84467,58,,,19/1/2022 7:23
7/10/2021,Loei,22,3120,638788,319998,318790,83583,83511,72,,,19/1/2022 7:23
7/10/2021,Phrae,0,1616,435038,209644,225394,19532,19532,0,41,24,19/1/2022 7:23
7/10/2021,Mae Hong Son,55,847,285804,144781,141023,33309,33043,266,54,15,19/1/2022 7:23
7/10/2021,,0,173,,,,,,,,,19/1/2022 7:23
8/10/2021,Krabi,113,5206,479040,237966,241074,6644,6408,236,,,19/1/2022 7:23
8/10/2021,Bangkok,1261,405188,5534354,2596396,2937958,535508,483200,52308,100,25,19/1/2022 7:23
8/10/2021,Kanchanaburi,162,18667,894097,448418,445679,467938,467816,122,34,13,19/1/2022 7:23
8/10/2021,Kalasin,51,7935,975928,482318,493610,31863,31863,0,,,19/1/2022 7:23
8/10/2021,Kamphaeng Phet,11,7177,712417,351684,360733,10935,10935,0,,,19/1/2022 7:23
8/10/2021,Khon Kaen,186,15843,1791477,880238,911239,78172,78172,0,77,41,19/1/2022 7:23
8/10/2021,Chanthaburi,284,13593,536488,262258,274230,49181,49069,112,,,19/1/2022 7:23
8/10/2021,Chachoengsao,114,32961,723575,354550,369025,192208,192208,0,77,28,19/1/2022 7:23
8/10/2021,Chon Buri,696,95189,1582463,771883,810580,224103,223216,887,54,23,19/1/2022 7:23
8/10/2021,Chai Nat,1,2325,320853,154238,166615,25249,25249,0,,,19/1/2022 7:23
8/10/2021,Chaiyaphum,52,10848,1122445,554477,567968,24350,24317,33,,,19/1/2022 7:23
8/10/2021,Chumphon,146,10187,509477,251470,258007,7560,7560,0,,,19/1/2022 7:23
8/10/2021,Trang,98,6425,639979,312812,327167,7387,7387,0,,,19/1/2022 7:23
8/10/2021,Trat,95,5658,228426,112944,115482,51815,51639,176,,,19/1/2022 7:23
8/10/2021,Tak,232,17554,675561,341512,334049,23928,23928,0,,,19/1/2022 7:23
8/10/2021,Nakhon Nayok,57,10097,260324,128842,131482,21362,21362,0,,,19/1/2022 7:23
8/10/2021,Nakhon Pathom,129,33205,922078,442736,479342,37242,37188,54,66,20,19/1/2022 7:23
8/10/2021,Nakhon Phanom,2,4827,717013,357096,359917,22046,22046,0,,,19/1/2022 7:23
8/10/2021,Nakhon Ratchasima,140,26545,2634213,1294009,1340204,236917,235237,1680,73,35,19/1/2022 7:23
8/10/2021,Nakhon Si Thammarat,395,18747,1549297,764402,784895,10942,10942,0,,,19/1/2022 7:23
8/10/2021,Nakhon Sawan,108,12088,1035673,505014,530659,28921,28763,158,45,36,19/1/2022 7:23
8/10/2021,Nonthaburi,127,63091,1286596,598356,688240,32482,32370,112,67,42,19/1/2022 7:23
8/10/2021,Narathiwat,592,28014,809130,400257,408873,1549,1549,0,37,25,19/1/2022 7:23
8/10/2021,Nan,5,2370,475962,238027,237935,57643,57453,190,,,19/1/2022 7:23
8/10/2021,Bueng Kan,12,1828,421923,211450,210473,7313,7296,17,,,19/1/2022 7:23
8/10/2021,Buri Ram,22,15975,1579696,783590,796106,48708,48574,134,,,19/1/2022 7:23
8/10/2021,Pathum Thani,95,38922,1187933,562786,625147,26324,26147,177,90,36,19/1/2022 7:23
8/10/2021,Prachuap Khiri Khan,93,11924,553609,274647,278962,262017,261857,160,,,19/1/2022 7:23
8/10/2021,Prachin Buri,245,18281,495017,244513,250504,17246,17246,0,78,32,19/1/2022 7:23
8/10/2021,Pattani,504,24906,729218,360169,369049,1157,1157,0,,,19/1/2022 7:23
8/10/2021,Phra Nakhon Si Ayutthaya,145,28411,820377,393914,426463,161519,160956,563,68,38,19/1/2022 7:23
8/10/2021,Phayao,3,1735,465061,226262,238799,21386,21386,0,66,31,19/1/2022 7:23
8/10/2021,Phang-nga,37,3072,268081,133851,134230,28887,21873,7014,,,19/1/2022 7:23
8/10/2021,Phatthalung,107,5457,522590,254511,268079,3107,3107,0,,,19/1/2022 7:23
8/10/2021,Phichit,28,4318,529974,258338,271636,11935,11935,0,,,19/1/2022 7:23
8/10/2021,Phitsanulok,42,5113,847418,414640,432778,52678,52480,198,,,19/1/2022 7:23
8/10/2021,Phuket,172,12634,419194,198106,221088,91363,64142,27221,49,24,19/1/2022 7:23
8/10/2021,Maha Sarakham,57,10054,949130,465310,483820,12910,12885,25,,,19/1/2022 7:23
8/10/2021,Mukdahan,11,2153,351338,175540,175798,38043,38043,0,,,19/1/2022 7:23
8/10/2021,Yala,776,28149,542002,269804,272198,1327,1327,0,42,29,19/1/2022 7:23
8/10/2021,Yasothon,3,5578,533454,266097,267357,6476,6476,0,,,19/1/2022 7:23
8/10/2021,Ranong,30,9114,194681,98240,96441,5367,5367,0,,,19/1/2022 7:23
8/10/2021,Rayong,342,35387,750107,368398,381709,51424,51159,265,54,15,19/1/2022 7:23
8/10/2021,Ratchaburi,283,32011,868830,422350,446480,88889,88772,117,,,19/1/2022 7:23
8/10/2021,Roi Et,11,13049,1296284,642133,654151,17276,17276,0,,,19/1/2022 7:23
8/10/2021,Lop Buri,81,15135,739712,368713,370999,47834,47796,38,,,19/1/2022 7:23
8/10/2021,Lampang,18,2357,725564,353383,372181,28742,28577,165,70,24,19/1/2022 7:23
8/10/2021,Lamphun,23,2353,401381,192875,208506,18167,18018,149,,,19/1/2022 7:23
8/10/2021,Si Sa Ket,88,15283,1457005,725113,731892,29110,29110,0,,,19/1/2022 7:23
8/10/2021,Sakon Nakhon,28,7342,1146320,569525,576795,37911,37911,0,,,19/1/2022 7:23
8/10/2021,Songkhla,455,35437,1431655,697409,734246,9362,9358,4,43,30,19/1/2022 7:23
8/10/2021,Satun,50,2530,324638,161492,163146,4965,4960,5,58,28,19/1/2022 7:23
8/10/2021,Samut Prakarn,592,117479,1356083,645776,710307,30524,30346,178,,,19/1/2022 7:23
8/10/2021,Samut Songkhram,37,10604,191082,91247,99835,44761,44761,0,50,18,19/1/2022 7:23
8/10/2021,Samut Sakhon,233,107942,586194,282490,303704,20981,20981,0,85,40,19/1/2022 7:23
8/10/2021,Saraburi,186,27906,644040,316399,327641,62770,62680,90,89,67,19/1/2022 7:23
8/10/2021,Sa kaeo,113,14677,561690,280406,281284,11217,10519,698,49,16,19/1/2022 7:23
8/10/2021,Sing Buri,12,2724,204869,97319,107550,15147,15124,23,,,19/1/2022 7:23
8/10/2021,Suphan Buri,58,13129,835825,403209,432616,112708,112708,0,,,19/1/2022 7:23
8/10/2021,Surat Thani,243,13977,1072403,527376,545027,9650,6323,3327,64,24,19/1/2022 7:23
8/10/2021,Surin,68,15409,1376625,684726,691899,19225,19203,22,,,19/1/2022 7:23
8/10/2021,Sukhothai,12,5648,585595,283519,302076,18172,17814,358,,,19/1/2022 7:23
8/10/2021,Nong Khai,7,3270,516972,256377,260595,29617,29500,117,27,11,19/1/2022 7:23
8/10/2021,Nong Bua Lam Phu,24,3923,508984,253786,255198,3417,3402,15,,,19/1/2022 7:23
8/10/2021,Amnat Charoen,9,2820,376306,187145,189161,4821,4821,0,,,19/1/2022 7:23
8/10/2021,Udon Thani,198,19415,1566668,775641,791027,44698,44548,150,,,19/1/2022 7:23
8/10/2021,Uttaradit,3,3955,446617,217679,228938,16832,16832,0,,,19/1/2022 7:23
8/10/2021,Uthai Thani,9,3441,325234,158965,166269,4910,4910,0,,,19/1/2022 7:23
8/10/2021,Ubon Ratchathani,113,17778,1867597,932041,935556,60742,60742,0,62,27,19/1/2022 7:23
8/10/2021,Ang Thong,18,10706,275167,131646,143521,15302,15302,0,,,19/1/2022 7:23
8/10/2021,Chiang Rai,30,3903,1298092,630910,667182,116319,115525,794,62,28,19/1/2022 7:23
8/10/2021,Chiang Mai,89,13550,1788340,863999,924341,214715,212787,1928,65,38,19/1/2022 7:23
8/10/2021,Phetchaburi,145,19431,482659,232915,249744,301889,301778,111,,,19/1/2022 7:23
8/10/2021,Phetchabun,62,9685,978584,482468,496116,84525,84467,58,,,19/1/2022 7:23
8/10/2021,Loei,19,3139,638788,319998,318790,83583,83511,72,,,19/1/2022 7:23
8/10/2021,Phrae,5,1621,435038,209644,225394,19532,19532,0,56,29,19/1/2022 7:23
8/10/2021,Mae Hong Son,37,884,285804,144781,141023,33309,33043,266,57, ,19/1/2022 7:23
8/10/2021,,0,173,,,,,,,,,19/1/2022 7:23
9/10/2021,Krabi,124,5330,479040,237966,241074,6644,6408,236,,,19/1/2022 7:23
9/10/2021,Bangkok,1301,406489,5534354,2596396,2937958,535508,483200,52308,54,22,19/1/2022 7:23
9/10/2021,Kanchanaburi,194,18861,894097,448418,445679,467938,467816,122,26,9,19/1/2022 7:23
9/10/2021,Kalasin,74,8009,975928,482318,493610,31863,31863,0,,,19/1/2022 7:23
9/10/2021,Kamphaeng Phet,30,7207,712417,351684,360733,10935,10935,0,,,19/1/2022 7:23
9/10/2021,Khon Kaen,250,16093,1791477,880238,911239,78172,78172,0,80,42,19/1/2022 7:23
9/10/2021,Chanthaburi,316,13909,536488,262258,274230,49181,49069,112,,,19/1/2022 7:23
9/10/2021,Chachoengsao,107,33068,723575,354550,369025,192208,192208,0,58,15,19/1/2022 7:23
9/10/2021,Chon Buri,490,95679,1582463,771883,810580,224103,223216,887,29, ,19/1/2022 7:23
9/10/2021,Chai Nat,3,2328,320853,154238,166615,25249,25249,0,,,19/1/2022 7:23
9/10/2021,Chaiyaphum,44,10892,1122445,554477,567968,24350,24317,33,,,19/1/2022 7:23
9/10/2021,Chumphon,139,10326,509477,251470,258007,7560,7560,0,,,19/1/2022 7:23
9/10/2021,Trang,125,6550,639979,312812,327167,7387,7387,0,,,19/1/2022 7:23
9/10/2021,Trat,96,5754,228426,112944,115482,51815,51639,176,,,19/1/2022 7:23
9/10/2021,Tak,240,17794,675561,341512,334049,23928,23928,0,,,19/1/2022 7:23
9/10/2021,Nakhon Nayok,53,10150,260324,128842,131482,21362,21362,0,,,19/1/2022 7:23
9/10/2021,Nakhon Pathom,76,33281,922078,442736,479342,37242,37188,54,50,14,19/1/2022 7:23
9/10/2021,Nakhon Phanom,5,4832,717013,357096,359917,22046,22046,0,,,19/1/2022 7:23
9/10/2021,Nakhon Ratchasima,175,26720,2634213,1294009,1340204,236917,235237,1680,75,26,19/1/2022 7:23
9/10/2021,Nakhon Si Thammarat,301,19048,1549297,764402,784895,10942,10942,0,,,19/1/2022 7:23
9/10/2021,Nakhon Sawan,135,12223,1035673,505014,530659,28921,28763,158,70,30,19/1/2022 7:23
9/10/2021,Nonthaburi,131,63222,1286596,598356,688240,32482,32370,112,65,35,19/1/2022 7:23
9/10/2021,Narathiwat,471,28485,809130,400257,408873,1549,1549,0,52,26,19/1/2022 7:23
9/10/2021,Nan,0,2370,475962,238027,237935,57643,57453,190,,,19/1/2022 7:23
9/10/2021,Bueng Kan,3,1831,421923,211450,210473,7313,7296,17,,,19/1/2022 7:23
9/10/2021,Buri Ram,68,16043,1579696,783590,796106,48708,48574,134,,,19/1/2022 7:23
9/10/2021,Pathum Thani,79,39001,1187933,562786,625147,26324,26147,177,69,24,19/1/2022 7:23
9/10/2021,Prachuap Khiri Khan,114,12038,553609,274647,278962,262017,261857,160,,,19/1/2022 7:23
9/10/2021,Prachin Buri,234,18515,495017,244513,250504,17246,17246,0,60,31,19/1/2022 7:23
9/10/2021,Pattani,414,25320,729218,360169,369049,1157,1157,0,,,19/1/2022 7:23
9/10/2021,Phra Nakhon Si Ayutthaya,115,28526,820377,393914,426463,161519,160956,563,51,30,19/1/2022 7:23
9/10/2021,Phayao,0,1735,465061,226262,238799,21386,21386,0,70,26,19/1/2022 7:23
9/10/2021,Phang-nga,65,3137,268081,133851,134230,28887,21873,7014,,,19/1/2022 7:23
9/10/2021,Phatthalung,132,5589,522590,254511,268079,3107,3107,0,,,19/1/2022 7:23
9/10/2021,Phichit,11,4329,529974,258338,271636,11935,11935,0,,,19/1/2022 7:23
9/10/2021,Phitsanulok,41,5154,847418,414640,432778,52678,52480,198,,,19/1/2022 7:23
9/10/2021,Phuket,118,12752,419194,198106,221088,91363,64142,27221,47,28,19/1/2022 7:23
9/10/2021,Maha Sarakham,44,10098,949130,465310,483820,12910,12885,25,,,19/1/2022 7:23
9/10/2021,Mukdahan,9,2162,351338,175540,175798,38043,38043,0,,,19/1/2022 7:23
9/10/2021,Yala,650,28799,542002,269804,272198,1327,1327,0,47,26,19/1/2022 7:23
9/10/2021,Yasothon,25,5603,533454,266097,267357,6476,6476,0,,,19/1/2022 7:23
9/10/2021,Ranong,27,9141,194681,98240,96441,5367,5367,0,,,19/1/2022 7:23
9/10/2021,Rayong,359,35746,750107,368398,381709,51424,51159,265,26,15,19/1/2022 7:23
9/10/2021,Ratchaburi,348,32359,868830,422350,446480,88889,88772,117,,,19/1/2022 7:23
9/10/2021,Roi Et,24,13073,1296284,642133,654151,17276,17276,0,,,19/1/2022 7:23
9/10/2021,Lop Buri,79,15214,739712,368713,370999,47834,47796,38,,,19/1/2022 7:23
9/10/2021,Lampang,13,2370,725564,353383,372181,28742,28577,165,71,22,19/1/2022 7:23
9/10/2021,Lamphun,14,2367,401381,192875,208506,18167,18018,149,,,19/1/2022 7:23
9/10/2021,Si Sa Ket,48,15331,1457005,725113,731892,29110,29110,0,,,19/1/2022 7:23
9/10/2021,Sakon Nakhon,20,7362,1146320,569525,576795,37911,37911,0,,,19/1/2022 7:23
9/10/2021,Songkhla,509,35946,1431655,697409,734246,9362,9358,4,55,28,19/1/2022 7:23
9/10/2021,Satun,65,2595,324638,161492,163146,4965,4960,5,48,37,19/1/2022 7:23
9/10/2021,Samut Prakarn,522,118001,1356083,645776,710307,30524,30346,178,,,19/1/2022 7:23
9/10/2021,Samut Songkhram,41,10645,191082,91247,99835,44761,44761,0,41,10,19/1/2022 7:23
9/10/2021,Samut Sakhon,99,108041,586194,282490,303704,20981,20981,0,65,31,19/1/2022 7:23
9/10/2021,Saraburi,160,28066,644040,316399,327641,62770,62680,90,82,45,19/1/2022 7:23
9/10/2021,Sa kaeo,132,14809,561690,280406,281284,11217,10519,698,29,15,19/1/2022 7:23
9/10/2021,Sing Buri,9,2733,204869,97319,107550,15147,15124,23,,,19/1/2022 7:23
9/10/2021,Suphan Buri,74,13203,835825,403209,432616,112708,112708,0,,,19/1/2022 7:23
9/10/2021,Surat Thani,200,14177,1072403,527376,545027,9650,6323,3327,68,26,19/1/2022 7:23
9/10/2021,Surin,58,15467,1376625,684726,691899,19225,19203,22,,,19/1/2022 7:23
9/10/2021,Sukhothai,6,5654,585595,283519,302076,18172,17814,358,,,19/1/2022 7:23
9/10/2021,Nong Khai,30,3300,516972,256377,260595,29617,29500,117,28,11,19/1/2022 7:23
9/10/2021,Nong Bua Lam Phu,20,3943,508984,253786,255198,3417,3402,15,,,19/1/2022 7:23
9/10/2021,Amnat Charoen,0,2820,376306,187145,189161,4821,4821,0,,,19/1/2022 7:23
9/10/2021,Udon Thani,145,19560,1566668,775641,791027,44698,44548,150,,,19/1/2022 7:23
9/10/2021,Uttaradit,31,3986,446617,217679,228938,16832,16832,0,,,19/1/2022 7:23
9/10/2021,Uthai Thani,10,3451,325234,158965,166269,4910,4910,0,,,19/1/2022 7:23
9/10/2021,Ubon Ratchathani,66,17844,1867597,932041,935556,60742,60742,0,66,18,19/1/2022 7:23
9/10/2021,Ang Thong,44,10750,275167,131646,143521,15302,15302,0,,,19/1/2022 7:23
9/10/2021,Chiang Rai,24,3927,1298092,630910,667182,116319,115525,794,79,27,19/1/2022 7:23
9/10/2021,Chiang Mai,177,13727,1788340,863999,924341,214715,212787,1928,74,34,19/1/2022 7:23
9/10/2021,Phetchaburi,128,19559,482659,232915,249744,301889,301778,111,,,19/1/2022 7:23
9/10/2021,Phetchabun,54,9739,978584,482468,496116,84525,84467,58,,,19/1/2022 7:23
9/10/2021,Loei,28,3167,638788,319998,318790,83583,83511,72,,,19/1/2022 7:23
9/10/2021,Phrae,3,1624,435038,209644,225394,19532,19532,0,66,25,19/1/2022 7:23
9/10/2021,Mae Hong Son,61,945,285804,144781,141023,33309,33043,266,,,19/1/2022 7:23
9/10/2021,,0,173,,,,,,,,,19/1/2022 7:23
10/10/2021,Krabi,108,5438,479040,237966,241074,6644,6408,236,,,19/1/2022 7:23
10/10/2021,Bangkok,1190,407679,5534354,2596396,2937958,535508,483200,52308,48,22,19/1/2022 7:23
10/10/2021,Kanchanaburi,160,19021,894097,448418,445679,467938,467816,122,26,10,19/1/2022 7:23
10/10/2021,Kalasin,69,8078,975928,482318,493610,31863,31863,0,,,19/1/2022 7:23
10/10/2021,Kamphaeng Phet,19,7226,712417,351684,360733,10935,10935,0,,,19/1/2022 7:23
10/10/2021,Khon Kaen,305,16398,1791477,880238,911239,78172,78172,0,82,32,19/1/2022 7:23
10/10/2021,Chanthaburi,300,14209,536488,262258,274230,49181,49069,112,,,19/1/2022 7:23
10/10/2021,Chachoengsao,112,33180,723575,354550,369025,192208,192208,0,37,20,19/1/2022 7:23
10/10/2021,Chon Buri,458,96137,1582463,771883,810580,224103,223216,887,,,19/1/2022 7:23
10/10/2021,Chai Nat,2,2330,320853,154238,166615,25249,25249,0,,,19/1/2022 7:23
10/10/2021,Chaiyaphum,48,10940,1122445,554477,567968,24350,24317,33,,,19/1/2022 7:23
10/10/2021,Chumphon,115,10441,509477,251470,258007,7560,7560,0,,,19/1/2022 7:23
10/10/2021,Trang,129,6679,639979,312812,327167,7387,7387,0,,,19/1/2022 7:23
10/10/2021,Trat,107,5861,228426,112944,115482,51815,51639,176,,,19/1/2022 7:23
10/10/2021,Tak,248,18042,675561,341512,334049,23928,23928,0,,,19/1/2022 7:23
10/10/2021,Nakhon Nayok,102,10252,260324,128842,131482,21362,21362,0,,,19/1/2022 7:23
10/10/2021,Nakhon Pathom,74,33355,922078,442736,479342,37242,37188,54,33,13,19/1/2022 7:23
10/10/2021,Nakhon Phanom,0,4832,717013,357096,359917,22046,22046,0,,,19/1/2022 7:23
10/10/2021,Nakhon Ratchasima,144,26864,2634213,1294009,1340204,236917,235237,1680,58,21,19/1/2022 7:23
10/10/2021,Nakhon Si Thammarat,347,19395,1549297,764402,784895,10942,10942,0,,,19/1/2022 7:23
10/10/2021,Nakhon Sawan,117,12340,1035673,505014,530659,28921,28763,158,58,21,19/1/2022 7:23
10/10/2021,Nonthaburi,140,63362,1286596,598356,688240,32482,32370,112,33,18,19/1/2022 7:23
10/10/2021,Narathiwat,479,28964,809130,400257,408873,1549,1549,0,54,26,19/1/2022 7:23
10/10/2021,Nan,0,2370,475962,238027,237935,57643,57453,190,,,19/1/2022 7:23
10/10/2021,Bueng Kan,8,1839,421923,211450,210473,7313,7296,17,,,19/1/2022 7:23
10/10/2021,Buri Ram,30,16073,1579696,783590,796106,48708,48574,134,,,19/1/2022 7:23
10/10/2021,Pathum Thani,123,39124,1187933,562786,625147,26324,26147,177,48,22,19/1/2022 7:23
10/10/2021,Prachuap Khiri Khan,109,12147,553609,274647,278962,262017,261857,160,,,19/1/2022 7:23
10/10/2021,Prachin Buri,246,18761,495017,244513,250504,17246,17246,0,51,29,19/1/2022 7:23
10/10/2021,Pattani,514,25834,729218,360169,369049,1157,1157,0,,,19/1/2022 7:23
10/10/2021,Phra Nakhon Si Ayutthaya,121,28647,820377,393914,426463,161519,160956,563,27,30,19/1/2022 7:23
10/10/2021,Phayao,6,1741,465061,226262,238799,21386,21386,0,59,16,19/1/2022 7:23
10/10/2021,Phang-nga,70,3207,268081,133851,134230,28887,21873,7014,,,19/1/2022 7:23
10/10/2021,Phatthalung,126,5715,522590,254511,268079,3107,3107,0,,,19/1/2022 7:23
10/10/2021,Phichit,14,4343,529974,258338,271636,11935,11935,0,,,19/1/2022 7:23
10/10/2021,Phitsanulok,44,5198,847418,414640,432778,52678,52480,198,,,19/1/2022 7:23
10/10/2021,Phuket,163,12915,419194,198106,221088,91363,64142,27221,50,33,19/1/2022 7:23
10/10/2021,Maha Sarakham,70,10168,949130,465310,483820,12910,12885,25,,,19/1/2022 7:23
10/10/2021,Mukdahan,3,2165,351338,175540,175798,38043,38043,0,,,19/1/2022 7:23
10/10/2021,Yala,781,29580,542002,269804,272198,1327,1327,0,46,32,19/1/2022 7:23
10/10/2021,Yasothon,0,5603,533454,266097,267357,6476,6476,0,,,19/1/2022 7:23
10/10/2021,Ranong,22,9163,194681,98240,96441,5367,5367,0,,,19/1/2022 7:23
10/10/2021,Rayong,366,36112,750107,368398,381709,51424,51159,265,28,18,19/1/2022 7:23
10/10/2021,Ratchaburi,253,32612,868830,422350,446480,88889,88772,117,,,19/1/2022 7:23
10/10/2021,Roi Et,17,13090,1296284,642133,654151,17276,17276,0,,,19/1/2022 7:23
10/10/2021,Lop Buri,82,15296,739712,368713,370999,47834,47796,38,,,19/1/2022 7:23
10/10/2021,Lampang,0,2370,725564,353383,372181,28742,28577,165,65,15,19/1/2022 7:23
10/10/2021,Lamphun,9,2376,401381,192875,208506,18167,18018,149,,,19/1/2022 7:23
10/10/2021,Si Sa Ket,91,15422,1457005,725113,731892,29110,29110,0,,,19/1/2022 7:23
10/10/2021,Sakon Nakhon,28,7390,1146320,569525,576795,37911,37911,0,,,19/1/2022 7:23
10/10/2021,Songkhla,570,36516,1431655,697409,734246,9362,9358,4,55,36,19/1/2022 7:23
10/10/2021,Satun,67,2662,324638,161492,163146,4965,4960,5,59,24,19/1/2022 7:23
10/10/2021,Samut Prakarn,462,118463,1356083,645776,710307,30524,30346,178,,,19/1/2022 7:23
10/10/2021,Samut Songkhram,42,10687,191082,91247,99835,44761,44761,0,20,9,19/1/2022 7:23
10/10/2021,Samut Sakhon,139,108180,586194,282490,303704,20981,20981,0,41,33,19/1/2022 7:23
10/10/2021,Saraburi,122,28188,644040,316399,327641,62770,62680,90,53,50,19/1/2022 7:23
10/10/2021,Sa kaeo,87,14896,561690,280406,281284,11217,10519,698,24,16,19/1/2022 7:23
10/10/2021,Sing Buri,6,2739,204869,97319,107550,15147,15124,23,,,19/1/2022 7:23
10/10/2021,Suphan Buri,57,13260,835825,403209,432616,112708,112708,0,,,19/1/2022 7:23
10/10/2021,Surat Thani,271,14448,1072403,527376,545027,9650,6323,3327,71,28,19/1/2022 7:23
10/10/2021,Surin,78,15545,1376625,684726,691899,19225,19203,22,,,19/1/2022 7:23
10/10/2021,Sukhothai,40,5694,585595,283519,302076,18172,17814,358,,,19/1/2022 7:23
10/10/2021,Nong Khai,7,3307,516972,256377,260595,29617,29500,117,26,11,19/1/2022 7:23
10/10/2021,Nong Bua Lam Phu,9,3952,508984,253786,255198,3417,3402,15,,,19/1/2022 7:23
10/10/2021,Amnat Charoen,13,2833,376306,187145,189161,4821,4821,0,,,19/1/2022 7:23
10/10/2021,Udon Thani,157,19717,1566668,775641,791027,44698,44548,150,,,19/1/2022 7:23
10/10/2021,Uttaradit,21,4007,446617,217679,228938,16832,16832,0,,,19/1/2022 7:23
10/10/2021,Uthai Thani,6,3457,325234,158965,166269,4910,4910,0,,,19/1/2022 7:23
10/10/2021,Ubon Ratchathani,89,17933,1867597,932041,935556,60742,60742,0,41,21,19/1/2022 7:23
10/10/2021,Ang Thong,21,10771,275167,131646,143521,15302,15302,0,,,19/1/2022 7:23
10/10/2021,Chiang Rai,26,3953,1298092,630910,667182,116319,115525,794,72,12,19/1/2022 7:23
10/10/2021,Chiang Mai,226,13953,1788340,863999,924341,214715,212787,1928,76,23,19/1/2022 7:23
10/10/2021,Phetchaburi,103,19662,482659,232915,249744,301889,301778,111,,,19/1/2022 7:23
10/10/2021,Phetchabun,67,9806,978584,482468,496116,84525,84467,58,,,19/1/2022 7:23
10/10/2021,Loei,14,3181,638788,319998,318790,83583,83511,72,,,19/1/2022 7:23
10/10/2021,Phrae,8,1632,435038,209644,225394,19532,19532,0,61,15,19/1/2022 7:23
10/10/2021,Mae Hong Son,40,985,285804,144781,141023,33309,33043,266,,,19/1/2022 7:23
10/10/2021,,0,173,,,,,,,,,19/1/2022 7:23
11/10/2021,Krabi,191,5629,479040,237966,241074,6644,6408,236,,,19/1/2022 7:23
11/10/2021,Bangkok,1186,408865,5534354,2596396,2937958,535508,483200,52308,43,21,19/1/2022 7:23
11/10/2021,Kanchanaburi,121,19142,894097,448418,445679,467938,467816,122,22,10,19/1/2022 7:23
11/10/2021,Kalasin,62,8140,975928,482318,493610,31863,31863,0,,,19/1/2022 7:23
11/10/2021,Kamphaeng Phet,37,7263,712417,351684,360733,10935,10935,0,,,19/1/2022 7:23
11/10/2021,Khon Kaen,177,16575,1791477,880238,911239,78172,78172,0,64,28,19/1/2022 7:23
11/10/2021,Chanthaburi,279,14488,536488,262258,274230,49181,49069,112,,,19/1/2022 7:23
11/10/2021,Chachoengsao,72,33252,723575,354550,369025,192208,192208,0,49,23,19/1/2022 7:23
11/10/2021,Chon Buri,473,96610,1582463,771883,810580,224103,223216,887, ,32,19/1/2022 7:23
11/10/2021,Chai Nat,3,2333,320853,154238,166615,25249,25249,0,,,19/1/2022 7:23
11/10/2021,Chaiyaphum,32,10972,1122445,554477,567968,24350,24317,33,,,19/1/2022 7:23
11/10/2021,Chumphon,113,10554,509477,251470,258007,7560,7560,0,,,19/1/2022 7:23
11/10/2021,Trang,139,6818,639979,312812,327167,7387,7387,0,,,19/1/2022 7:23
11/10/2021,Trat,75,5936,228426,112944,115482,51815,51639,176,,,19/1/2022 7:23
11/10/2021,Tak,211,18253,675561,341512,334049,23928,23928,0,,,19/1/2022 7:23
11/10/2021,Nakhon Nayok,20,10272,260324,128842,131482,21362,21362,0,,,19/1/2022 7:23
11/10/2021,Nakhon Pathom,97,33452,922078,442736,479342,37242,37188,54,31,15,19/1/2022 7:23
11/10/2021,Nakhon Phanom,2,4834,717013,357096,359917,22046,22046,0,,,19/1/2022 7:23
11/10/2021,Nakhon Ratchasima,152,27016,2634213,1294009,1340204,236917,235237,1680,51,24,19/1/2022 7:23
11/10/2021,Nakhon Si Thammarat,473,19868,1549297,764402,784895,10942,10942,0,,,19/1/2022 7:23
11/10/2021,Nakhon Sawan,89,12429,1035673,505014,530659,28921,28763,158,38,17,19/1/2022 7:23
11/10/2021,Nonthaburi,138,63500,1286596,598356,688240,32482,32370,112,25,20,19/1/2022 7:23
11/10/2021,Narathiwat,414,29378,809130,400257,408873,1549,1549,0,57,32,19/1/2022 7:23
11/10/2021,Nan,0,2370,475962,238027,237935,57643,57453,190,,,19/1/2022 7:23
11/10/2021,Bueng Kan,4,1843,421923,211450,210473,7313,7296,17,,,19/1/2022 7:23
11/10/2021,Buri Ram,32,16105,1579696,783590,796106,48708,48574,134,,,19/1/2022 7:23
11/10/2021,Pathum Thani,61,39185,1187933,562786,625147,26324,26147,177,37,27,19/1/2022 7:23
11/10/2021,Prachuap Khiri Khan,88,12235,553609,274647,278962,262017,261857,160,,,19/1/2022 7:23
11/10/2021,Prachin Buri,185,18946,495017,244513,250504,17246,17246,0,53,34,19/1/2022 7:23
11/10/2021,Pattani,548,26382,729218,360169,369049,1157,1157,0,,,19/1/2022 7:23
11/10/2021,Phra Nakhon Si Ayutthaya,121,28768,820377,393914,426463,161519,160956,563,26,32,19/1/2022 7:23
11/10/2021,Phayao,0,1741,465061,226262,238799,21386,21386,0,36,15,19/1/2022 7:23
11/10/2021,Phang-nga,43,3250,268081,133851,134230,28887,21873,7014,,,19/1/2022 7:23
11/10/2021,Phatthalung,23,5738,522590,254511,268079,3107,3107,0,,,19/1/2022 7:23
11/10/2021,Phichit,11,4354,529974,258338,271636,11935,11935,0,,,19/1/2022 7:23
11/10/2021,Phitsanulok,45,5243,847418,414640,432778,52678,52480,198,,,19/1/2022 7:23
11/10/2021,Phuket,163,13078,419194,198106,221088,91363,64142,27221,92,29,19/1/2022 7:23
11/10/2021,Maha Sarakham,49,10217,949130,465310,483820,12910,12885,25,,,19/1/2022 7:23
11/10/2021,Mukdahan,8,2173,351338,175540,175798,38043,38043,0,,,19/1/2022 7:23
11/10/2021,Yala,719,30299,542002,269804,272198,1327,1327,0,53,40,19/1/2022 7:23
11/10/2021,Yasothon,9,5612,533454,266097,267357,6476,6476,0,,,19/1/2022 7:23
11/10/2021,Ranong,19,9182,194681,98240,96441,5367,5367,0,,,19/1/2022 7:23
11/10/2021,Rayong,379,36491,750107,368398,381709,51424,51159,265,33,15,19/1/2022 7:23
11/10/2021,Ratchaburi,247,32859,868830,422350,446480,88889,88772,117,,,19/1/2022 7:23
11/10/2021,Roi Et,24,13114,1296284,642133,654151,17276,17276,0,,,19/1/2022 7:23
11/10/2021,Lop Buri,73,15369,739712,368713,370999,47834,47796,38,,,19/1/2022 7:23
11/10/2021,Lampang,19,2389,725564,353383,372181,28742,28577,165,45,13,19/1/2022 7:23
11/10/2021,Lamphun,22,2398,401381,192875,208506,18167,18018,149,,,19/1/2022 7:23
11/10/2021,Si Sa Ket,73,15495,1457005,725113,731892,29110,29110,0,,,19/1/2022 7:23
11/10/2021,Sakon Nakhon,28,7418,1146320,569525,576795,37911,37911,0,,,19/1/2022 7:23
11/10/2021,Songkhla,506,37022,1431655,697409,734246,9362,9358,4,63,34,19/1/2022 7:23
11/10/2021,Satun,78,2740,324638,161492,163146,4965,4960,5,50,36,19/1/2022 7:23
11/10/2021,Samut Prakarn,542,119005,1356083,645776,710307,30524,30346,178,,,19/1/2022 7:23
11/10/2021,Samut Songkhram,47,10734,191082,91247,99835,44761,44761,0,17, ,19/1/2022 7:23
11/10/2021,Samut Sakhon,162,108342,586194,282490,303704,20981,20981,0,49,33,19/1/2022 7:23
11/10/2021,Saraburi,130,28318,644040,316399,327641,62770,62680,90,55,66,19/1/2022 7:23
11/10/2021,Sa kaeo,37,14933,561690,280406,281284,11217,10519,698,25,15,19/1/2022 7:23
11/10/2021,Sing Buri,1,2740,204869,97319,107550,15147,15124,23,,,19/1/2022 7:23
11/10/2021,Suphan Buri,64,13324,835825,403209,432616,112708,112708,0,,,19/1/2022 7:23
11/10/2021,Surat Thani,212,14660,1072403,527376,545027,9650,6323,3327,68,26,19/1/2022 7:23
11/10/2021,Surin,49,15594,1376625,684726,691899,19225,19203,22,,,19/1/2022 7:23
11/10/2021,Sukhothai,5,5699,585595,283519,302076,18172,17814,358,,,19/1/2022 7:23
11/10/2021,Nong Khai,7,3314,516972,256377,260595,29617,29500,117,27,10,19/1/2022 7:23
11/10/2021,Nong Bua Lam Phu,14,3966,508984,253786,255198,3417,3402,15,,,19/1/2022 7:23
11/10/2021,Amnat Charoen,3,2836,376306,187145,189161,4821,4821,0,,,19/1/2022 7:23
11/10/2021,Udon Thani,124,19841,1566668,775641,791027,44698,44548,150,,,19/1/2022 7:23
11/10/2021,Uttaradit,7,4014,446617,217679,228938,16832,16832,0,,,19/1/2022 7:23
11/10/2021,Uthai Thani,11,3468,325234,158965,166269,4910,4910,0,,,19/1/2022 7:23
11/10/2021,Ubon Ratchathani,84,18017,1867597,932041,935556,60742,60742,0,44,18,19/1/2022 7:23
11/10/2021,Ang Thong,35,10806,275167,131646,143521,15302,15302,0,,,19/1/2022 7:23
11/10/2021,Chiang Rai,17,3970,1298092,630910,667182,116319,115525,794,32,9,19/1/2022 7:23
11/10/2021,Chiang Mai,191,14144,1788340,863999,924341,214715,212787,1928,55,19,19/1/2022 7:23
11/10/2021,Phetchaburi,87,19749,482659,232915,249744,301889,301778,111,,,19/1/2022 7:23
11/10/2021,Phetchabun,14,9820,978584,482468,496116,84525,84467,58,,,19/1/2022 7:23
11/10/2021,Loei,22,3203,638788,319998,318790,83583,83511,72,,,19/1/2022 7:23
11/10/2021,Phrae,4,1636,435038,209644,225394,19532,19532,0,38,13,19/1/2022 7:23
11/10/2021,Mae Hong Son,33,1018,285804,144781,141023,33309,33043,266,,,19/1/2022 7:23
11/10/2021,,0,173,,,,,,,,,19/1/2022 7:23
12/10/2021,Krabi,127,5756,479040,237966,241074,6644,6408,236,,,19/1/2022 7:23
12/10/2021,Bangkok,1179,410044,5534354,2596396,2937958,535508,483200,52308,47,19,19/1/2022 7:23
12/10/2021,Kanchanaburi,97,19239,894097,448418,445679,467938,467816,122,26,10,19/1/2022 7:23
12/10/2021,Kalasin,27,8167,975928,482318,493610,31863,31863,0,,,19/1/2022 7:23
12/10/2021,Kamphaeng Phet,24,7287,712417,351684,360733,10935,10935,0,,,19/1/2022 7:23
12/10/2021,Khon Kaen,181,16756,1791477,880238,911239,78172,78172,0,58,32,19/1/2022 7:23
12/10/2021,Chanthaburi,146,14634,536488,262258,274230,49181,49069,112,,,19/1/2022 7:23
12/10/2021,Chachoengsao,100,33352,723575,354550,369025,192208,192208,0,39,29,19/1/2022 7:23
12/10/2021,Chon Buri,540,97150,1582463,771883,810580,224103,223216,887,37,21,19/1/2022 7:23
12/10/2021,Chai Nat,4,2337,320853,154238,166615,25249,25249,0,,,19/1/2022 7:23
12/10/2021,Chaiyaphum,44,11016,1122445,554477,567968,24350,24317,33,,,19/1/2022 7:23
12/10/2021,Chumphon,111,10665,509477,251470,258007,7560,7560,0,,,19/1/2022 7:23
12/10/2021,Trang,148,6966,639979,312812,327167,7387,7387,0,,,19/1/2022 7:23
12/10/2021,Trat,62,5998,228426,112944,115482,51815,51639,176,,,19/1/2022 7:23
12/10/2021,Tak,160,18413,675561,341512,334049,23928,23928,0,,,19/1/2022 7:23
12/10/2021,Nakhon Nayok,33,10305,260324,128842,131482,21362,21362,0,,,19/1/2022 7:23
12/10/2021,Nakhon Pathom,95,33547,922078,442736,479342,37242,37188,54,42,10,19/1/2022 7:23
12/10/2021,Nakhon Phanom,2,4836,717013,357096,359917,22046,22046,0,,,19/1/2022 7:23
12/10/2021,Nakhon Ratchasima,131,27147,2634213,1294009,1340204,236917,235237,1680,64,20,19/1/2022 7:23
12/10/2021,Nakhon Si Thammarat,363,20231,1549297,764402,784895,10942,10942,0,,,19/1/2022 7:23
12/10/2021,Nakhon Sawan,81,12510,1035673,505014,530659,28921,28763,158,31,17,19/1/2022 7:23
12/10/2021,Nonthaburi,140,63640,1286596,598356,688240,32482,32370,112,30,18,19/1/2022 7:23
12/10/2021,Narathiwat,473,29851,809130,400257,408873,1549,1549,0,65,29,19/1/2022 7:23
12/10/2021,Nan,2,2372,475962,238027,237935,57643,57453,190,,,19/1/2022 7:23
12/10/2021,Bueng Kan,1,1844,421923,211450,210473,7313,7296,17,,,19/1/2022 7:23
12/10/2021,Buri Ram,41,16146,1579696,783590,796106,48708,48574,134,,,19/1/2022 7:23
12/10/2021,Pathum Thani,30,39215,1187933,562786,625147,26324,26147,177,52,23,19/1/2022 7:23
12/10/2021,Prachuap Khiri Khan,47,12282,553609,274647,278962,262017,261857,160,,,19/1/2022 7:23
12/10/2021,Prachin Buri,202,19148,495017,244513,250504,17246,17246,0,61,29,19/1/2022 7:23
12/10/2021,Pattani,567,26949,729218,360169,369049,1157,1157,0,,,19/1/2022 7:23
12/10/2021,Phra Nakhon Si Ayutthaya,91,28859,820377,393914,426463,161519,160956,563,34,30,19/1/2022 7:23
12/10/2021,Phayao,3,1744,465061,226262,238799,21386,21386,0,28,18,19/1/2022 7:23
12/10/2021,Phang-nga,88,3338,268081,133851,134230,28887,21873,7014,,,19/1/2022 7:23
12/10/2021,Phatthalung,170,5908,522590,254511,268079,3107,3107,0,,,19/1/2022 7:23
12/10/2021,Phichit,11,4365,529974,258338,271636,11935,11935,0,,,19/1/2022 7:23
12/10/2021,Phitsanulok,45,5288,847418,414640,432778,52678,52480,198,,,19/1/2022 7:23
12/10/2021,Phuket,152,13230,419194,198106,221088,91363,64142,27221,52,32,19/1/2022 7:23
12/10/2021,Maha Sarakham,25,10242,949130,465310,483820,12910,12885,25,,,19/1/2022 7:23
12/10/2021,Mukdahan,2,2175,351338,175540,175798,38043,38043,0,,,19/1/2022 7:23
12/10/2021,Yala,493,30792,542002,269804,272198,1327,1327,0,63,31,19/1/2022 7:23
12/10/2021,Yasothon,8,5620,533454,266097,267357,6476,6476,0,,,19/1/2022 7:23
12/10/2021,Ranong,35,9217,194681,98240,96441,5367,5367,0,,,19/1/2022 7:23
12/10/2021,Rayong,315,36806,750107,368398,381709,51424,51159,265,27,15,19/1/2022 7:23
12/10/2021,Ratchaburi,173,33032,868830,422350,446480,88889,88772,117,,,19/1/2022 7:23
12/10/2021,Roi Et,9,13123,1296284,642133,654151,17276,17276,0,,,19/1/2022 7:23
12/10/2021,Lop Buri,46,15415,739712,368713,370999,47834,47796,38,,,19/1/2022 7:23
12/10/2021,Lampang,10,2399,725564,353383,372181,28742,28577,165,41,16,19/1/2022 7:23
12/10/2021,Lamphun,11,2409,401381,192875,208506,18167,18018,149,,,19/1/2022 7:23
12/10/2021,Si Sa Ket,204,15699,1457005,725113,731892,29110,29110,0,,,19/1/2022 7:23
12/10/2021,Sakon Nakhon,9,7427,1146320,569525,576795,37911,37911,0,,,19/1/2022 7:23
12/10/2021,Songkhla,468,37490,1431655,697409,734246,9362,9358,4,65,33,19/1/2022 7:23
12/10/2021,Satun,90,2830,324638,161492,163146,4965,4960,5,66,32,19/1/2022 7:23
12/10/2021,Samut Prakarn,425,119430,1356083,645776,710307,30524,30346,178,,,19/1/2022 7:23
12/10/2021,Samut Songkhram,62,10796,191082,91247,99835,44761,44761,0,,,19/1/2022 7:23
12/10/2021,Samut Sakhon,120,108462,586194,282490,303704,20981,20981,0,50,27,19/1/2022 7:23
12/10/2021,Saraburi,127,28445,644040,316399,327641,62770,62680,90,69,49,19/1/2022 7:23
12/10/2021,Sa kaeo,47,14980,561690,280406,281284,11217,10519,698,21,17,19/1/2022 7:23
12/10/2021,Sing Buri,3,2743,204869,97319,107550,15147,15124,23,,,19/1/2022 7:23
12/10/2021,Suphan Buri,82,13406,835825,403209,432616,112708,112708,0,,,19/1/2022 7:23
12/10/2021,Surat Thani,214,14874,1072403,527376,545027,9650,6323,3327,65,25,19/1/2022 7:23
12/10/2021,Surin,42,15636,1376625,684726,691899,19225,19203,22,,,19/1/2022 7:23
12/10/2021,Sukhothai,4,5703,585595,283519,302076,18172,17814,358,,,19/1/2022 7:23
12/10/2021,Nong Khai,6,3320,516972,256377,260595,29617,29500,117,24,9,19/1/2022 7:23
12/10/2021,Nong Bua Lam Phu,30,3996,508984,253786,255198,3417,3402,15,,,19/1/2022 7:23
12/10/2021,Amnat Charoen,3,2839,376306,187145,189161,4821,4821,0,,,19/1/2022 7:23
12/10/2021,Udon Thani,168,20009,1566668,775641,791027,44698,44548,150,,,19/1/2022 7:23
12/10/2021,Uttaradit,5,4019,446617,217679,228938,16832,16832,0,,,19/1/2022 7:23
12/10/2021,Uthai Thani,13,3481,325234,158965,166269,4910,4910,0,,,19/1/2022 7:23
12/10/2021,Ubon Ratchathani,76,18093,1867597,932041,935556,60742,60742,0,40,31,19/1/2022 7:23
12/10/2021,Ang Thong,32,10838,275167,131646,143521,15302,15302,0,,,19/1/2022 7:23
12/10/2021,Chiang Rai,25,3995,1298092,630910,667182,116319,115525,794,22,17,19/1/2022 7:23
12/10/2021,Chiang Mai,194,14338,1788340,863999,924341,214715,212787,1928,45,22,19/1/2022 7:23
12/10/2021,Phetchaburi,59,19808,482659,232915,249744,301889,301778,111,,,19/1/2022 7:23
12/10/2021,Phetchabun,15,9835,978584,482468,496116,84525,84467,58,,,19/1/2022 7:23
12/10/2021,Loei,39,3242,638788,319998,318790,83583,83511,72,,,19/1/2022 7:23
12/10/2021,Phrae,4,1640,435038,209644,225394,19532,19532,0,28,20,19/1/2022 7:23
12/10/2021,Mae Hong Son,34,1052,285804,144781,141023,33309,33043,266,,,19/1/2022 7:23
12/10/2021,,0,173,,,,,,,,,19/1/2022 7:23
13/10/2021,Krabi,143,5899,479040,237966,241074,6644,6408,236,,,19/1/2022 7:23
13/10/2021,Bangkok,1152,411196,5534354,2596396,2937958,535508,483200,52308,39,23,19/1/2022 7:23
13/10/2021,Kanchanaburi,116,19355,894097,448418,445679,467938,467816,122,22,9,19/1/2022 7:23
13/10/2021,Kalasin,78,8245,975928,482318,493610,31863,31863,0,,,19/1/2022 7:23
13/10/2021,Kamphaeng Phet,27,7314,712417,351684,360733,10935,10935,0,,,19/1/2022 7:23
13/10/2021,Khon Kaen,153,16909,1791477,880238,911239,78172,78172,0,66,27,19/1/2022 7:23
13/10/2021,Chanthaburi,311,14945,536488,262258,274230,49181,49069,112,,,19/1/2022 7:23
13/10/2021,Chachoengsao,118,33470,723575,354550,369025,192208,192208,0,36,35,19/1/2022 7:23
13/10/2021,Chon Buri,442,97592,1582463,771883,810580,224103,223216,887,32,36,19/1/2022 7:23
13/10/2021,Chai Nat,9,2346,320853,154238,166615,25249,25249,0,,,19/1/2022 7:23
13/10/2021,Chaiyaphum,35,11051,1122445,554477,567968,24350,24317,33,,,19/1/2022 7:23
13/10/2021,Chumphon,140,10805,509477,251470,258007,7560,7560,0,,,19/1/2022 7:23
13/10/2021,Trang,170,7136,639979,312812,327167,7387,7387,0,,,19/1/2022 7:23
13/10/2021,Trat,101,6099,228426,112944,115482,51815,51639,176,,,19/1/2022 7:23
13/10/2021,Tak,239,18652,675561,341512,334049,23928,23928,0,,,19/1/2022 7:23
13/10/2021,Nakhon Nayok,56,10361,260324,128842,131482,21362,21362,0,,,19/1/2022 7:23
13/10/2021,Nakhon Pathom,61,33608,922078,442736,479342,37242,37188,54,27,14,19/1/2022 7:23
13/10/2021,Nakhon Phanom,3,4839,717013,357096,359917,22046,22046,0,,,19/1/2022 7:23
13/10/2021,Nakhon Ratchasima,185,27332,2634213,1294009,1340204,236917,235237,1680,49,19,19/1/2022 7:23
13/10/2021,Nakhon Si Thammarat,265,20496,1549297,764402,784895,10942,10942,0,,,19/1/2022 7:23
13/10/2021,Nakhon Sawan,107,12617,1035673,505014,530659,28921,28763,158,31,22,19/1/2022 7:23
13/10/2021,Nonthaburi,165,63805,1286596,598356,688240,32482,32370,112,22,18,19/1/2022 7:23
13/10/2021,Narathiwat,420,30271,809130,400257,408873,1549,1549,0,60,33,19/1/2022 7:23
13/10/2021,Nan,0,2372,475962,238027,237935,57643,57453,190,,,19/1/2022 7:23
13/10/2021,Bueng Kan,4,1848,421923,211450,210473,7313,7296,17,,,19/1/2022 7:23
13/10/2021,Buri Ram,36,16182,1579696,783590,796106,48708,48574,134,,,19/1/2022 7:23
13/10/2021,Pathum Thani,124,39339,1187933,562786,625147,26324,26147,177,45,18,19/1/2022 7:23
13/10/2021,Prachuap Khiri Khan,118,12400,553609,274647,278962,262017,261857,160,,,19/1/2022 7:23
13/10/2021,Prachin Buri,192,19340,495017,244513,250504,17246,17246,0,51,27,19/1/2022 7:23
13/10/2021,Pattani,423,27372,729218,360169,369049,1157,1157,0,,,19/1/2022 7:23
13/10/2021,Phra Nakhon Si Ayutthaya,78,28937,820377,393914,426463,161519,160956,563,32,28,19/1/2022 7:23
13/10/2021,Phayao,4,1748,465061,226262,238799,21386,21386,0,40,24,19/1/2022 7:23
13/10/2021,Phang-nga,57,3395,268081,133851,134230,28887,21873,7014,,,19/1/2022 7:23
13/10/2021,Phatthalung,129,6037,522590,254511,268079,3107,3107,0,,,19/1/2022 7:23
13/10/2021,Phichit,25,4390,529974,258338,271636,11935,11935,0,,,19/1/2022 7:23
13/10/2021,Phitsanulok,43,5331,847418,414640,432778,52678,52480,198,,,19/1/2022 7:23
13/10/2021,Phuket,172,13402,419194,198106,221088,91363,64142,27221,59,35,19/1/2022 7:23
13/10/2021,Maha Sarakham,55,10297,949130,465310,483820,12910,12885,25,,,19/1/2022 7:23
13/10/2021,Mukdahan,1,2176,351338,175540,175798,38043,38043,0,,,19/1/2022 7:23
13/10/2021,Yala,650,31442,542002,269804,272198,1327,1327,0,53,37,19/1/2022 7:23
13/10/2021,Yasothon,7,5627,533454,266097,267357,6476,6476,0,,,19/1/2022 7:23
13/10/2021,Ranong,24,9241,194681,98240,96441,5367,5367,0,,,19/1/2022 7:23
13/10/2021,Rayong,326,37132,750107,368398,381709,51424,51159,265,29,15,19/1/2022 7:23
13/10/2021,Ratchaburi,158,33190,868830,422350,446480,88889,88772,117,,,19/1/2022 7:23
13/10/2021,Roi Et,19,13142,1296284,642133,654151,17276,17276,0,,,19/1/2022 7:23
13/10/2021,Lop Buri,51,15466,739712,368713,370999,47834,47796,38,,,19/1/2022 7:23
13/10/2021,Lampang,15,2414,725564,353383,372181,28742,28577,165,48,18,19/1/2022 7:23
13/10/2021,Lamphun,14,2423,401381,192875,208506,18167,18018,149,,,19/1/2022 7:23
13/10/2021,Si Sa Ket,43,15742,1457005,725113,731892,29110,29110,0,,,19/1/2022 7:23
13/10/2021,Sakon Nakhon,10,7437,1146320,569525,576795,37911,37911,0,,,19/1/2022 7:23
13/10/2021,Songkhla,475,37965,1431655,697409,734246,9362,9358,4,57,32,19/1/2022 7:23
13/10/2021,Satun,96,2926,324638,161492,163146,4965,4960,5,61,41,19/1/2022 7:23
13/10/2021,Samut Prakarn,453,119883,1356083,645776,710307,30524,30346,178,,,19/1/2022 7:23
13/10/2021,Samut Songkhram,68,10864,191082,91247,99835,44761,44761,0, ,14,19/1/2022 7:23
13/10/2021,Samut Sakhon,100,108562,586194,282490,303704,20981,20981,0,43,34,19/1/2022 7:23
13/10/2021,Saraburi,188,28633,644040,316399,327641,62770,62680,90,53,45,19/1/2022 7:23
13/10/2021,Sa kaeo,148,15128,561690,280406,281284,11217,10519,698,25,17,19/1/2022 7:23
13/10/2021,Sing Buri,9,2752,204869,97319,107550,15147,15124,23,,,19/1/2022 7:23
13/10/2021,Suphan Buri,106,13512,835825,403209,432616,112708,112708,0,,,19/1/2022 7:23
13/10/2021,Surat Thani,218,15092,1072403,527376,545027,9650,6323,3327,71,27,19/1/2022 7:23
13/10/2021,Surin,89,15725,1376625,684726,691899,19225,19203,22,,,19/1/2022 7:23
13/10/2021,Sukhothai,26,5729,585595,283519,302076,18172,17814,358,,,19/1/2022 7:23
13/10/2021,Nong Khai,6,3326,516972,256377,260595,29617,29500,117,21,9,19/1/2022 7:23
13/10/2021,Nong Bua Lam Phu,23,4019,508984,253786,255198,3417,3402,15,,,19/1/2022 7:23
13/10/2021,Amnat Charoen,14,2853,376306,187145,189161,4821,4821,0,,,19/1/2022 7:23
13/10/2021,Udon Thani,181,20190,1566668,775641,791027,44698,44548,150,,,19/1/2022 7:23
13/10/2021,Uttaradit,14,4033,446617,217679,228938,16832,16832,0,,,19/1/2022 7:23
13/10/2021,Uthai Thani,15,3496,325234,158965,166269,4910,4910,0,,,19/1/2022 7:23
13/10/2021,Ubon Ratchathani,93,18186,1867597,932041,935556,60742,60742,0,62,23,19/1/2022 7:23
13/10/2021,Ang Thong,15,10853,275167,131646,143521,15302,15302,0,,,19/1/2022 7:23
13/10/2021,Chiang Rai,28,4023,1298092,630910,667182,116319,115525,794,43,19,19/1/2022 7:23
13/10/2021,Chiang Mai,214,14552,1788340,863999,924341,214715,212787,1928,47,27,19/1/2022 7:23
13/10/2021,Phetchaburi,90,19898,482659,232915,249744,301889,301778,111,,,19/1/2022 7:23
13/10/2021,Phetchabun,58,9893,978584,482468,496116,84525,84467,58,,,19/1/2022 7:23
13/10/2021,Loei,32,3274,638788,319998,318790,83583,83511,72,,,19/1/2022 7:23
13/10/2021,Phrae,2,1642,435038,209644,225394,19532,19532,0,42,21,19/1/2022 7:23
13/10/2021,Mae Hong Son,29,1081,285804,144781,141023,33309,33043,266,,,19/1/2022 7:23
13/10/2021,,0,173,,,,,,,,,19/1/2022 7:23
14/10/2021,Krabi,193,6092,479040,237966,241074,6644,6408,236,,,19/1/2022 7:23
14/10/2021,Bangkok,1125,412321,5534354,2596396,2937958,535508,483200,52308,49,25,19/1/2022 7:23
14/10/2021,Kanchanaburi,148,19503,894097,448418,445679,467938,467816,122,22,11,19/1/2022 7:23
14/10/2021,Kalasin,94,8339,975928,482318,493610,31863,31863,0,,,19/1/2022 7:23
14/10/2021,Kamphaeng Phet,27,7341,712417,351684,360733,10935,10935,0,,,19/1/2022 7:23
14/10/2021,Khon Kaen,230,17139,1791477,880238,911239,78172,78172,0,62,23,19/1/2022 7:23
14/10/2021,Chanthaburi,423,15368,536488,262258,274230,49181,49069,112,,,19/1/2022 7:23
14/10/2021,Chachoengsao,116,33586,723575,354550,369025,192208,192208,0,39,154,19/1/2022 7:23
14/10/2021,Chon Buri,451,98043,1582463,771883,810580,224103,223216,887,34,36,19/1/2022 7:23
14/10/2021,Chai Nat,4,2350,320853,154238,166615,25249,25249,0,,,19/1/2022 7:23
14/10/2021,Chaiyaphum,25,11076,1122445,554477,567968,24350,24317,33,,,19/1/2022 7:23
14/10/2021,Chumphon,90,10895,509477,251470,258007,7560,7560,0,,,19/1/2022 7:23
14/10/2021,Trang,168,7304,639979,312812,327167,7387,7387,0,,,19/1/2022 7:23
14/10/2021,Trat,52,6151,228426,112944,115482,51815,51639,176,,,19/1/2022 7:23
14/10/2021,Tak,282,18934,675561,341512,334049,23928,23928,0,,,19/1/2022 7:23
14/10/2021,Nakhon Nayok,22,10383,260324,128842,131482,21362,21362,0,,,19/1/2022 7:23
14/10/2021,Nakhon Pathom,84,33692,922078,442736,479342,37242,37188,54,33,31,19/1/2022 7:23
14/10/2021,Nakhon Phanom,5,4844,717013,357096,359917,22046,22046,0,,,19/1/2022 7:23
14/10/2021,Nakhon Ratchasima,157,27489,2634213,1294009,1340204,236917,235237,1680,46,14,19/1/2022 7:23
14/10/2021,Nakhon Si Thammarat,510,21006,1549297,764402,784895,10942,10942,0,,,19/1/2022 7:23
14/10/2021,Nakhon Sawan,127,12744,1035673,505014,530659,28921,28763,158,42,16,19/1/2022 7:23
14/10/2021,Nonthaburi,125,63930,1286596,598356,688240,32482,32370,112,28,19,19/1/2022 7:23
14/10/2021,Narathiwat,545,30816,809130,400257,408873,1549,1549,0,68,33,19/1/2022 7:23
14/10/2021,Nan,3,2375,475962,238027,237935,57643,57453,190,,,19/1/2022 7:23
14/10/2021,Bueng Kan,4,1852,421923,211450,210473,7313,7296,17,,,19/1/2022 7:23
14/10/2021,Buri Ram,39,16221,1579696,783590,796106,48708,48574,134,,,19/1/2022 7:23
14/10/2021,Pathum Thani,121,39460,1187933,562786,625147,26324,26147,177,38,19,19/1/2022 7:23
14/10/2021,Prachuap Khiri Khan,154,12554,553609,274647,278962,262017,261857,160,,,19/1/2022 7:23
14/10/2021,Prachin Buri,283,19623,495017,244513,250504,17246,17246,0,53,19,19/1/2022 7:23
14/10/2021,Pattani,468,27840,729218,360169,369049,1157,1157,0,,,19/1/2022 7:23
14/10/2021,Phra Nakhon Si Ayutthaya,126,29063,820377,393914,426463,161519,160956,563,27,27,19/1/2022 7:23
14/10/2021,Phayao,14,1762,465061,226262,238799,21386,21386,0,55,12,19/1/2022 7:23
14/10/2021,Phang-nga,94,3489,268081,133851,134230,28887,21873,7014,,,19/1/2022 7:23
14/10/2021,Phatthalung,163,6200,522590,254511,268079,3107,3107,0,,,19/1/2022 7:23
14/10/2021,Phichit,17,4407,529974,258338,271636,11935,11935,0,,,19/1/2022 7:23
14/10/2021,Phitsanulok,37,5368,847418,414640,432778,52678,52480,198,,,19/1/2022 7:23
14/10/2021,Phuket,156,13558,419194,198106,221088,91363,64142,27221,62,50,19/1/2022 7:23
14/10/2021,Maha Sarakham,42,10339,949130,465310,483820,12910,12885,25,,,19/1/2022 7:23
14/10/2021,Mukdahan,1,2177,351338,175540,175798,38043,38043,0,,,19/1/2022 7:23
14/10/2021,Yala,785,32227,542002,269804,272198,1327,1327,0,60,44,19/1/2022 7:23
14/10/2021,Yasothon,2,5629,533454,266097,267357,6476,6476,0,,,19/1/2022 7:23
14/10/2021,Ranong,17,9258,194681,98240,96441,5367,5367,0,,,19/1/2022 7:23
14/10/2021,Rayong,385,37517,750107,368398,381709,51424,51159,265,31,17,19/1/2022 7:23
14/10/2021,Ratchaburi,217,33407,868830,422350,446480,88889,88772,117,,,19/1/2022 7:23
14/10/2021,Roi Et,19,13161,1296284,642133,654151,17276,17276,0,,,19/1/2022 7:23
14/10/2021,Lop Buri,75,15541,739712,368713,370999,47834,47796,38,,,19/1/2022 7:23
14/10/2021,Lampang,21,2435,725564,353383,372181,28742,28577,165,58,16,19/1/2022 7:23
14/10/2021,Lamphun,24,2447,401381,192875,208506,18167,18018,149,,,19/1/2022 7:23
14/10/2021,Si Sa Ket,57,15799,1457005,725113,731892,29110,29110,0,,,19/1/2022 7:23
14/10/2021,Sakon Nakhon,8,7445,1146320,569525,576795,37911,37911,0,,,19/1/2022 7:23
14/10/2021,Songkhla,596,38561,1431655,697409,734246,9362,9358,4,61,41,19/1/2022 7:23
14/10/2021,Satun,95,3021,324638,161492,163146,4965,4960,5,71,31,19/1/2022 7:23
14/10/2021,Samut Prakarn,404,120287,1356083,645776,710307,30524,30346,178,,,19/1/2022 7:23
14/10/2021,Samut Songkhram,68,10932,191082,91247,99835,44761,44761,0,26,13,19/1/2022 7:23
14/10/2021,Samut Sakhon,84,108646,586194,282490,303704,20981,20981,0,51,34,19/1/2022 7:23
14/10/2021,Saraburi,194,28827,644040,316399,327641,62770,62680,90,45,32,19/1/2022 7:23
14/10/2021,Sa kaeo,77,15205,561690,280406,281284,11217,10519,698,28,10,19/1/2022 7:23
14/10/2021,Sing Buri,0,2752,204869,97319,107550,15147,15124,23,,,19/1/2022 7:23
14/10/2021,Suphan Buri,101,13613,835825,403209,432616,112708,112708,0,,,19/1/2022 7:23
14/10/2021,Surat Thani,290,15382,1072403,527376,545027,9650,6323,3327,71,27,19/1/2022 7:23
14/10/2021,Surin,60,15785,1376625,684726,691899,19225,19203,22,,,19/1/2022 7:23
14/10/2021,Sukhothai,19,5748,585595,283519,302076,18172,17814,358,,,19/1/2022 7:23
14/10/2021,Nong Khai,13,3339,516972,256377,260595,29617,29500,117,22,9,19/1/2022 7:23
14/10/2021,Nong Bua Lam Phu,16,4035,508984,253786,255198,3417,3402,15,,,19/1/2022 7:23
14/10/2021,Amnat Charoen,4,2857,376306,187145,189161,4821,4821,0,,,19/1/2022 7:23
14/10/2021,Udon Thani,146,20336,1566668,775641,791027,44698,44548,150,,,19/1/2022 7:23
14/10/2021,Uttaradit,28,4061,446617,217679,228938,16832,16832,0,,,19/1/2022 7:23
14/10/2021,Uthai Thani,6,3502,325234,158965,166269,4910,4910,0,,,19/1/2022 7:23
14/10/2021,Ubon Ratchathani,104,18290,1867597,932041,935556,60742,60742,0,45,12,19/1/2022 7:23
14/10/2021,Ang Thong,28,10881,275167,131646,143521,15302,15302,0,,,19/1/2022 7:23
14/10/2021,Chiang Rai,29,4052,1298092,630910,667182,116319,115525,794,56,12,19/1/2022 7:23
14/10/2021,Chiang Mai,337,14889,1788340,863999,924341,214715,212787,1928,61,20,19/1/2022 7:23
14/10/2021,Phetchaburi,134,20032,482659,232915,249744,301889,301778,111,,,19/1/2022 7:23
14/10/2021,Phetchabun,51,9944,978584,482468,496116,84525,84467,58,,,19/1/2022 7:23
14/10/2021,Loei,25,3299,638788,319998,318790,83583,83511,72,,,19/1/2022 7:23
14/10/2021,Phrae,0,1642,435038,209644,225394,19532,19532,0,46,12,19/1/2022 7:23
14/10/2021,Mae Hong Son,32,1113,285804,144781,141023,33309,33043,266, ,5,19/1/2022 7:23
14/10/2021,,0,173,,,,,,,,,19/1/2022 7:23
15/10/2021,Krabi,129,6221,479040,237966,241074,6644,6408,236,,,19/1/2022 7:23
15/10/2021,Bangkok,1068,413389,5534354,2596396,2937958,535508,483200,52308,57,31,19/1/2022 7:23
15/10/2021,Kanchanaburi,127,19630,894097,448418,445679,467938,467816,122,21,22,19/1/2022 7:23
15/10/2021,Kalasin,27,8366,975928,482318,493610,31863,31863,0,,,19/1/2022 7:23
15/10/2021,Kamphaeng Phet,44,7385,712417,351684,360733,10935,10935,0,,,19/1/2022 7:23
15/10/2021,Khon Kaen,213,17352,1791477,880238,911239,78172,78172,0,53,21,19/1/2022 7:23
15/10/2021,Chanthaburi,202,15570,536488,262258,274230,49181,49069,112,,,19/1/2022 7:23
15/10/2021,Chachoengsao,84,33670,723575,354550,369025,192208,192208,0,48,28,19/1/2022 7:23
15/10/2021,Chon Buri,469,98512,1582463,771883,810580,224103,223216,887,44,34,19/1/2022 7:23
15/10/2021,Chai Nat,2,2352,320853,154238,166615,25249,25249,0,,,19/1/2022 7:23
15/10/2021,Chaiyaphum,30,11106,1122445,554477,567968,24350,24317,33,,,19/1/2022 7:23
15/10/2021,Chumphon,122,11017,509477,251470,258007,7560,7560,0,,,19/1/2022 7:23
15/10/2021,Trang,177,7481,639979,312812,327167,7387,7387,0,,,19/1/2022 7:23
15/10/2021,Trat,25,6176,228426,112944,115482,51815,51639,176,,,19/1/2022 7:23
15/10/2021,Tak,190,19124,675561,341512,334049,23928,23928,0,,,19/1/2022 7:23
15/10/2021,Nakhon Nayok,19,10402,260324,128842,131482,21362,21362,0,,,19/1/2022 7:23
15/10/2021,Nakhon Pathom,81,33773,922078,442736,479342,37242,37188,54,59,20,19/1/2022 7:23
15/10/2021,Nakhon Phanom,5,4849,717013,357096,359917,22046,22046,0,,,19/1/2022 7:23
15/10/2021,Nakhon Ratchasima,174,27663,2634213,1294009,1340204,236917,235237,1680,40,14,19/1/2022 7:23
15/10/2021,Nakhon Si Thammarat,488,21494,1549297,764402,784895,10942,10942,0,,,19/1/2022 7:23
15/10/2021,Nakhon Sawan,137,12881,1035673,505014,530659,28921,28763,158,29,23,19/1/2022 7:23
15/10/2021,Nonthaburi,132,64062,1286596,598356,688240,32482,32370,112,33,20,19/1/2022 7:23
15/10/2021,Narathiwat,573,31389,809130,400257,408873,1549,1549,0,65,19,19/1/2022 7:23
15/10/2021,Nan,1,2376,475962,238027,237935,57643,57453,190,,,19/1/2022 7:23
15/10/2021,Bueng Kan,9,1861,421923,211450,210473,7313,7296,17,,,19/1/2022 7:23
15/10/2021,Buri Ram,37,16258,1579696,783590,796106,48708,48574,134,,,19/1/2022 7:23
15/10/2021,Pathum Thani,33,39493,1187933,562786,625147,26324,26147,177,46,36,19/1/2022 7:23
15/10/2021,Prachuap Khiri Khan,140,12694,553609,274647,278962,262017,261857,160,,,19/1/2022 7:23
15/10/2021,Prachin Buri,257,19880,495017,244513,250504,17246,17246,0,46,28,19/1/2022 7:23
15/10/2021,Pattani,645,28485,729218,360169,369049,1157,1157,0,,,19/1/2022 7:23
15/10/2021,Phra Nakhon Si Ayutthaya,108,29171,820377,393914,426463,161519,160956,563,27,33,19/1/2022 7:23
15/10/2021,Phayao,2,1764,465061,226262,238799,21386,21386,0,28,14,19/1/2022 7:23
15/10/2021,Phang-nga,93,3582,268081,133851,134230,28887,21873,7014,,,19/1/2022 7:23
15/10/2021,Phatthalung,172,6372,522590,254511,268079,3107,3107,0,,,19/1/2022 7:23
15/10/2021,Phichit,17,4424,529974,258338,271636,11935,11935,0,,,19/1/2022 7:23
15/10/2021,Phitsanulok,28,5396,847418,414640,432778,52678,52480,198,,,19/1/2022 7:23
15/10/2021,Phuket,158,13716,419194,198106,221088,91363,64142,27221,89,31,19/1/2022 7:23
15/10/2021,Maha Sarakham,15,10354,949130,465310,483820,12910,12885,25,,,19/1/2022 7:23
15/10/2021,Mukdahan,4,2181,351338,175540,175798,38043,38043,0,,,19/1/2022 7:23
15/10/2021,Yala,767,32994,542002,269804,272198,1327,1327,0,69,30,19/1/2022 7:23
15/10/2021,Yasothon,9,5638,533454,266097,267357,6476,6476,0,,,19/1/2022 7:23
15/10/2021,Ranong,25,9283,194681,98240,96441,5367,5367,0,,,19/1/2022 7:23
15/10/2021,Rayong,223,37740,750107,368398,381709,51424,51159,265,36,23,19/1/2022 7:23
15/10/2021,Ratchaburi,299,33706,868830,422350,446480,88889,88772,117,,,19/1/2022 7:23
15/10/2021,Roi Et,37,13198,1296284,642133,654151,17276,17276,0,,,19/1/2022 7:23
15/10/2021,Lop Buri,85,15626,739712,368713,370999,47834,47796,38,,,19/1/2022 7:23
15/10/2021,Lampang,23,2458,725564,353383,372181,28742,28577,165,49,13,19/1/2022 7:23
15/10/2021,Lamphun,42,2489,401381,192875,208506,18167,18018,149,,,19/1/2022 7:23
15/10/2021,Si Sa Ket,71,15870,1457005,725113,731892,29110,29110,0,,,19/1/2022 7:23
15/10/2021,Sakon Nakhon,4,7449,1146320,569525,576795,37911,37911,0,,,19/1/2022 7:23
15/10/2021,Songkhla,605,39166,1431655,697409,734246,9362,9358,4,78,34,19/1/2022 7:23
15/10/2021,Satun,98,3119,324638,161492,163146,4965,4960,5,66,40,19/1/2022 7:23
15/10/2021,Samut Prakarn,379,120666,1356083,645776,710307,30524,30346,178,,,19/1/2022 7:23
15/10/2021,Samut Songkhram,76,11008,191082,91247,99835,44761,44761,0,31,15,19/1/2022 7:23
15/10/2021,Samut Sakhon,89,108735,586194,282490,303704,20981,20981,0,57,37,19/1/2022 7:23
15/10/2021,Saraburi,184,29011,644040,316399,327641,62770,62680,90,42,54,19/1/2022 7:23
15/10/2021,Sa kaeo,51,15256,561690,280406,281284,11217,10519,698,17,13,19/1/2022 7:23
15/10/2021,Sing Buri,4,2756,204869,97319,107550,15147,15124,23,,,19/1/2022 7:23
15/10/2021,Suphan Buri,105,13718,835825,403209,432616,112708,112708,0,,,19/1/2022 7:23
15/10/2021,Surat Thani,199,15581,1072403,527376,545027,9650,6323,3327,79,31,19/1/2022 7:23
15/10/2021,Surin,76,15861,1376625,684726,691899,19225,19203,22,,,19/1/2022 7:23
15/10/2021,Sukhothai,3,5751,585595,283519,302076,18172,17814,358,,,19/1/2022 7:23
15/10/2021,Nong Khai,9,3348,516972,256377,260595,29617,29500,117,23,9,19/1/2022 7:23
15/10/2021,Nong Bua Lam Phu,5,4040,508984,253786,255198,3417,3402,15,,,19/1/2022 7:23
15/10/2021,Amnat Charoen,3,2860,376306,187145,189161,4821,4821,0,,,19/1/2022 7:23
15/10/2021,Udon Thani,141,20477,1566668,775641,791027,44698,44548,150,,,19/1/2022 7:23
15/10/2021,Uttaradit,16,4077,446617,217679,228938,16832,16832,0,,,19/1/2022 7:23
15/10/2021,Uthai Thani,4,3506,325234,158965,166269,4910,4910,0,,,19/1/2022 7:23
15/10/2021,Ubon Ratchathani,84,18374,1867597,932041,935556,60742,60742,0,23,10,19/1/2022 7:23
15/10/2021,Ang Thong,38,10919,275167,131646,143521,15302,15302,0,,,19/1/2022 7:23
15/10/2021,Chiang Rai,22,4074,1298092,630910,667182,116319,115525,794,34,7,19/1/2022 7:23
15/10/2021,Chiang Mai,233,15122,1788340,863999,924341,214715,212787,1928,49,15,19/1/2022 7:23
15/10/2021,Phetchaburi,76,20108,482659,232915,249744,301889,301778,111,,,19/1/2022 7:23
15/10/2021,Phetchabun,68,10012,978584,482468,496116,84525,84467,58,,,19/1/2022 7:23
15/10/2021,Loei,35,3334,638788,319998,318790,83583,83511,72,,,19/1/2022 7:23
15/10/2021,Phrae,3,1645,435038,209644,225394,19532,19532,0,28,12,19/1/2022 7:23
15/10/2021,Mae Hong Son,58,1171,285804,144781,141023,33309,33043,266,23,4,19/1/2022 7:23
15/10/2021,,0,173,,,,,,,,,19/1/2022 7:23
16/10/2021,Krabi,81,6302,479040,237966,241074,6644,6408,236,,,19/1/2022 7:23
16/10/2021,Bangkok,1086,414475,5534354,2596396,2937958,535508,483200,52308,57,17,19/1/2022 7:23
16/10/2021,Kanchanaburi,110,19740,894097,448418,445679,467938,467816,122,28,7,19/1/2022 7:23
16/10/2021,Kalasin,48,8414,975928,482318,493610,31863,31863,0,,,19/1/2022 7:23
16/10/2021,Kamphaeng Phet,8,7393,712417,351684,360733,10935,10935,0,,,19/1/2022 7:23
16/10/2021,Khon Kaen,270,17622,1791477,880238,911239,78172,78172,0,49,30,19/1/2022 7:23
16/10/2021,Chanthaburi,350,15920,536488,262258,274230,49181,49069,112,,,19/1/2022 7:23
16/10/2021,Chachoengsao,83,33753,723575,354550,369025,192208,192208,0,35,23,19/1/2022 7:23
16/10/2021,Chon Buri,473,98985,1582463,771883,810580,224103,223216,887,48,50,19/1/2022 7:23
16/10/2021,Chai Nat,2,2354,320853,154238,166615,25249,25249,0,,,19/1/2022 7:23
16/10/2021,Chaiyaphum,49,11155,1122445,554477,567968,24350,24317,33,,,19/1/2022 7:23
16/10/2021,Chumphon,161,11178,509477,251470,258007,7560,7560,0,,,19/1/2022 7:23
16/10/2021,Trang,190,7671,639979,312812,327167,7387,7387,0,,,19/1/2022 7:23
16/10/2021,Trat,93,6269,228426,112944,115482,51815,51639,176,,,19/1/2022 7:23
16/10/2021,Tak,232,19356,675561,341512,334049,23928,23928,0,,,19/1/2022 7:23
16/10/2021,Nakhon Nayok,85,10487,260324,128842,131482,21362,21362,0,,,19/1/2022 7:23
16/10/2021,Nakhon Pathom,63,33836,922078,442736,479342,37242,37188,54,53,9,19/1/2022 7:23
16/10/2021,Nakhon Phanom,0,4849,717013,357096,359917,22046,22046,0,,,19/1/2022 7:23
16/10/2021,Nakhon Ratchasima,207,27870,2634213,1294009,1340204,236917,235237,1680,40,14,19/1/2022 7:23
16/10/2021,Nakhon Si Thammarat,369,21863,1549297,764402,784895,10942,10942,0,,,19/1/2022 7:23
16/10/2021,Nakhon Sawan,146,13027,1035673,505014,530659,28921,28763,158,44,13,19/1/2022 7:23
16/10/2021,Nonthaburi,128,64190,1286596,598356,688240,32482,32370,112,32,19,19/1/2022 7:23
16/10/2021,Narathiwat,460,31849,809130,400257,408873,1549,1549,0,40,21,19/1/2022 7:23
16/10/2021,Nan,0,2376,475962,238027,237935,57643,57453,190,,,19/1/2022 7:23
16/10/2021,Bueng Kan,10,1871,421923,211450,210473,7313,7296,17,,,19/1/2022 7:23
16/10/2021,Buri Ram,32,16290,1579696,783590,796106,48708,48574,134,,,19/1/2022 7:23
16/10/2021,Pathum Thani,91,39584,1187933,562786,625147,26324,26147,177,69,19,19/1/2022 7:23
16/10/2021,Prachuap Khiri Khan,152,12846,553609,274647,278962,262017,261857,160,,,19/1/2022 7:23
16/10/2021,Prachin Buri,225,20105,495017,244513,250504,17246,17246,0,52,19,19/1/2022 7:23
16/10/2021,Pattani,561,29046,729218,360169,369049,1157,1157,0,,,19/1/2022 7:23
16/10/2021,Phra Nakhon Si Ayutthaya,96,29267,820377,393914,426463,161519,160956,563,43,29,19/1/2022 7:23
16/10/2021,Phayao,11,1775,465061,226262,238799,21386,21386,0,28,16,19/1/2022 7:23
16/10/2021,Phang-nga,94,3676,268081,133851,134230,28887,21873,7014,,,19/1/2022 7:23
16/10/2021,Phatthalung,131,6503,522590,254511,268079,3107,3107,0,,,19/1/2022 7:23
16/10/2021,Phichit,33,4457,529974,258338,271636,11935,11935,0,,,19/1/2022 7:23
16/10/2021,Phitsanulok,29,5425,847418,414640,432778,52678,52480,198,,,19/1/2022 7:23
16/10/2021,Phuket,156,13872,419194,198106,221088,91363,64142,27221,63,27,19/1/2022 7:23
16/10/2021,Maha Sarakham,34,10388,949130,465310,483820,12910,12885,25,,,19/1/2022 7:23
16/10/2021,Mukdahan,5,2186,351338,175540,175798,38043,38043,0,,,19/1/2022 7:23
16/10/2021,Yala,664,33658,542002,269804,272198,1327,1327,0,52,24,19/1/2022 7:23
16/10/2021,Yasothon,8,5646,533454,266097,267357,6476,6476,0,,,19/1/2022 7:23
16/10/2021,Ranong,26,9309,194681,98240,96441,5367,5367,0,,,19/1/2022 7:23
16/10/2021,Rayong,325,38065,750107,368398,381709,51424,51159,265,43,11,19/1/2022 7:23
16/10/2021,Ratchaburi,241,33947,868830,422350,446480,88889,88772,117,,,19/1/2022 7:23
16/10/2021,Roi Et,18,13216,1296284,642133,654151,17276,17276,0,,,19/1/2022 7:23
16/10/2021,Lop Buri,82,15708,739712,368713,370999,47834,47796,38,,,19/1/2022 7:23
16/10/2021,Lampang,21,2479,725564,353383,372181,28742,28577,165,40,14,19/1/2022 7:23
16/10/2021,Lamphun,23,2512,401381,192875,208506,18167,18018,149,,,19/1/2022 7:23
16/10/2021,Si Sa Ket,95,15965,1457005,725113,731892,29110,29110,0,,,19/1/2022 7:23
16/10/2021,Sakon Nakhon,25,7474,1146320,569525,576795,37911,37911,0,,,19/1/2022 7:23
16/10/2021,Songkhla,621,39787,1431655,697409,734246,9362,9358,4,68,24,19/1/2022 7:23
16/10/2021,Satun,98,3217,324638,161492,163146,4965,4960,5,76,29,19/1/2022 7:23
16/10/2021,Samut Prakarn,380,121046,1356083,645776,710307,30524,30346,178,,,19/1/2022 7:23
16/10/2021,Samut Songkhram,48,11056,191082,91247,99835,44761,44761,0,29,9,19/1/2022 7:23
16/10/2021,Samut Sakhon,106,108841,586194,282490,303704,20981,20981,0,55,18,19/1/2022 7:23
16/10/2021,Saraburi,138,29149,644040,316399,327641,62770,62680,90,46,56,19/1/2022 7:23
16/10/2021,Sa kaeo,121,15377,561690,280406,281284,11217,10519,698,22,9,19/1/2022 7:23
16/10/2021,Sing Buri,0,2756,204869,97319,107550,15147,15124,23,,,19/1/2022 7:23
16/10/2021,Suphan Buri,84,13802,835825,403209,432616,112708,112708,0,,,19/1/2022 7:23
16/10/2021,Surat Thani,181,15762,1072403,527376,545027,9650,6323,3327,73,29,19/1/2022 7:23
16/10/2021,Surin,109,15970,1376625,684726,691899,19225,19203,22,,,19/1/2022 7:23
16/10/2021,Sukhothai,25,5776,585595,283519,302076,18172,17814,358,,,19/1/2022 7:23
16/10/2021,Nong Khai,10,3358,516972,256377,260595,29617,29500,117,21,9,19/1/2022 7:23
16/10/2021,Nong Bua Lam Phu,14,4054,508984,253786,255198,3417,3402,15,,,19/1/2022 7:23
16/10/2021,Amnat Charoen,10,2870,376306,187145,189161,4821,4821,0,,,19/1/2022 7:23
16/10/2021,Udon Thani,133,20610,1566668,775641,791027,44698,44548,150,,,19/1/2022 7:23
16/10/2021,Uttaradit,12,4089,446617,217679,228938,16832,16832,0,,,19/1/2022 7:23
16/10/2021,Uthai Thani,3,3509,325234,158965,166269,4910,4910,0,,,19/1/2022 7:23
16/10/2021,Ubon Ratchathani,73,18447,1867597,932041,935556,60742,60742,0,18,8,19/1/2022 7:23
16/10/2021,Ang Thong,15,10934,275167,131646,143521,15302,15302,0,,,19/1/2022 7:23
16/10/2021,Chiang Rai,43,4117,1298092,630910,667182,116319,115525,794,17,10,19/1/2022 7:23
16/10/2021,Chiang Mai,278,15400,1788340,863999,924341,214715,212787,1928,36,16,19/1/2022 7:23
16/10/2021,Phetchaburi,121,20229,482659,232915,249744,301889,301778,111,,,19/1/2022 7:23
16/10/2021,Phetchabun,71,10083,978584,482468,496116,84525,84467,58,,,19/1/2022 7:23
16/10/2021,Loei,24,3358,638788,319998,318790,83583,83511,72,,,19/1/2022 7:23
16/10/2021,Phrae,4,1649,435038,209644,225394,19532,19532,0,28,17,19/1/2022 7:23
16/10/2021,Mae Hong Son,44,1215,285804,144781,141023,33309,33043,266,17,4,19/1/2022 7:23
16/10/2021,,0,173,,,,,,,,,19/1/2022 7:23
17/10/2021,Krabi,85,6387,479040,237966,241074,6644,6408,236,,,19/1/2022 7:23
17/10/2021,Bangkok,1074,415549,5534354,2596396,2937958,535508,483200,52308,38,23,19/1/2022 7:23
17/10/2021,Kanchanaburi,195,19935,894097,448418,445679,467938,467816,122,14,7,19/1/2022 7:23
17/10/2021,Kalasin,46,8460,975928,482318,493610,31863,31863,0,,,19/1/2022 7:23
17/10/2021,Kamphaeng Phet,28,7421,712417,351684,360733,10935,10935,0,,,19/1/2022 7:23
17/10/2021,Khon Kaen,231,17853,1791477,880238,911239,78172,78172,0,53,29,19/1/2022 7:23
17/10/2021,Chanthaburi,255,16175,536488,262258,274230,49181,49069,112,,,19/1/2022 7:23
17/10/2021,Chachoengsao,118,33871,723575,354550,369025,192208,192208,0,33,28,19/1/2022 7:23
17/10/2021,Chon Buri,401,99386,1582463,771883,810580,224103,223216,887,60,17,19/1/2022 7:23
17/10/2021,Chai Nat,3,2357,320853,154238,166615,25249,25249,0,,,19/1/2022 7:23
17/10/2021,Chaiyaphum,21,11176,1122445,554477,567968,24350,24317,33,,,19/1/2022 7:23
17/10/2021,Chumphon,123,11301,509477,251470,258007,7560,7560,0,,,19/1/2022 7:23
17/10/2021,Trang,183,7854,639979,312812,327167,7387,7387,0,,,19/1/2022 7:23
17/10/2021,Trat,88,6357,228426,112944,115482,51815,51639,176,,,19/1/2022 7:23
17/10/2021,Tak,202,19558,675561,341512,334049,23928,23928,0,,,19/1/2022 7:23
17/10/2021,Nakhon Nayok,53,10540,260324,128842,131482,21362,21362,0,,,19/1/2022 7:23
17/10/2021,Nakhon Pathom,110,33946,922078,442736,479342,37242,37188,54,47,13,19/1/2022 7:23
17/10/2021,Nakhon Phanom,2,4851,717013,357096,359917,22046,22046,0,,,19/1/2022 7:23
17/10/2021,Nakhon Ratchasima,158,28028,2634213,1294009,1340204,236917,235237,1680,42,10,19/1/2022 7:23
17/10/2021,Nakhon Si Thammarat,519,22382,1549297,764402,784895,10942,10942,0,,,19/1/2022 7:23
17/10/2021,Nakhon Sawan,168,13195,1035673,505014,530659,28921,28763,158,16,11,19/1/2022 7:23
17/10/2021,Nonthaburi,114,64304,1286596,598356,688240,32482,32370,112,28,19,19/1/2022 7:23
17/10/2021,Narathiwat,468,32317,809130,400257,408873,1549,1549,0,48,16,19/1/2022 7:23
17/10/2021,Nan,3,2379,475962,238027,237935,57643,57453,190,,,19/1/2022 7:23
17/10/2021,Bueng Kan,25,1896,421923,211450,210473,7313,7296,17,,,19/1/2022 7:23
17/10/2021,Buri Ram,32,16322,1579696,783590,796106,48708,48574,134,,,19/1/2022 7:23
17/10/2021,Pathum Thani,69,39653,1187933,562786,625147,26324,26147,177,34,13,19/1/2022 7:23
17/10/2021,Prachuap Khiri Khan,158,13004,553609,274647,278962,262017,261857,160,,,19/1/2022 7:23
17/10/2021,Prachin Buri,172,20277,495017,244513,250504,17246,17246,0,39,21,19/1/2022 7:23
17/10/2021,Pattani,648,29694,729218,360169,369049,1157,1157,0,,,19/1/2022 7:23
17/10/2021,Phra Nakhon Si Ayutthaya,107,29374,820377,393914,426463,161519,160956,563,23,38,19/1/2022 7:23
17/10/2021,Phayao,20,1795,465061,226262,238799,21386,21386,0,30,15,19/1/2022 7:23
17/10/2021,Phang-nga,98,3774,268081,133851,134230,28887,21873,7014,,,19/1/2022 7:23
17/10/2021,Phatthalung,195,6698,522590,254511,268079,3107,3107,0,,,19/1/2022 7:23
17/10/2021,Phichit,12,4469,529974,258338,271636,11935,11935,0,,,19/1/2022 7:23
17/10/2021,Phitsanulok,34,5459,847418,414640,432778,52678,52480,198,,,19/1/2022 7:23
17/10/2021,Phuket,149,14021,419194,198106,221088,91363,64142,27221,58,28,19/1/2022 7:23
17/10/2021,Maha Sarakham,30,10418,949130,465310,483820,12910,12885,25,,,19/1/2022 7:23
17/10/2021,Mukdahan,13,2199,351338,175540,175798,38043,38043,0,,,19/1/2022 7:23
17/10/2021,Yala,729,34387,542002,269804,272198,1327,1327,0,43,25,19/1/2022 7:23
17/10/2021,Yasothon,9,5655,533454,266097,267357,6476,6476,0,,,19/1/2022 7:23
17/10/2021,Ranong,29,9338,194681,98240,96441,5367,5367,0,,,19/1/2022 7:23
17/10/2021,Rayong,347,38412,750107,368398,381709,51424,51159,265,30,17,19/1/2022 7:23
17/10/2021,Ratchaburi,182,34129,868830,422350,446480,88889,88772,117,,,19/1/2022 7:23
17/10/2021,Roi Et,17,13233,1296284,642133,654151,17276,17276,0,,,19/1/2022 7:23
17/10/2021,Lop Buri,93,15801,739712,368713,370999,47834,47796,38,,,19/1/2022 7:23
17/10/2021,Lampang,17,2496,725564,353383,372181,28742,28577,165,46,16,19/1/2022 7:23
17/10/2021,Lamphun,12,2524,401381,192875,208506,18167,18018,149,,,19/1/2022 7:23
17/10/2021,Si Sa Ket,49,16014,1457005,725113,731892,29110,29110,0,,,19/1/2022 7:23
17/10/2021,Sakon Nakhon,10,7484,1146320,569525,576795,37911,37911,0,,,19/1/2022 7:23
17/10/2021,Songkhla,650,40437,1431655,697409,734246,9362,9358,4,53,29,19/1/2022 7:23
17/10/2021,Satun,94,3311,324638,161492,163146,4965,4960,5,60,37,19/1/2022 7:23
17/10/2021,Samut Prakarn,367,121413,1356083,645776,710307,30524,30346,178,,,19/1/2022 7:23
17/10/2021,Samut Songkhram,28,11084,191082,91247,99835,44761,44761,0,19,12,19/1/2022 7:23
17/10/2021,Samut Sakhon,94,108935,586194,282490,303704,20981,20981,0,33,19,19/1/2022 7:23
17/10/2021,Saraburi,186,29335,644040,316399,327641,62770,62680,90,50,49,19/1/2022 7:23
17/10/2021,Sa kaeo,86,15463,561690,280406,281284,11217,10519,698,13,10,19/1/2022 7:23
17/10/2021,Sing Buri,7,2763,204869,97319,107550,15147,15124,23,,,19/1/2022 7:23
17/10/2021,Suphan Buri,49,13851,835825,403209,432616,112708,112708,0,,,19/1/2022 7:23
17/10/2021,Surat Thani,210,15972,1072403,527376,545027,9650,6323,3327,68,29,19/1/2022 7:23
17/10/2021,Surin,68,16038,1376625,684726,691899,19225,19203,22,,,19/1/2022 7:23
17/10/2021,Sukhothai,29,5805,585595,283519,302076,18172,17814,358,,,19/1/2022 7:23
17/10/2021,Nong Khai,24,3382,516972,256377,260595,29617,29500,117,21,10,19/1/2022 7:23
17/10/2021,Nong Bua Lam Phu,37,4091,508984,253786,255198,3417,3402,15,,,19/1/2022 7:23
17/10/2021,Amnat Charoen,1,2871,376306,187145,189161,4821,4821,0,,,19/1/2022 7:23
17/10/2021,Udon Thani,153,20763,1566668,775641,791027,44698,44548,150,,,19/1/2022 7:23
17/10/2021,Uttaradit,8,4097,446617,217679,228938,16832,16832,0,,,19/1/2022 7:23
17/10/2021,Uthai Thani,1,3510,325234,158965,166269,4910,4910,0,,,19/1/2022 7:23
17/10/2021,Ubon Ratchathani,122,18569,1867597,932041,935556,60742,60742,0,14,16,19/1/2022 7:23
17/10/2021,Ang Thong,19,10953,275167,131646,143521,15302,15302,0,,,19/1/2022 7:23
17/10/2021,Chiang Rai,34,4151,1298092,630910,667182,116319,115525,794,27,18,19/1/2022 7:23
17/10/2021,Chiang Mai,360,15760,1788340,863999,924341,214715,212787,1928,40,23,19/1/2022 7:23
17/10/2021,Phetchaburi,136,20365,482659,232915,249744,301889,301778,111,,,19/1/2022 7:23
17/10/2021,Phetchabun,167,10250,978584,482468,496116,84525,84467,58,,,19/1/2022 7:23
17/10/2021,Loei,8,3366,638788,319998,318790,83583,83511,72,,,19/1/2022 7:23
17/10/2021,Phrae,8,1657,435038,209644,225394,19532,19532,0,34,20,19/1/2022 7:23
17/10/2021,Mae Hong Son,13,1228,285804,144781,141023,33309,33043,266,19,6,19/1/2022 7:23
17/10/2021,,0,173,,,,,,,,,19/1/2022 7:23
18/10/2021,Krabi,93,6480,479040,237966,241074,6644,6408,236,,,19/1/2022 7:23
18/10/2021,Bangkok,1052,416601,5534354,2596396,2937958,535508,483200,52308,48,38,19/1/2022 7:23
18/10/2021,Kanchanaburi,185,20120,894097,448418,445679,467938,467816,122,16,17,19/1/2022 7:23
18/10/2021,Kalasin,19,8479,975928,482318,493610,31863,31863,0,,,19/1/2022 7:23
18/10/2021,Kamphaeng Phet,26,7447,712417,351684,360733,10935,10935,0,,,19/1/2022 7:23
18/10/2021,Khon Kaen,225,18078,1791477,880238,911239,78172,78172,0,53,31,19/1/2022 7:23
18/10/2021,Chanthaburi,221,16396,536488,262258,274230,49181,49069,112,,,19/1/2022 7:23
18/10/2021,Chachoengsao,89,33960,723575,354550,369025,192208,192208,0,25,33,19/1/2022 7:23
18/10/2021,Chon Buri,358,99744,1582463,771883,810580,224103,223216,887,33,34,19/1/2022 7:23
18/10/2021,Chai Nat,1,2358,320853,154238,166615,25249,25249,0,,,19/1/2022 7:23
18/10/2021,Chaiyaphum,23,11199,1122445,554477,567968,24350,24317,33,,,19/1/2022 7:23
18/10/2021,Chumphon,116,11417,509477,251470,258007,7560,7560,0,,,19/1/2022 7:23
18/10/2021,Trang,212,8066,639979,312812,327167,7387,7387,0,,,19/1/2022 7:23
18/10/2021,Trat,60,6417,228426,112944,115482,51815,51639,176,,,19/1/2022 7:23
18/10/2021,Tak,202,19760,675561,341512,334049,23928,23928,0,,,19/1/2022 7:23
18/10/2021,Nakhon Nayok,11,10551,260324,128842,131482,21362,21362,0,,,19/1/2022 7:23
18/10/2021,Nakhon Pathom,73,34019,922078,442736,479342,37242,37188,54,39,27,19/1/2022 7:23
18/10/2021,Nakhon Phanom,3,4854,717013,357096,359917,22046,22046,0,,,19/1/2022 7:23
18/10/2021,Nakhon Ratchasima,153,28181,2634213,1294009,1340204,236917,235237,1680,35,26,19/1/2022 7:23
18/10/2021,Nakhon Si Thammarat,616,22998,1549297,764402,784895,10942,10942,0,,,19/1/2022 7:23
18/10/2021,Nakhon Sawan,126,13321,1035673,505014,530659,28921,28763,158,20,18,19/1/2022 7:23
18/10/2021,Nonthaburi,116,64420,1286596,598356,688240,32482,32370,112,31,26,19/1/2022 7:23
18/10/2021,Narathiwat,466,32783,809130,400257,408873,1549,1549,0,35,16,19/1/2022 7:23
18/10/2021,Nan,0,2379,475962,238027,237935,57643,57453,190,,,19/1/2022 7:23
18/10/2021,Bueng Kan,7,1903,421923,211450,210473,7313,7296,17,,,19/1/2022 7:23
18/10/2021,Buri Ram,29,16351,1579696,783590,796106,48708,48574,134,,,19/1/2022 7:23
18/10/2021,Pathum Thani,50,39703,1187933,562786,625147,26324,26147,177,29,33,19/1/2022 7:23
18/10/2021,Prachuap Khiri Khan,157,13161,553609,274647,278962,262017,261857,160,,,19/1/2022 7:23
18/10/2021,Prachin Buri,183,20460,495017,244513,250504,17246,17246,0,40,31,19/1/2022 7:23
18/10/2021,Pattani,503,30197,729218,360169,369049,1157,1157,0,,,19/1/2022 7:23
18/10/2021,Phra Nakhon Si Ayutthaya,70,29444,820377,393914,426463,161519,160956,563,23,37,19/1/2022 7:23
18/10/2021,Phayao,9,1804,465061,226262,238799,21386,21386,0,39,17,19/1/2022 7:23
18/10/2021,Phang-nga,96,3870,268081,133851,134230,28887,21873,7014,,,19/1/2022 7:23
18/10/2021,Phatthalung,230,6928,522590,254511,268079,3107,3107,0,,,19/1/2022 7:23
18/10/2021,Phichit,17,4486,529974,258338,271636,11935,11935,0,,,19/1/2022 7:23
18/10/2021,Phitsanulok,26,5485,847418,414640,432778,52678,52480,198,,,19/1/2022 7:23
18/10/2021,Phuket,145,14166,419194,198106,221088,91363,64142,27221,64,23,19/1/2022 7:23
18/10/2021,Maha Sarakham,32,10450,949130,465310,483820,12910,12885,25,,,19/1/2022 7:23
18/10/2021,Mukdahan,2,2201,351338,175540,175798,38043,38043,0,,,19/1/2022 7:23
18/10/2021,Yala,756,35143,542002,269804,272198,1327,1327,0,45,26,19/1/2022 7:23
18/10/2021,Yasothon,7,5662,533454,266097,267357,6476,6476,0,,,19/1/2022 7:23
18/10/2021,Ranong,36,9374,194681,98240,96441,5367,5367,0,,,19/1/2022 7:23
18/10/2021,Rayong,407,38819,750107,368398,381709,51424,51159,265,30,25,19/1/2022 7:23
18/10/2021,Ratchaburi,188,34317,868830,422350,446480,88889,88772,117,,,19/1/2022 7:23
18/10/2021,Roi Et,30,13263,1296284,642133,654151,17276,17276,0,,,19/1/2022 7:23
18/10/2021,Lop Buri,64,15865,739712,368713,370999,47834,47796,38,,,19/1/2022 7:23
18/10/2021,Lampang,11,2507,725564,353383,372181,28742,28577,165,49,18,19/1/2022 7:23
18/10/2021,Lamphun,18,2542,401381,192875,208506,18167,18018,149,,,19/1/2022 7:23
18/10/2021,Si Sa Ket,63,16077,1457005,725113,731892,29110,29110,0,,,19/1/2022 7:23
18/10/2021,Sakon Nakhon,12,7496,1146320,569525,576795,37911,37911,0,,,19/1/2022 7:23
18/10/2021,Songkhla,579,41016,1431655,697409,734246,9362,9358,4,60,21,19/1/2022 7:23
18/10/2021,Satun,99,3410,324638,161492,163146,4965,4960,5,59,22,19/1/2022 7:23
18/10/2021,Samut Prakarn,247,121660,1356083,645776,710307,30524,30346,178,,,19/1/2022 7:23
18/10/2021,Samut Songkhram,32,11116,191082,91247,99835,44761,44761,0,23,22,19/1/2022 7:23
18/10/2021,Samut Sakhon,78,109013,586194,282490,303704,20981,20981,0,35,33,19/1/2022 7:23
18/10/2021,Saraburi,132,29467,644040,316399,327641,62770,62680,90,39,80,19/1/2022 7:23
18/10/2021,Sa kaeo,65,15528,561690,280406,281284,11217,10519,698,20,21,19/1/2022 7:23
18/10/2021,Sing Buri,5,2768,204869,97319,107550,15147,15124,23,,,19/1/2022 7:23
18/10/2021,Suphan Buri,67,13918,835825,403209,432616,112708,112708,0,,,19/1/2022 7:23
18/10/2021,Surat Thani,227,16199,1072403,527376,545027,9650,6323,3327,62,31,19/1/2022 7:23
18/10/2021,Surin,116,16154,1376625,684726,691899,19225,19203,22,,,19/1/2022 7:23
18/10/2021,Sukhothai,10,5815,585595,283519,302076,18172,17814,358,,,19/1/2022 7:23
18/10/2021,Nong Khai,3,3385,516972,256377,260595,29617,29500,117,23,13,19/1/2022 7:23
18/10/2021,Nong Bua Lam Phu,8,4099,508984,253786,255198,3417,3402,15,,,19/1/2022 7:23
18/10/2021,Amnat Charoen,5,2876,376306,187145,189161,4821,4821,0,,,19/1/2022 7:23
18/10/2021,Udon Thani,158,20921,1566668,775641,791027,44698,44548,150,,,19/1/2022 7:23
18/10/2021,Uttaradit,7,4104,446617,217679,228938,16832,16832,0,,,19/1/2022 7:23
18/10/2021,Uthai Thani,4,3514,325234,158965,166269,4910,4910,0,,,19/1/2022 7:23
18/10/2021,Ubon Ratchathani,98,18667,1867597,932041,935556,60742,60742,0,21,15,19/1/2022 7:23
18/10/2021,Ang Thong,33,10986,275167,131646,143521,15302,15302,0,,,19/1/2022 7:23
18/10/2021,Chiang Rai,18,4169,1298092,630910,667182,116319,115525,794,48,15,19/1/2022 7:23
18/10/2021,Chiang Mai,314,16074,1788340,863999,924341,214715,212787,1928,48,21,19/1/2022 7:23
18/10/2021,Phetchaburi,139,20504,482659,232915,249744,301889,301778,111,,,19/1/2022 7:23
18/10/2021,Phetchabun,36,10286,978584,482468,496116,84525,84467,58,,,19/1/2022 7:23
18/10/2021,Loei,20,3386,638788,319998,318790,83583,83511,72, ,15,19/1/2022 7:23
18/10/2021,Phrae,8,1665,435038,209644,225394,19532,19532,0,38,19,19/1/2022 7:23
18/10/2021,Mae Hong Son,9,1237,285804,144781,141023,33309,33043,266,25,9,19/1/2022 7:23
18/10/2021,,0,173,,,,,,,,,19/1/2022 7:23
19/10/2021,Krabi,109,6589,479040,237966,241074,6644,6408,236,,,19/1/2022 7:23
19/10/2021,Bangkok,1038,417639,5534354,2596396,2937958,535508,483200,52308,72,45,19/1/2022 7:23
19/10/2021,Kanchanaburi,125,20245,894097,448418,445679,467938,467816,122,27,24,19/1/2022 7:23
19/10/2021,Kalasin,27,8506,975928,482318,493610,31863,31863,0,,,19/1/2022 7:23
19/10/2021,Kamphaeng Phet,7,7454,712417,351684,360733,10935,10935,0,,,19/1/2022 7:23
19/10/2021,Khon Kaen,237,18315,1791477,880238,911239,78172,78172,0,60,36,19/1/2022 7:23
19/10/2021,Chanthaburi,173,16569,536488,262258,274230,49181,49069,112,,,19/1/2022 7:23
19/10/2021,Chachoengsao,89,34049,723575,354550,369025,192208,192208,0,42,52,19/1/2022 7:23
19/10/2021,Chon Buri,313,100057,1582463,771883,810580,224103,223216,887,53,49,19/1/2022 7:23
19/10/2021,Chai Nat,5,2363,320853,154238,166615,25249,25249,0,,,19/1/2022 7:23
19/10/2021,Chaiyaphum,15,11214,1122445,554477,567968,24350,24317,33,,,19/1/2022 7:23
19/10/2021,Chumphon,99,11516,509477,251470,258007,7560,7560,0,,,19/1/2022 7:23
19/10/2021,Trang,187,8253,639979,312812,327167,7387,7387,0,,,19/1/2022 7:23
19/10/2021,Trat,40,6457,228426,112944,115482,51815,51639,176,,,19/1/2022 7:23
19/10/2021,Tak,166,19926,675561,341512,334049,23928,23928,0,,,19/1/2022 7:23
19/10/2021,Nakhon Nayok,8,10559,260324,128842,131482,21362,21362,0,,,19/1/2022 7:23
19/10/2021,Nakhon Pathom,65,34084,922078,442736,479342,37242,37188,54,69,31,19/1/2022 7:23
19/10/2021,Nakhon Phanom,0,4854,717013,357096,359917,22046,22046,0,,,19/1/2022 7:23
19/10/2021,Nakhon Ratchasima,159,28340,2634213,1294009,1340204,236917,235237,1680,54,29,19/1/2022 7:23
19/10/2021,Nakhon Si Thammarat,602,23600,1549297,764402,784895,10942,10942,0,,,19/1/2022 7:23
19/10/2021,Nakhon Sawan,135,13456,1035673,505014,530659,28921,28763,158,30,30,19/1/2022 7:23
19/10/2021,Nonthaburi,97,64517,1286596,598356,688240,32482,32370,112,46,27,19/1/2022 7:23
19/10/2021,Narathiwat,453,33236,809130,400257,408873,1549,1549,0,37,12,19/1/2022 7:23
19/10/2021,Nan,0,2379,475962,238027,237935,57643,57453,190,,,19/1/2022 7:23
19/10/2021,Bueng Kan,5,1908,421923,211450,210473,7313,7296,17,,,19/1/2022 7:23
19/10/2021,Buri Ram,33,16384,1579696,783590,796106,48708,48574,134,,,19/1/2022 7:23
19/10/2021,Pathum Thani,62,39765,1187933,562786,625147,26324,26147,177,60,30,19/1/2022 7:23
19/10/2021,Prachuap Khiri Khan,238,13399,553609,274647,278962,262017,261857,160,,,19/1/2022 7:23
19/10/2021,Prachin Buri,118,20578,495017,244513,250504,17246,17246,0,55,43,19/1/2022 7:23
19/10/2021,Pattani,621,30818,729218,360169,369049,1157,1157,0,,,19/1/2022 7:23
19/10/2021,Phra Nakhon Si Ayutthaya,64,29508,820377,393914,426463,161519,160956,563,39,39,19/1/2022 7:23
19/10/2021,Phayao,8,1812,465061,226262,238799,21386,21386,0,39,22,19/1/2022 7:23
19/10/2021,Phang-nga,34,3904,268081,133851,134230,28887,21873,7014,,,19/1/2022 7:23
19/10/2021,Phatthalung,208,7136,522590,254511,268079,3107,3107,0,,,19/1/2022 7:23
19/10/2021,Phichit,27,4513,529974,258338,271636,11935,11935,0,,,19/1/2022 7:23
19/10/2021,Phitsanulok,21,5506,847418,414640,432778,52678,52480,198,,,19/1/2022 7:23
19/10/2021,Phuket,142,14308,419194,198106,221088,91363,64142,27221,58,19,19/1/2022 7:23
19/10/2021,Maha Sarakham,25,10475,949130,465310,483820,12910,12885,25,,,19/1/2022 7:23
19/10/2021,Mukdahan,10,2211,351338,175540,175798,38043,38043,0,,,19/1/2022 7:23
19/10/2021,Yala,459,35602,542002,269804,272198,1327,1327,0,45,18,19/1/2022 7:23
19/10/2021,Yasothon,5,5667,533454,266097,267357,6476,6476,0,,,19/1/2022 7:23
19/10/2021,Ranong,24,9398,194681,98240,96441,5367,5367,0,,,19/1/2022 7:23
19/10/2021,Rayong,232,39051,750107,368398,381709,51424,51159,265,50,45,19/1/2022 7:23
19/10/2021,Ratchaburi,179,34496,868830,422350,446480,88889,88772,117,,,19/1/2022 7:23
19/10/2021,Roi Et,23,13286,1296284,642133,654151,17276,17276,0,,,19/1/2022 7:23
19/10/2021,Lop Buri,76,15941,739712,368713,370999,47834,47796,38,,,19/1/2022 7:23
19/10/2021,Lampang,15,2522,725564,353383,372181,28742,28577,165,53,15,19/1/2022 7:23
19/10/2021,Lamphun,18,2560,401381,192875,208506,18167,18018,149,,,19/1/2022 7:23
19/10/2021,Si Sa Ket,16,16093,1457005,725113,731892,29110,29110,0,,,19/1/2022 7:23
19/10/2021,Sakon Nakhon,6,7502,1146320,569525,576795,37911,37911,0,,,19/1/2022 7:23
19/10/2021,Songkhla,498,41514,1431655,697409,734246,9362,9358,4,42,32,19/1/2022 7:23
19/10/2021,Satun,98,3508,324638,161492,163146,4965,4960,5,48,26,19/1/2022 7:23
19/10/2021,Samut Prakarn,323,121983,1356083,645776,710307,30524,30346,178,,,19/1/2022 7:23
19/10/2021,Samut Songkhram,41,11157,191082,91247,99835,44761,44761,0,49,27,19/1/2022 7:23
19/10/2021,Samut Sakhon,89,109102,586194,282490,303704,20981,20981,0,57,39,19/1/2022 7:23
19/10/2021,Saraburi,139,29606,644040,316399,327641,62770,62680,90,46,78,19/1/2022 7:23
19/10/2021,Sa kaeo,56,15584,561690,280406,281284,11217,10519,698,36,21,19/1/2022 7:23
19/10/2021,Sing Buri,8,2776,204869,97319,107550,15147,15124,23,,,19/1/2022 7:23
19/10/2021,Suphan Buri,62,13980,835825,403209,432616,112708,112708,0,,,19/1/2022 7:23
19/10/2021,Surat Thani,202,16401,1072403,527376,545027,9650,6323,3327,47,36,19/1/2022 7:23
19/10/2021,Surin,121,16275,1376625,684726,691899,19225,19203,22,,,19/1/2022 7:23
19/10/2021,Sukhothai,14,5829,585595,283519,302076,18172,17814,358,,,19/1/2022 7:23
19/10/2021,Nong Khai,4,3389,516972,256377,260595,29617,29500,117,31,13,19/1/2022 7:23
19/10/2021,Nong Bua Lam Phu,18,4117,508984,253786,255198,3417,3402,15,,,19/1/2022 7:23
19/10/2021,Amnat Charoen,8,2884,376306,187145,189161,4821,4821,0,,,19/1/2022 7:23
19/10/2021,Udon Thani,121,21042,1566668,775641,791027,44698,44548,150,,,19/1/2022 7:23
19/10/2021,Uttaradit,2,4106,446617,217679,228938,16832,16832,0,,,19/1/2022 7:23
19/10/2021,Uthai Thani,5,3519,325234,158965,166269,4910,4910,0,,,19/1/2022 7:23
19/10/2021,Ubon Ratchathani,95,18762,1867597,932041,935556,60742,60742,0,25,15,19/1/2022 7:23
19/10/2021,Ang Thong,15,11001,275167,131646,143521,15302,15302,0,,,19/1/2022 7:23
19/10/2021,Chiang Rai,18,4187,1298092,630910,667182,116319,115525,794,44,12,19/1/2022 7:23
19/10/2021,Chiang Mai,199,16273,1788340,863999,924341,214715,212787,1928,51,26,19/1/2022 7:23
19/10/2021,Phetchaburi,109,20613,482659,232915,249744,301889,301778,111,,,19/1/2022 7:23
19/10/2021,Phetchabun,18,10304,978584,482468,496116,84525,84467,58,,,19/1/2022 7:23
19/10/2021,Loei,10,3396,638788,319998,318790,83583,83511,72,23,14,19/1/2022 7:23
19/10/2021,Phrae,22,1687,435038,209644,225394,19532,19532,0,42,19,19/1/2022 7:23
19/10/2021,Mae Hong Son,9,1246,285804,144781,141023,33309,33043,266,36,11,19/1/2022 7:23
19/10/2021,,0,173,,,,,,,,,19/1/2022 7:23
20/10/2021,Krabi,93,6682,479040,237966,241074,6644,6408,236,,,19/1/2022 7:23
20/10/2021,Bangkok,1050,418689,5534354,2596396,2937958,535508,483200,52308,87,50,19/1/2022 7:23
20/10/2021,Kanchanaburi,68,20313,894097,448418,445679,467938,467816,122,39,25,19/1/2022 7:23
20/10/2021,Kalasin,55,8561,975928,482318,493610,31863,31863,0,,,19/1/2022 7:23
20/10/2021,Kamphaeng Phet,35,7489,712417,351684,360733,10935,10935,0,,,19/1/2022 7:23
20/10/2021,Khon Kaen,232,18547,1791477,880238,911239,78172,78172,0,69,39,19/1/2022 7:23
20/10/2021,Chanthaburi,265,16834,536488,262258,274230,49181,49069,112,,,19/1/2022 7:23
20/10/2021,Chachoengsao,88,34137,723575,354550,369025,192208,192208,0,101,42,19/1/2022 7:23
20/10/2021,Chon Buri,329,100386,1582463,771883,810580,224103,223216,887,85,43,19/1/2022 7:23
20/10/2021,Chai Nat,4,2367,320853,154238,166615,25249,25249,0,,,19/1/2022 7:23
20/10/2021,Chaiyaphum,20,11234,1122445,554477,567968,24350,24317,33,,,19/1/2022 7:23
20/10/2021,Chumphon,126,11642,509477,251470,258007,7560,7560,0,,,19/1/2022 7:23
20/10/2021,Trang,197,8450,639979,312812,327167,7387,7387,0,,,19/1/2022 7:23
20/10/2021,Trat,102,6559,228426,112944,115482,51815,51639,176,,,19/1/2022 7:23
20/10/2021,Tak,220,20146,675561,341512,334049,23928,23928,0,,,19/1/2022 7:23
20/10/2021,Nakhon Nayok,46,10605,260324,128842,131482,21362,21362,0,,,19/1/2022 7:23
20/10/2021,Nakhon Pathom,47,34131,922078,442736,479342,37242,37188,54,67,35,19/1/2022 7:23
20/10/2021,Nakhon Phanom,1,4855,717013,357096,359917,22046,22046,0,,,19/1/2022 7:23
20/10/2021,Nakhon Ratchasima,172,28512,2634213,1294009,1340204,236917,235237,1680,62,25,19/1/2022 7:23
20/10/2021,Nakhon Si Thammarat,267,23867,1549297,764402,784895,10942,10942,0,,,19/1/2022 7:23
20/10/2021,Nakhon Sawan,131,13587,1035673,505014,530659,28921,28763,158,60,37,19/1/2022 7:23
20/10/2021,Nonthaburi,87,64604,1286596,598356,688240,32482,32370,112,51,25,19/1/2022 7:23
20/10/2021,Narathiwat,285,33521,809130,400257,408873,1549,1549,0,25,15,19/1/2022 7:23
20/10/2021,Nan,0,2379,475962,238027,237935,57643,57453,190,,,19/1/2022 7:23
20/10/2021,Bueng Kan,1,1909,421923,211450,210473,7313,7296,17,,,19/1/2022 7:23
20/10/2021,Buri Ram,31,16415,1579696,783590,796106,48708,48574,134,,,19/1/2022 7:23
20/10/2021,Pathum Thani,29,39794,1187933,562786,625147,26324,26147,177,59,38,19/1/2022 7:23
20/10/2021,Prachuap Khiri Khan,113,13512,553609,274647,278962,262017,261857,160,,,19/1/2022 7:23
20/10/2021,Prachin Buri,241,20819,495017,244513,250504,17246,17246,0,72,35,19/1/2022 7:23
20/10/2021,Pattani,520,31338,729218,360169,369049,1157,1157,0,,,19/1/2022 7:23
20/10/2021,Phra Nakhon Si Ayutthaya,55,29563,820377,393914,426463,161519,160956,563,46,38,19/1/2022 7:23
20/10/2021,Phayao,4,1816,465061,226262,238799,21386,21386,0,38,21,19/1/2022 7:23
20/10/2021,Phang-nga,85,3989,268081,133851,134230,28887,21873,7014,,,19/1/2022 7:23
20/10/2021,Phatthalung,79,7215,522590,254511,268079,3107,3107,0,,,19/1/2022 7:23
20/10/2021,Phichit,35,4548,529974,258338,271636,11935,11935,0,,,19/1/2022 7:23
20/10/2021,Phitsanulok,28,5534,847418,414640,432778,52678,52480,198,,,19/1/2022 7:23
20/10/2021,Phuket,138,14446,419194,198106,221088,91363,64142,27221,54,19,19/1/2022 7:23
20/10/2021,Maha Sarakham,32,10507,949130,465310,483820,12910,12885,25,,,19/1/2022 7:23
20/10/2021,Mukdahan,9,2220,351338,175540,175798,38043,38043,0,,,19/1/2022 7:23
20/10/2021,Yala,704,36306,542002,269804,272198,1327,1327,0,33,23,19/1/2022 7:23
20/10/2021,Yasothon,29,5696,533454,266097,267357,6476,6476,0,,,19/1/2022 7:23
20/10/2021,Ranong,22,9420,194681,98240,96441,5367,5367,0,,,19/1/2022 7:23
20/10/2021,Rayong,146,39197,750107,368398,381709,51424,51159,265,92,28,19/1/2022 7:23
20/10/2021,Ratchaburi,189,34685,868830,422350,446480,88889,88772,117,,,19/1/2022 7:23
20/10/2021,Roi Et,14,13300,1296284,642133,654151,17276,17276,0,,,19/1/2022 7:23
20/10/2021,Lop Buri,24,15965,739712,368713,370999,47834,47796,38,,,19/1/2022 7:23
20/10/2021,Lampang,26,2548,725564,353383,372181,28742,28577,165,47,16,19/1/2022 7:23
20/10/2021,Lamphun,17,2577,401381,192875,208506,18167,18018,149,,,19/1/2022 7:23
20/10/2021,Si Sa Ket,53,16146,1457005,725113,731892,29110,29110,0,,,19/1/2022 7:23
20/10/2021,Sakon Nakhon,16,7518,1146320,569525,576795,37911,37911,0,,,19/1/2022 7:23
20/10/2021,Songkhla,484,41998,1431655,697409,734246,9362,9358,4,63,29,19/1/2022 7:23
20/10/2021,Satun,93,3601,324638,161492,163146,4965,4960,5,53,19,19/1/2022 7:23
20/10/2021,Samut Prakarn,359,122342,1356083,645776,710307,30524,30346,178,,,19/1/2022 7:23
20/10/2021,Samut Songkhram,33,11190,191082,91247,99835,44761,44761,0,60,28,19/1/2022 7:23
20/10/2021,Samut Sakhon,74,109176,586194,282490,303704,20981,20981,0,65,90,19/1/2022 7:23
20/10/2021,Saraburi,111,29717,644040,316399,327641,62770,62680,90, ,78,19/1/2022 7:23
20/10/2021,Sa kaeo,61,15645,561690,280406,281284,11217,10519,698,38,19,19/1/2022 7:23
20/10/2021,Sing Buri,4,2780,204869,97319,107550,15147,15124,23,,,19/1/2022 7:23
20/10/2021,Suphan Buri,41,14021,835825,403209,432616,112708,112708,0,,,19/1/2022 7:23
20/10/2021,Surat Thani,245,16646,1072403,527376,545027,9650,6323,3327,,,19/1/2022 7:23
20/10/2021,Surin,89,16364,1376625,684726,691899,19225,19203,22,,,19/1/2022 7:23
20/10/2021,Sukhothai,29,5858,585595,283519,302076,18172,17814,358,,,19/1/2022 7:23
20/10/2021,Nong Khai,17,3406,516972,256377,260595,29617,29500,117,32,10,19/1/2022 7:23
20/10/2021,Nong Bua Lam Phu,5,4122,508984,253786,255198,3417,3402,15,,,19/1/2022 7:23
20/10/2021,Amnat Charoen,7,2891,376306,187145,189161,4821,4821,0,,,19/1/2022 7:23
20/10/2021,Udon Thani,89,21131,1566668,775641,791027,44698,44548,150,,,19/1/2022 7:23
20/10/2021,Uttaradit,20,4126,446617,217679,228938,16832,16832,0,,,19/1/2022 7:23
20/10/2021,Uthai Thani,2,3521,325234,158965,166269,4910,4910,0,,,19/1/2022 7:23
20/10/2021,Ubon Ratchathani,65,18827,1867597,932041,935556,60742,60742,0,28,15,19/1/2022 7:23
20/10/2021,Ang Thong,2,11003,275167,131646,143521,15302,15302,0,,,19/1/2022 7:23
20/10/2021,Chiang Rai,15,4202,1298092,630910,667182,116319,115525,794,33,14,19/1/2022 7:23
20/10/2021,Chiang Mai,294,16567,1788340,863999,924341,214715,212787,1928,56,24,19/1/2022 7:23
20/10/2021,Phetchaburi,150,20763,482659,232915,249744,301889,301778,111,,,19/1/2022 7:23
20/10/2021,Phetchabun,30,10334,978584,482468,496116,84525,84467,58,,,19/1/2022 7:23
20/10/2021,Loei,7,3403,638788,319998,318790,83583,83511,72,24,14,19/1/2022 7:23
20/10/2021,Phrae,22,1709,435038,209644,225394,19532,19532,0,42,21,19/1/2022 7:23
20/10/2021,Mae Hong Son,10,1256,285804,144781,141023,33309,33043,266,43,10,19/1/2022 7:23
20/10/2021,,0,173,,,,,,,,,19/1/2022 7:23
21/10/2021,Krabi,87,6769,479040,237966,241074,6644,6408,236,,,19/1/2022 7:23
21/10/2021,Bangkok,1017,419706,5534354,2596396,2937958,535508,483200,52308,97,37,19/1/2022 7:23
21/10/2021,Kanchanaburi,87,20400,894097,448418,445679,467938,467816,122,45,15,19/1/2022 7:23
21/10/2021,Kalasin,16,8577,975928,482318,493610,31863,31863,0,,,19/1/2022 7:23
21/10/2021,Kamphaeng Phet,12,7501,712417,351684,360733,10935,10935,0,,,19/1/2022 7:23
21/10/2021,Khon Kaen,167,18714,1791477,880238,911239,78172,78172,0,73,28,19/1/2022 7:23
21/10/2021,Chanthaburi,177,17011,536488,262258,274230,49181,49069,112,,,19/1/2022 7:23
21/10/2021,Chachoengsao,89,34226,723575,354550,369025,192208,192208,0,86,37,19/1/2022 7:23
21/10/2021,Chon Buri,359,100745,1582463,771883,810580,224103,223216,887,82,28,19/1/2022 7:23
21/10/2021,Chai Nat,0,2367,320853,154238,166615,25249,25249,0,,,19/1/2022 7:23
21/10/2021,Chaiyaphum,38,11272,1122445,554477,567968,24350,24317,33,,,19/1/2022 7:23
21/10/2021,Chumphon,124,11766,509477,251470,258007,7560,7560,0,,,19/1/2022 7:23
21/10/2021,Trang,187,8637,639979,312812,327167,7387,7387,0,,,19/1/2022 7:23
21/10/2021,Trat,72,6631,228426,112944,115482,51815,51639,176,,,19/1/2022 7:23
21/10/2021,Tak,178,20324,675561,341512,334049,23928,23928,0,,,19/1/2022 7:23
21/10/2021,Nakhon Nayok,50,10655,260324,128842,131482,21362,21362,0,,,19/1/2022 7:23
21/10/2021,Nakhon Pathom,74,34205,922078,442736,479342,37242,37188,54,75,23,19/1/2022 7:23
21/10/2021,Nakhon Phanom,6,4861,717013,357096,359917,22046,22046,0,,,19/1/2022 7:23
21/10/2021,Nakhon Ratchasima,63,28575,2634213,1294009,1340204,236917,235237,1680,57,22,19/1/2022 7:23
21/10/2021,Nakhon Si Thammarat,630,24497,1549297,764402,784895,10942,10942,0,,,19/1/2022 7:23
21/10/2021,Nakhon Sawan,161,13748,1035673,505014,530659,28921,28763,158,72,29,19/1/2022 7:23
21/10/2021,Nonthaburi,94,64698,1286596,598356,688240,32482,32370,112,59,23,19/1/2022 7:23
21/10/2021,Narathiwat,375,33896,809130,400257,408873,1549,1549,0,33,17,19/1/2022 7:23
21/10/2021,Nan,0,2379,475962,238027,237935,57643,57453,190,,,19/1/2022 7:23
21/10/2021,Bueng Kan,2,1911,421923,211450,210473,7313,7296,17,,,19/1/2022 7:23
21/10/2021,Buri Ram,25,16440,1579696,783590,796106,48708,48574,134,,,19/1/2022 7:23
21/10/2021,Pathum Thani,83,39877,1187933,562786,625147,26324,26147,177,77,31,19/1/2022 7:23
21/10/2021,Prachuap Khiri Khan,182,13694,553609,274647,278962,262017,261857,160,,,19/1/2022 7:23
21/10/2021,Prachin Buri,186,21005,495017,244513,250504,17246,17246,0,60,32,19/1/2022 7:23
21/10/2021,Pattani,544,31882,729218,360169,369049,1157,1157,0,,,19/1/2022 7:23
21/10/2021,Phra Nakhon Si Ayutthaya,85,29648,820377,393914,426463,161519,160956,563,54,43,19/1/2022 7:23
21/10/2021,Phayao,17,1833,465061,226262,238799,21386,21386,0,43,13,19/1/2022 7:23
21/10/2021,Phang-nga,95,4084,268081,133851,134230,28887,21873,7014,,,19/1/2022 7:23
21/10/2021,Phatthalung,190,7405,522590,254511,268079,3107,3107,0,,,19/1/2022 7:23
21/10/2021,Phichit,15,4563,529974,258338,271636,11935,11935,0,,,19/1/2022 7:23
21/10/2021,Phitsanulok,32,5566,847418,414640,432778,52678,52480,198,,,19/1/2022 7:23
21/10/2021,Phuket,155,14601,419194,198106,221088,91363,64142,27221,49,21,19/1/2022 7:23
21/10/2021,Maha Sarakham,40,10547,949130,465310,483820,12910,12885,25,,,19/1/2022 7:23
21/10/2021,Mukdahan,5,2225,351338,175540,175798,38043,38043,0,,,19/1/2022 7:23
21/10/2021,Yala,661,36967,542002,269804,272198,1327,1327,0,40,25,19/1/2022 7:23
21/10/2021,Yasothon,9,5705,533454,266097,267357,6476,6476,0,,,19/1/2022 7:23
21/10/2021,Ranong,19,9439,194681,98240,96441,5367,5367,0,,,19/1/2022 7:23
21/10/2021,Rayong,301,39498,750107,368398,381709,51424,51159,265,71,22,19/1/2022 7:23
21/10/2021,Ratchaburi,161,34846,868830,422350,446480,88889,88772,117,,,19/1/2022 7:23
21/10/2021,Roi Et,16,13316,1296284,642133,654151,17276,17276,0,,,19/1/2022 7:23
21/10/2021,Lop Buri,68,16033,739712,368713,370999,47834,47796,38,,,19/1/2022 7:23
21/10/2021,Lampang,10,2558,725564,353383,372181,28742,28577,165,50,15,19/1/2022 7:23
21/10/2021,Lamphun,12,2589,401381,192875,208506,18167,18018,149,,,19/1/2022 7:23
21/10/2021,Si Sa Ket,27,16173,1457005,725113,731892,29110,29110,0,,,19/1/2022 7:23
21/10/2021,Sakon Nakhon,6,7524,1146320,569525,576795,37911,37911,0,,,19/1/2022 7:23
21/10/2021,Songkhla,634,42632,1431655,697409,734246,9362,9358,4,55,32,19/1/2022 7:23
21/10/2021,Satun,144,3745,324638,161492,163146,4965,4960,5,39,27,19/1/2022 7:23
21/10/2021,Samut Prakarn,329,122671,1356083,645776,710307,30524,30346,178,,,19/1/2022 7:23
21/10/2021,Samut Songkhram,27,11217,191082,91247,99835,44761,44761,0,69,12,19/1/2022 7:23
21/10/2021,Samut Sakhon,105,109281,586194,282490,303704,20981,20981,0,97,40,19/1/2022 7:23
21/10/2021,Saraburi,126,29843,644040,316399,327641,62770,62680,90,21,75,19/1/2022 7:23
21/10/2021,Sa kaeo,85,15730,561690,280406,281284,11217,10519,698,31,16,19/1/2022 7:23
21/10/2021,Sing Buri,9,2789,204869,97319,107550,15147,15124,23,,,19/1/2022 7:23
21/10/2021,Suphan Buri,49,14070,835825,403209,432616,112708,112708,0,,,19/1/2022 7:23
21/10/2021,Surat Thani,238,16884,1072403,527376,545027,9650,6323,3327,,,19/1/2022 7:23
21/10/2021,Surin,17,16381,1376625,684726,691899,19225,19203,22,,,19/1/2022 7:23
21/10/2021,Sukhothai,11,5869,585595,283519,302076,18172,17814,358,,,19/1/2022 7:23
21/10/2021,Nong Khai,22,3428,516972,256377,260595,29617,29500,117,27,12,19/1/2022 7:23
21/10/2021,Nong Bua Lam Phu,20,4142,508984,253786,255198,3417,3402,15,,,19/1/2022 7:23
21/10/2021,Amnat Charoen,1,2892,376306,187145,189161,4821,4821,0,,,19/1/2022 7:23
21/10/2021,Udon Thani,117,21248,1566668,775641,791027,44698,44548,150,,,19/1/2022 7:23
21/10/2021,Uttaradit,5,4131,446617,217679,228938,16832,16832,0,,,19/1/2022 7:23
21/10/2021,Uthai Thani,1,3522,325234,158965,166269,4910,4910,0,,,19/1/2022 7:23
21/10/2021,Ubon Ratchathani,97,18924,1867597,932041,935556,60742,60742,0,32,14,19/1/2022 7:23
21/10/2021,Ang Thong,21,11024,275167,131646,143521,15302,15302,0,,,19/1/2022 7:23
21/10/2021,Chiang Rai,16,4218,1298092,630910,667182,116319,115525,794,36,11,19/1/2022 7:23
21/10/2021,Chiang Mai,357,16924,1788340,863999,924341,214715,212787,1928,50,20,19/1/2022 7:23
21/10/2021,Phetchaburi,165,20928,482659,232915,249744,301889,301778,111,,,19/1/2022 7:23
21/10/2021,Phetchabun,75,10409,978584,482468,496116,84525,84467,58,,,19/1/2022 7:23
21/10/2021,Loei,10,3413,638788,319998,318790,83583,83511,72,28,9,19/1/2022 7:23
21/10/2021,Phrae,8,1717,435038,209644,225394,19532,19532,0,49,14,19/1/2022 7:23
21/10/2021,Mae Hong Son,29,1285,285804,144781,141023,33309,33043,266,40,6,19/1/2022 7:23
21/10/2021,,0,173,,,,,,,,,19/1/2022 7:23
22/10/2021,Krabi,91,6860,479040,237966,241074,6644,6408,236,,,19/1/2022 7:23
22/10/2021,Bangkok,984,420690,5534354,2596396,2937958,535508,483200,52308,75,29,19/1/2022 7:23
22/10/2021,Kanchanaburi,125,20525,894097,448418,445679,467938,467816,122,30,13,19/1/2022 7:23
22/10/2021,Kalasin,43,8620,975928,482318,493610,31863,31863,0,,,19/1/2022 7:23
22/10/2021,Kamphaeng Phet,18,7519,712417,351684,360733,10935,10935,0,,,19/1/2022 7:23
22/10/2021,Khon Kaen,172,18886,1791477,880238,911239,78172,78172,0,57,25,19/1/2022 7:23
22/10/2021,Chanthaburi,248,17259,536488,262258,274230,49181,49069,112,,,19/1/2022 7:23
22/10/2021,Chachoengsao,88,34314,723575,354550,369025,192208,192208,0,54,29,19/1/2022 7:23
22/10/2021,Chon Buri,299,101044,1582463,771883,810580,224103,223216,887,53,23,19/1/2022 7:23
22/10/2021,Chai Nat,2,2369,320853,154238,166615,25249,25249,0,,,19/1/2022 7:23
22/10/2021,Chaiyaphum,25,11297,1122445,554477,567968,24350,24317,33,,,19/1/2022 7:23
22/10/2021,Chumphon,118,11884,509477,251470,258007,7560,7560,0,,,19/1/2022 7:23
22/10/2021,Trang,207,8844,639979,312812,327167,7387,7387,0,,,19/1/2022 7:23
22/10/2021,Trat,42,6673,228426,112944,115482,51815,51639,176,,,19/1/2022 7:23
22/10/2021,Tak,309,20633,675561,341512,334049,23928,23928,0,,,19/1/2022 7:23
22/10/2021,Nakhon Nayok,29,10684,260324,128842,131482,21362,21362,0,,,19/1/2022 7:23
22/10/2021,Nakhon Pathom,88,34293,922078,442736,479342,37242,37188,54,56,23,19/1/2022 7:23
22/10/2021,Nakhon Phanom,1,4862,717013,357096,359917,22046,22046,0,,,19/1/2022 7:23
22/10/2021,Nakhon Ratchasima,97,28672,2634213,1294009,1340204,236917,235237,1680,50,15,19/1/2022 7:23
22/10/2021,Nakhon Si Thammarat,664,25161,1549297,764402,784895,10942,10942,0,,,19/1/2022 7:23
22/10/2021,Nakhon Sawan,134,13882,1035673,505014,530659,28921,28763,158,59,22,19/1/2022 7:23
22/10/2021,Nonthaburi,94,64792,1286596,598356,688240,32482,32370,112,47,22,19/1/2022 7:23
22/10/2021,Narathiwat,306,34202,809130,400257,408873,1549,1549,0,36,15,19/1/2022 7:23
22/10/2021,Nan,0,2379,475962,238027,237935,57643,57453,190,,,19/1/2022 7:23
22/10/2021,Bueng Kan,3,1914,421923,211450,210473,7313,7296,17,,,19/1/2022 7:23
22/10/2021,Buri Ram,30,16470,1579696,783590,796106,48708,48574,134,,,19/1/2022 7:23
22/10/2021,Pathum Thani,82,39959,1187933,562786,625147,26324,26147,177,59,33,19/1/2022 7:23
22/10/2021,Prachuap Khiri Khan,344,14038,553609,274647,278962,262017,261857,160,,,19/1/2022 7:23
22/10/2021,Prachin Buri,209,21214,495017,244513,250504,17246,17246,0,58,26,19/1/2022 7:23
22/10/2021,Pattani,425,32307,729218,360169,369049,1157,1157,0,,,19/1/2022 7:23
22/10/2021,Phra Nakhon Si Ayutthaya,75,29723,820377,393914,426463,161519,160956,563,56,40,19/1/2022 7:23
22/10/2021,Phayao,20,1853,465061,226262,238799,21386,21386,0,31,11,19/1/2022 7:23
22/10/2021,Phang-nga,68,4152,268081,133851,134230,28887,21873,7014,,,19/1/2022 7:23
22/10/2021,Phatthalung,20,7425,522590,254511,268079,3107,3107,0,,,19/1/2022 7:23
22/10/2021,Phichit,20,4583,529974,258338,271636,11935,11935,0,,,19/1/2022 7:23
22/10/2021,Phitsanulok,33,5599,847418,414640,432778,52678,52480,198,,,19/1/2022 7:23
22/10/2021,Phuket,127,14728,419194,198106,221088,91363,64142,27221,51,24,19/1/2022 7:23
22/10/2021,Maha Sarakham,23,10570,949130,465310,483820,12910,12885,25,,,19/1/2022 7:23
22/10/2021,Mukdahan,4,2229,351338,175540,175798,38043,38043,0,,,19/1/2022 7:23
22/10/2021,Yala,432,37399,542002,269804,272198,1327,1327,0,45,19,19/1/2022 7:23
22/10/2021,Yasothon,18,5723,533454,266097,267357,6476,6476,0,,,19/1/2022 7:23
22/10/2021,Ranong,18,9457,194681,98240,96441,5367,5367,0,,,19/1/2022 7:23
22/10/2021,Rayong,228,39726,750107,368398,381709,51424,51159,265,62,18,19/1/2022 7:23
22/10/2021,Ratchaburi,238,35084,868830,422350,446480,88889,88772,117,,,19/1/2022 7:23
22/10/2021,Roi Et,13,13329,1296284,642133,654151,17276,17276,0,,,19/1/2022 7:23
22/10/2021,Lop Buri,62,16095,739712,368713,370999,47834,47796,38,,,19/1/2022 7:23
22/10/2021,Lampang,7,2565,725564,353383,372181,28742,28577,165,50, ,19/1/2022 7:23
22/10/2021,Lamphun,4,2593,401381,192875,208506,18167,18018,149,,,19/1/2022 7:23
22/10/2021,Si Sa Ket,81,16254,1457005,725113,731892,29110,29110,0,,,19/1/2022 7:23
22/10/2021,Sakon Nakhon,18,7542,1146320,569525,576795,37911,37911,0,,,19/1/2022 7:23
22/10/2021,Songkhla,689,43321,1431655,697409,734246,9362,9358,4,64,37,19/1/2022 7:23
22/10/2021,Satun,138,3883,324638,161492,163146,4965,4960,5,55,25,19/1/2022 7:23
22/10/2021,Samut Prakarn,315,122986,1356083,645776,710307,30524,30346,178,,,19/1/2022 7:23
22/10/2021,Samut Songkhram,29,11246,191082,91247,99835,44761,44761,0,29,10,19/1/2022 7:23
22/10/2021,Samut Sakhon,84,109365,586194,282490,303704,20981,20981,0,69,29,19/1/2022 7:23
22/10/2021,Saraburi,115,29958,644040,316399,327641,62770,62680,90,23,52,19/1/2022 7:23
22/10/2021,Sa kaeo,151,15881,561690,280406,281284,11217,10519,698,27,14,19/1/2022 7:23
22/10/2021,Sing Buri,8,2797,204869,97319,107550,15147,15124,23,,,19/1/2022 7:23
22/10/2021,Suphan Buri,66,14136,835825,403209,432616,112708,112708,0,,,19/1/2022 7:23
22/10/2021,Surat Thani,241,17125,1072403,527376,545027,9650,6323,3327,56,27,19/1/2022 7:23
22/10/2021,Surin,65,16446,1376625,684726,691899,19225,19203,22,,,19/1/2022 7:23
22/10/2021,Sukhothai,9,5878,585595,283519,302076,18172,17814,358,,,19/1/2022 7:23
22/10/2021,Nong Khai,20,3448,516972,256377,260595,29617,29500,117,28,12,19/1/2022 7:23
22/10/2021,Nong Bua Lam Phu,0,4142,508984,253786,255198,3417,3402,15,,,19/1/2022 7:23
22/10/2021,Amnat Charoen,1,2893,376306,187145,189161,4821,4821,0,,,19/1/2022 7:23
22/10/2021,Udon Thani,161,21409,1566668,775641,791027,44698,44548,150,,,19/1/2022 7:23
22/10/2021,Uttaradit,21,4152,446617,217679,228938,16832,16832,0,,,19/1/2022 7:23
22/10/2021,Uthai Thani,3,3525,325234,158965,166269,4910,4910,0,,,19/1/2022 7:23
22/10/2021,Ubon Ratchathani,104,19028,1867597,932041,935556,60742,60742,0,21,10,19/1/2022 7:23
22/10/2021,Ang Thong,18,11042,275167,131646,143521,15302,15302,0,,,19/1/2022 7:23
22/10/2021,Chiang Rai,24,4242,1298092,630910,667182,116319,115525,794,25,8,19/1/2022 7:23
22/10/2021,Chiang Mai,412,17336,1788340,863999,924341,214715,212787,1928,43,20,19/1/2022 7:23
22/10/2021,Phetchaburi,146,21074,482659,232915,249744,301889,301778,111,,,19/1/2022 7:23
22/10/2021,Phetchabun,149,10558,978584,482468,496116,84525,84467,58,,,19/1/2022 7:23
22/10/2021,Loei,16,3429,638788,319998,318790,83583,83511,72,15,11,19/1/2022 7:23
22/10/2021,Phrae,10,1727,435038,209644,225394,19532,19532,0,33,16,19/1/2022 7:23
22/10/2021,Mae Hong Son,28,1313,285804,144781,141023,33309,33043,266,25,3,19/1/2022 7:23
22/10/2021,,0,173,,,,,,,,,19/1/2022 7:23
23/10/2021,Krabi,95,6955,479040,237966,241074,6644,6408,236,,,19/1/2022 7:23
23/10/2021,Bangkok,940,421630,5534354,2596396,2937958,535508,483200,52308,58,28,19/1/2022 7:23
23/10/2021,Kanchanaburi,101,20626,894097,448418,445679,467938,467816,122,27,16,19/1/2022 7:23
23/10/2021,Kalasin,27,8647,975928,482318,493610,31863,31863,0,,,19/1/2022 7:23
23/10/2021,Kamphaeng Phet,23,7542,712417,351684,360733,10935,10935,0,,,19/1/2022 7:23
23/10/2021,Khon Kaen,247,19133,1791477,880238,911239,78172,78172,0,53,27,19/1/2022 7:23
23/10/2021,Chanthaburi,196,17455,536488,262258,274230,49181,49069,112,,,19/1/2022 7:23
23/10/2021,Chachoengsao,81,34395,723575,354550,369025,192208,192208,0,40,27,19/1/2022 7:23
23/10/2021,Chon Buri,373,101417,1582463,771883,810580,224103,223216,887,46,20,19/1/2022 7:23
23/10/2021,Chai Nat,1,2370,320853,154238,166615,25249,25249,0,,,19/1/2022 7:23
23/10/2021,Chaiyaphum,36,11333,1122445,554477,567968,24350,24317,33,,,19/1/2022 7:23
23/10/2021,Chumphon,96,11980,509477,251470,258007,7560,7560,0,,,19/1/2022 7:23
23/10/2021,Trang,245,9089,639979,312812,327167,7387,7387,0,,,19/1/2022 7:23
23/10/2021,Trat,171,6844,228426,112944,115482,51815,51639,176,,,19/1/2022 7:23
23/10/2021,Tak,166,20799,675561,341512,334049,23928,23928,0,,,19/1/2022 7:23
23/10/2021,Nakhon Nayok,22,10706,260324,128842,131482,21362,21362,0,,,19/1/2022 7:23
23/10/2021,Nakhon Pathom,51,34344,922078,442736,479342,37242,37188,54,63,27,19/1/2022 7:23
23/10/2021,Nakhon Phanom,6,4868,717013,357096,359917,22046,22046,0,,,19/1/2022 7:23
23/10/2021,Nakhon Ratchasima,85,28757,2634213,1294009,1340204,236917,235237,1680,36,21,19/1/2022 7:23
23/10/2021,Nakhon Si Thammarat,660,25821,1549297,764402,784895,10942,10942,0,,,19/1/2022 7:23
23/10/2021,Nakhon Sawan,142,14024,1035673,505014,530659,28921,28763,158,45,20,19/1/2022 7:23
23/10/2021,Nonthaburi,92,64884,1286596,598356,688240,32482,32370,112,33,24,19/1/2022 7:23
23/10/2021,Narathiwat,251,34453,809130,400257,408873,1549,1549,0,34,11,19/1/2022 7:23
23/10/2021,Nan,4,2383,475962,238027,237935,57643,57453,190,,,19/1/2022 7:23
23/10/2021,Bueng Kan,3,1917,421923,211450,210473,7313,7296,17,,,19/1/2022 7:23
23/10/2021,Buri Ram,32,16502,1579696,783590,796106,48708,48574,134,,,19/1/2022 7:23
23/10/2021,Pathum Thani,50,40009,1187933,562786,625147,26324,26147,177,58,29,19/1/2022 7:23
23/10/2021,Prachuap Khiri Khan,446,14484,553609,274647,278962,262017,261857,160,,,19/1/2022 7:23
23/10/2021,Prachin Buri,143,21357,495017,244513,250504,17246,17246,0,51,29,19/1/2022 7:23
23/10/2021,Pattani,512,32819,729218,360169,369049,1157,1157,0,,,19/1/2022 7:23
23/10/2021,Phra Nakhon Si Ayutthaya,116,29839,820377,393914,426463,161519,160956,563,41,40,19/1/2022 7:23
23/10/2021,Phayao,38,1891,465061,226262,238799,21386,21386,0,25,16,19/1/2022 7:23
23/10/2021,Phang-nga,71,4223,268081,133851,134230,28887,21873,7014,,,19/1/2022 7:23
23/10/2021,Phatthalung,85,7510,522590,254511,268079,3107,3107,0,,,19/1/2022 7:23
23/10/2021,Phichit,20,4603,529974,258338,271636,11935,11935,0,,,19/1/2022 7:23
23/10/2021,Phitsanulok,45,5644,847418,414640,432778,52678,52480,198,,,19/1/2022 7:23
23/10/2021,Phuket,119,14847,419194,198106,221088,91363,64142,27221,55,26,19/1/2022 7:23
23/10/2021,Maha Sarakham,28,10598,949130,465310,483820,12910,12885,25,,,19/1/2022 7:23
23/10/2021,Mukdahan,2,2231,351338,175540,175798,38043,38043,0,,,19/1/2022 7:23
23/10/2021,Yala,434,37833,542002,269804,272198,1327,1327,0,34,24,19/1/2022 7:23
23/10/2021,Yasothon,14,5737,533454,266097,267357,6476,6476,0,,,19/1/2022 7:23
23/10/2021,Ranong,17,9474,194681,98240,96441,5367,5367,0,,,19/1/2022 7:23
23/10/2021,Rayong,230,39956,750107,368398,381709,51424,51159,265,45,17,19/1/2022 7:23
23/10/2021,Ratchaburi,226,35310,868830,422350,446480,88889,88772,117,,,19/1/2022 7:23
23/10/2021,Roi Et,30,13359,1296284,642133,654151,17276,17276,0,,,19/1/2022 7:23
23/10/2021,Lop Buri,49,16144,739712,368713,370999,47834,47796,38,,,19/1/2022 7:23
23/10/2021,Lampang,0,2565,725564,353383,372181,28742,28577,165,45, ,19/1/2022 7:23
23/10/2021,Lamphun,15,2608,401381,192875,208506,18167,18018,149,,,19/1/2022 7:23
23/10/2021,Si Sa Ket,29,16283,1457005,725113,731892,29110,29110,0,,,19/1/2022 7:23
23/10/2021,Sakon Nakhon,12,7554,1146320,569525,576795,37911,37911,0,,,19/1/2022 7:23
23/10/2021,Songkhla,696,44017,1431655,697409,734246,9362,9358,4,74,28,19/1/2022 7:23
23/10/2021,Satun,99,3982,324638,161492,163146,4965,4960,5,45,25,19/1/2022 7:23
23/10/2021,Samut Prakarn,313,123299,1356083,645776,710307,30524,30346,178,,,19/1/2022 7:23
23/10/2021,Samut Songkhram,21,11267,191082,91247,99835,44761,44761,0,24,15,19/1/2022 7:23
23/10/2021,Samut Sakhon,87,109452,586194,282490,303704,20981,20981,0,58,29,19/1/2022 7:23
23/10/2021,Saraburi,111,30069,644040,316399,327641,62770,62680,90,17,51,19/1/2022 7:23
23/10/2021,Sa kaeo,144,16025,561690,280406,281284,11217,10519,698,21,14,19/1/2022 7:23
23/10/2021,Sing Buri,19,2816,204869,97319,107550,15147,15124,23,,,19/1/2022 7:23
23/10/2021,Suphan Buri,45,14181,835825,403209,432616,112708,112708,0,,,19/1/2022 7:23
23/10/2021,Surat Thani,253,17378,1072403,527376,545027,9650,6323,3327,58, ,19/1/2022 7:23
23/10/2021,Surin,45,16491,1376625,684726,691899,19225,19203,22,,,19/1/2022 7:23
23/10/2021,Sukhothai,23,5901,585595,283519,302076,18172,17814,358,,,19/1/2022 7:23
23/10/2021,Nong Khai,24,3472,516972,256377,260595,29617,29500,117,29,13,19/1/2022 7:23
23/10/2021,Nong Bua Lam Phu,4,4146,508984,253786,255198,3417,3402,15,,,19/1/2022 7:23
23/10/2021,Amnat Charoen,1,2894,376306,187145,189161,4821,4821,0,,,19/1/2022 7:23
23/10/2021,Udon Thani,190,21599,1566668,775641,791027,44698,44548,150,,,19/1/2022 7:23
23/10/2021,Uttaradit,5,4157,446617,217679,228938,16832,16832,0,,,19/1/2022 7:23
23/10/2021,Uthai Thani,0,3525,325234,158965,166269,4910,4910,0,,,19/1/2022 7:23
23/10/2021,Ubon Ratchathani,150,19178,1867597,932041,935556,60742,60742,0,18,12,19/1/2022 7:23
23/10/2021,Ang Thong,12,11054,275167,131646,143521,15302,15302,0,,,19/1/2022 7:23
23/10/2021,Chiang Rai,38,4280,1298092,630910,667182,116319,115525,794,22,10,19/1/2022 7:23
23/10/2021,Chiang Mai,357,17693,1788340,863999,924341,214715,212787,1928,36,19,19/1/2022 7:23
23/10/2021,Phetchaburi,146,21220,482659,232915,249744,301889,301778,111,,,19/1/2022 7:23
23/10/2021,Phetchabun,39,10597,978584,482468,496116,84525,84467,58,,,19/1/2022 7:23
23/10/2021,Loei,18,3447,638788,319998,318790,83583,83511,72,20,16,19/1/2022 7:23
23/10/2021,Phrae,7,1734,435038,209644,225394,19532,19532,0,37,19,19/1/2022 7:23
23/10/2021,Mae Hong Son,19,1332,285804,144781,141023,33309,33043,266,13,4,19/1/2022 7:23
23/10/2021,,0,173,,,,,,,,,19/1/2022 7:23
24/10/2021,Krabi,96,7051,479040,237966,241074,6644,6408,236,,,19/1/2022 7:23
24/10/2021,Bangkok,937,422567,5534354,2596396,2937958,535508,483200,52308,56,30,19/1/2022 7:23
24/10/2021,Kanchanaburi,95,20721,894097,448418,445679,467938,467816,122,33,20,19/1/2022 7:23
24/10/2021,Kalasin,32,8679,975928,482318,493610,31863,31863,0,,,19/1/2022 7:23
24/10/2021,Kamphaeng Phet,13,7555,712417,351684,360733,10935,10935,0,,,19/1/2022 7:23
24/10/2021,Khon Kaen,302,19435,1791477,880238,911239,78172,78172,0,57,38,19/1/2022 7:23
24/10/2021,Chanthaburi,207,17662,536488,262258,274230,49181,49069,112,,,19/1/2022 7:23
24/10/2021,Chachoengsao,88,34483,723575,354550,369025,192208,192208,0,39,31,19/1/2022 7:23
24/10/2021,Chon Buri,289,101706,1582463,771883,810580,224103,223216,887,43,22,19/1/2022 7:23
24/10/2021,Chai Nat,2,2372,320853,154238,166615,25249,25249,0,,,19/1/2022 7:23
24/10/2021,Chaiyaphum,19,11352,1122445,554477,567968,24350,24317,33,,,19/1/2022 7:23
24/10/2021,Chumphon,89,12069,509477,251470,258007,7560,7560,0,,,19/1/2022 7:23
24/10/2021,Trang,250,9339,639979,312812,327167,7387,7387,0,,,19/1/2022 7:23
24/10/2021,Trat,71,6915,228426,112944,115482,51815,51639,176,,,19/1/2022 7:23
24/10/2021,Tak,97,20896,675561,341512,334049,23928,23928,0,,,19/1/2022 7:23
24/10/2021,Nakhon Nayok,18,10724,260324,128842,131482,21362,21362,0,,,19/1/2022 7:23
24/10/2021,Nakhon Pathom,57,34401,922078,442736,479342,37242,37188,54,59,30,19/1/2022 7:23
24/10/2021,Nakhon Phanom,1,4869,717013,357096,359917,22046,22046,0,,,19/1/2022 7:23
24/10/2021,Nakhon Ratchasima,80,28837,2634213,1294009,1340204,236917,235237,1680,54,28,19/1/2022 7:23
24/10/2021,Nakhon Si Thammarat,602,26423,1549297,764402,784895,10942,10942,0,,,19/1/2022 7:23
24/10/2021,Nakhon Sawan,164,14188,1035673,505014,530659,28921,28763,158,46,29,19/1/2022 7:23
24/10/2021,Nonthaburi,78,64962,1286596,598356,688240,32482,32370,112,42,25,19/1/2022 7:23
24/10/2021,Narathiwat,265,34718,809130,400257,408873,1549,1549,0,23,15,19/1/2022 7:23
24/10/2021,Nan,0,2383,475962,238027,237935,57643,57453,190,,,19/1/2022 7:23
24/10/2021,Bueng Kan,24,1941,421923,211450,210473,7313,7296,17,,,19/1/2022 7:23
24/10/2021,Buri Ram,30,16532,1579696,783590,796106,48708,48574,134,,,19/1/2022 7:23
24/10/2021,Pathum Thani,76,40085,1187933,562786,625147,26324,26147,177,54,34,19/1/2022 7:23
24/10/2021,Prachuap Khiri Khan,240,14724,553609,274647,278962,262017,261857,160,,,19/1/2022 7:23
24/10/2021,Prachin Buri,125,21482,495017,244513,250504,17246,17246,0,58,29,19/1/2022 7:23
24/10/2021,Pattani,511,33330,729218,360169,369049,1157,1157,0,,,19/1/2022 7:23
24/10/2021,Phra Nakhon Si Ayutthaya,92,29931,820377,393914,426463,161519,160956,563,33,45,19/1/2022 7:23
24/10/2021,Phayao,43,1934,465061,226262,238799,21386,21386,0,36,20,19/1/2022 7:23
24/10/2021,Phang-nga,54,4277,268081,133851,134230,28887,21873,7014,,,19/1/2022 7:23
24/10/2021,Phatthalung,179,7689,522590,254511,268079,3107,3107,0,,,19/1/2022 7:23
24/10/2021,Phichit,27,4630,529974,258338,271636,11935,11935,0,,,19/1/2022 7:23
24/10/2021,Phitsanulok,36,5680,847418,414640,432778,52678,52480,198,,,19/1/2022 7:23
24/10/2021,Phuket,119,14966,419194,198106,221088,91363,64142,27221,57,19,19/1/2022 7:23
24/10/2021,Maha Sarakham,34,10632,949130,465310,483820,12910,12885,25,,,19/1/2022 7:23
24/10/2021,Mukdahan,2,2233,351338,175540,175798,38043,38043,0,,,19/1/2022 7:23
24/10/2021,Yala,529,38362,542002,269804,272198,1327,1327,0,42,26,19/1/2022 7:23
24/10/2021,Yasothon,6,5743,533454,266097,267357,6476,6476,0,,,19/1/2022 7:23
24/10/2021,Ranong,13,9487,194681,98240,96441,5367,5367,0,,,19/1/2022 7:23
24/10/2021,Rayong,259,40215,750107,368398,381709,51424,51159,265,44,19,19/1/2022 7:23
24/10/2021,Ratchaburi,173,35483,868830,422350,446480,88889,88772,117,,,19/1/2022 7:23
24/10/2021,Roi Et,31,13390,1296284,642133,654151,17276,17276,0,,,19/1/2022 7:23
24/10/2021,Lop Buri,61,16205,739712,368713,370999,47834,47796,38,,,19/1/2022 7:23
24/10/2021,Lampang,10,2575,725564,353383,372181,28742,28577,165,47, ,19/1/2022 7:23
24/10/2021,Lamphun,9,2617,401381,192875,208506,18167,18018,149,,,19/1/2022 7:23
24/10/2021,Si Sa Ket,19,16302,1457005,725113,731892,29110,29110,0,,,19/1/2022 7:23
24/10/2021,Sakon Nakhon,7,7561,1146320,569525,576795,37911,37911,0,,,19/1/2022 7:23
24/10/2021,Songkhla,682,44699,1431655,697409,734246,9362,9358,4,59,35,19/1/2022 7:23
24/10/2021,Satun,141,4123,324638,161492,163146,4965,4960,5,52,25,19/1/2022 7:23
24/10/2021,Samut Prakarn,294,123593,1356083,645776,710307,30524,30346,178,,,19/1/2022 7:23
24/10/2021,Samut Songkhram,21,11288,191082,91247,99835,44761,44761,0,36,15,19/1/2022 7:23
24/10/2021,Samut Sakhon,78,109530,586194,282490,303704,20981,20981,0,49,38,19/1/2022 7:23
24/10/2021,Saraburi,108,30177,644040,316399,327641,62770,62680,90,6,54,19/1/2022 7:23
24/10/2021,Sa kaeo,99,16124,561690,280406,281284,11217,10519,698,29,19,19/1/2022 7:23
24/10/2021,Sing Buri,12,2828,204869,97319,107550,15147,15124,23,,,19/1/2022 7:23
24/10/2021,Suphan Buri,24,14205,835825,403209,432616,112708,112708,0,,,19/1/2022 7:23
24/10/2021,Surat Thani,253,17631,1072403,527376,545027,9650,6323,3327,31, ,19/1/2022 7:23
24/10/2021,Surin,47,16538,1376625,684726,691899,19225,19203,22,,,19/1/2022 7:23
24/10/2021,Sukhothai,3,5904,585595,283519,302076,18172,17814,358,,,19/1/2022 7:23
24/10/2021,Nong Khai,28,3500,516972,256377,260595,29617,29500,117,31,13,19/1/2022 7:23
24/10/2021,Nong Bua Lam Phu,6,4152,508984,253786,255198,3417,3402,15,,,19/1/2022 7:23
24/10/2021,Amnat Charoen,0,2894,376306,187145,189161,4821,4821,0,,,19/1/2022 7:23
24/10/2021,Udon Thani,152,21751,1566668,775641,791027,44698,44548,150,,,19/1/2022 7:23
24/10/2021,Uttaradit,2,4159,446617,217679,228938,16832,16832,0,,,19/1/2022 7:23
24/10/2021,Uthai Thani,1,3526,325234,158965,166269,4910,4910,0,,,19/1/2022 7:23
24/10/2021,Ubon Ratchathani,102,19280,1867597,932041,935556,60742,60742,0,31,25,19/1/2022 7:23
24/10/2021,Ang Thong,19,11073,275167,131646,143521,15302,15302,0,,,19/1/2022 7:23
24/10/2021,Chiang Rai,32,4312,1298092,630910,667182,116319,115525,794,25,15,19/1/2022 7:23
24/10/2021,Chiang Mai,461,18154,1788340,863999,924341,214715,212787,1928,41,26,19/1/2022 7:23
24/10/2021,Phetchaburi,125,21345,482659,232915,249744,301889,301778,111,,,19/1/2022 7:23
24/10/2021,Phetchabun,52,10649,978584,482468,496116,84525,84467,58,,,19/1/2022 7:23
24/10/2021,Loei,17,3464,638788,319998,318790,83583,83511,72,34,17,19/1/2022 7:23
24/10/2021,Phrae,12,1746,435038,209644,225394,19532,19532,0,43,19,19/1/2022 7:23
24/10/2021,Mae Hong Son,19,1351,285804,144781,141023,33309,33043,266,19,9,19/1/2022 7:23
24/10/2021,,0,173,,,,,,,,,19/1/2022 7:23
25/10/2021,Krabi,85,7136,479040,237966,241074,6644,6408,236,,,19/1/2022 7:23
25/10/2021,Bangkok,925,423492,5534354,2596396,2937958,535508,483200,52308,64,40,19/1/2022 7:23
25/10/2021,Kanchanaburi,67,20788,894097,448418,445679,467938,467816,122,43,25,19/1/2022 7:23
25/10/2021,Kalasin,14,8693,975928,482318,493610,31863,31863,0,,,19/1/2022 7:23
25/10/2021,Kamphaeng Phet,44,7599,712417,351684,360733,10935,10935,0,,,19/1/2022 7:23
25/10/2021,Khon Kaen,200,19635,1791477,880238,911239,78172,78172,0,66,46,19/1/2022 7:23
25/10/2021,Chanthaburi,115,17777,536488,262258,274230,49181,49069,112,,,19/1/2022 7:23
25/10/2021,Chachoengsao,77,34560,723575,354550,369025,192208,192208,0,51,41,19/1/2022 7:23
25/10/2021,Chon Buri,295,102001,1582463,771883,810580,224103,223216,887,41,33,19/1/2022 7:23
25/10/2021,Chai Nat,4,2376,320853,154238,166615,25249,25249,0,,,19/1/2022 7:23
25/10/2021,Chaiyaphum,23,11375,1122445,554477,567968,24350,24317,33,,,19/1/2022 7:23
25/10/2021,Chumphon,139,12208,509477,251470,258007,7560,7560,0,,,19/1/2022 7:23
25/10/2021,Trang,411,9750,639979,312812,327167,7387,7387,0,,,19/1/2022 7:23
25/10/2021,Trat,64,6979,228426,112944,115482,51815,51639,176,,,19/1/2022 7:23
25/10/2021,Tak,142,21038,675561,341512,334049,23928,23928,0,,,19/1/2022 7:23
25/10/2021,Nakhon Nayok,28,10752,260324,128842,131482,21362,21362,0,,,19/1/2022 7:23
25/10/2021,Nakhon Pathom,50,34451,922078,442736,479342,37242,37188,54,68,36,19/1/2022 7:23
25/10/2021,Nakhon Phanom,1,4870,717013,357096,359917,22046,22046,0,,,19/1/2022 7:23
25/10/2021,Nakhon Ratchasima,96,28933,2634213,1294009,1340204,236917,235237,1680,64,33,19/1/2022 7:23
25/10/2021,Nakhon Si Thammarat,582,27005,1549297,764402,784895,10942,10942,0,,,19/1/2022 7:23
25/10/2021,Nakhon Sawan,81,14269,1035673,505014,530659,28921,28763,158,57,33,19/1/2022 7:23
25/10/2021,Nonthaburi,68,65030,1286596,598356,688240,32482,32370,112,51,30,19/1/2022 7:23
25/10/2021,Narathiwat,352,35070,809130,400257,408873,1549,1549,0,31,14,19/1/2022 7:23
25/10/2021,Nan,2,2385,475962,238027,237935,57643,57453,190,,,19/1/2022 7:23
25/10/2021,Bueng Kan,29,1970,421923,211450,210473,7313,7296,17,,,19/1/2022 7:23
25/10/2021,Buri Ram,24,16556,1579696,783590,796106,48708,48574,134,,,19/1/2022 7:23
25/10/2021,Pathum Thani,95,40180,1187933,562786,625147,26324,26147,177,62,41,19/1/2022 7:23
25/10/2021,Prachuap Khiri Khan,210,14934,553609,274647,278962,262017,261857,160,,,19/1/2022 7:23
25/10/2021,Prachin Buri,107,21589,495017,244513,250504,17246,17246,0,59,38,19/1/2022 7:23
25/10/2021,Pattani,618,33948,729218,360169,369049,1157,1157,0,,,19/1/2022 7:23
25/10/2021,Phra Nakhon Si Ayutthaya,90,30021,820377,393914,426463,161519,160956,563,47,51,19/1/2022 7:23
25/10/2021,Phayao,17,1951,465061,226262,238799,21386,21386,0,48,19,19/1/2022 7:23
25/10/2021,Phang-nga,35,4312,268081,133851,134230,28887,21873,7014,,,19/1/2022 7:23
25/10/2021,Phatthalung,164,7853,522590,254511,268079,3107,3107,0,,,19/1/2022 7:23
25/10/2021,Phichit,24,4654,529974,258338,271636,11935,11935,0,,,19/1/2022 7:23
25/10/2021,Phitsanulok,55,5735,847418,414640,432778,52678,52480,198,,,19/1/2022 7:23
25/10/2021,Phuket,96,15062,419194,198106,221088,91363,64142,27221,48,23,19/1/2022 7:23
25/10/2021,Maha Sarakham,23,10655,949130,465310,483820,12910,12885,25,,,19/1/2022 7:23
25/10/2021,Mukdahan,2,2235,351338,175540,175798,38043,38043,0,,,19/1/2022 7:23
25/10/2021,Yala,340,38702,542002,269804,272198,1327,1327,0,46,27,19/1/2022 7:23
25/10/2021,Yasothon,3,5746,533454,266097,267357,6476,6476,0,,,19/1/2022 7:23
25/10/2021,Ranong,8,9495,194681,98240,96441,5367,5367,0,,,19/1/2022 7:23
25/10/2021,Rayong,250,40465,750107,368398,381709,51424,51159,265,50,32,19/1/2022 7:23
25/10/2021,Ratchaburi,150,35633,868830,422350,446480,88889,88772,117,,,19/1/2022 7:23
25/10/2021,Roi Et,10,13400,1296284,642133,654151,17276,17276,0,,,19/1/2022 7:23
25/10/2021,Lop Buri,72,16277,739712,368713,370999,47834,47796,38,,,19/1/2022 7:23
25/10/2021,Lampang,3,2578,725564,353383,372181,28742,28577,165,59, ,19/1/2022 7:23
25/10/2021,Lamphun,7,2624,401381,192875,208506,18167,18018,149,,,19/1/2022 7:23
25/10/2021,Si Sa Ket,12,16314,1457005,725113,731892,29110,29110,0,,,19/1/2022 7:23
25/10/2021,Sakon Nakhon,16,7577,1146320,569525,576795,37911,37911,0,,,19/1/2022 7:23
25/10/2021,Songkhla,589,45288,1431655,697409,734246,9362,9358,4,68,29,19/1/2022 7:23
25/10/2021,Satun,129,4252,324638,161492,163146,4965,4960,5,46,26,19/1/2022 7:23
25/10/2021,Samut Prakarn,274,123867,1356083,645776,710307,30524,30346,178,,,19/1/2022 7:23
25/10/2021,Samut Songkhram,20,11308,191082,91247,99835,44761,44761,0,36,21,19/1/2022 7:23
25/10/2021,Samut Sakhon,77,109607,586194,282490,303704,20981,20981,0,61,46,19/1/2022 7:23
25/10/2021,Saraburi,98,30275,644040,316399,327641,62770,62680,90,42,72,19/1/2022 7:23
25/10/2021,Sa kaeo,79,16203,561690,280406,281284,11217,10519,698,46,27,19/1/2022 7:23
25/10/2021,Sing Buri,21,2849,204869,97319,107550,15147,15124,23,,,19/1/2022 7:23
25/10/2021,Suphan Buri,40,14245,835825,403209,432616,112708,112708,0,,,19/1/2022 7:23
25/10/2021,Surat Thani,187,17818,1072403,527376,545027,9650,6323,3327,99, ,19/1/2022 7:23
25/10/2021,Surin,25,16563,1376625,684726,691899,19225,19203,22,,,19/1/2022 7:23
25/10/2021,Sukhothai,7,5911,585595,283519,302076,18172,17814,358,,,19/1/2022 7:23
25/10/2021,Nong Khai,29,3529,516972,256377,260595,29617,29500,117,32,13,19/1/2022 7:23
25/10/2021,Nong Bua Lam Phu,1,4153,508984,253786,255198,3417,3402,15,,,19/1/2022 7:23
25/10/2021,Amnat Charoen,8,2902,376306,187145,189161,4821,4821,0,,,19/1/2022 7:23
25/10/2021,Udon Thani,134,21885,1566668,775641,791027,44698,44548,150,,,19/1/2022 7:23
25/10/2021,Uttaradit,6,4165,446617,217679,228938,16832,16832,0,,,19/1/2022 7:23
25/10/2021,Uthai Thani,0,3526,325234,158965,166269,4910,4910,0,,,19/1/2022 7:23
25/10/2021,Ubon Ratchathani,87,19367,1867597,932041,935556,60742,60742,0,61,35,19/1/2022 7:23
25/10/2021,Ang Thong,14,11087,275167,131646,143521,15302,15302,0,,,19/1/2022 7:23
25/10/2021,Chiang Rai,12,4324,1298092,630910,667182,116319,115525,794,34,16,19/1/2022 7:23
25/10/2021,Chiang Mai,353,18507,1788340,863999,924341,214715,212787,1928,54,30,19/1/2022 7:23
25/10/2021,Phetchaburi,103,21448,482659,232915,249744,301889,301778,111,,,19/1/2022 7:23
25/10/2021,Phetchabun,17,10666,978584,482468,496116,84525,84467,58,,,19/1/2022 7:23
25/10/2021,Loei,15,3479,638788,319998,318790,83583,83511,72,37,18,19/1/2022 7:23
25/10/2021,Phrae,8,1754,435038,209644,225394,19532,19532,0,48,21,19/1/2022 7:23
25/10/2021,Mae Hong Son,17,1368,285804,144781,141023,33309,33043,266,35,12,19/1/2022 7:23
25/10/2021,,0,173,,,,,,,,,19/1/2022 7:23
26/10/2021,Krabi,89,7225,479040,237966,241074,6644,6408,236,,,19/1/2022 7:23
26/10/2021,Bangkok,919,424411,5534354,2596396,2937958,535508,483200,52308,80,46,19/1/2022 7:23
26/10/2021,Kanchanaburi,68,20856,894097,448418,445679,467938,467816,122,50,27,19/1/2022 7:23
26/10/2021,Kalasin,22,8715,975928,482318,493610,31863,31863,0,,,19/1/2022 7:23
26/10/2021,Kamphaeng Phet,14,7613,712417,351684,360733,10935,10935,0,,,19/1/2022 7:23
26/10/2021,Khon Kaen,141,19776,1791477,880238,911239,78172,78172,0,82,50,19/1/2022 7:23
26/10/2021,Chanthaburi,164,17941,536488,262258,274230,49181,49069,112,,,19/1/2022 7:23
26/10/2021,Chachoengsao,53,34613,723575,354550,369025,192208,192208,0,66,42,19/1/2022 7:23
26/10/2021,Chon Buri,250,102251,1582463,771883,810580,224103,223216,887,62,36,19/1/2022 7:23
26/10/2021,Chai Nat,6,2382,320853,154238,166615,25249,25249,0,,,19/1/2022 7:23
26/10/2021,Chaiyaphum,18,11393,1122445,554477,567968,24350,24317,33,,,19/1/2022 7:23
26/10/2021,Chumphon,74,12282,509477,251470,258007,7560,7560,0,,,19/1/2022 7:23
26/10/2021,Trang,227,9977,639979,312812,327167,7387,7387,0,,,19/1/2022 7:23
26/10/2021,Trat,60,7039,228426,112944,115482,51815,51639,176,,,19/1/2022 7:23
26/10/2021,Tak,123,21161,675561,341512,334049,23928,23928,0,,,19/1/2022 7:23
26/10/2021,Nakhon Nayok,12,10764,260324,128842,131482,21362,21362,0,,,19/1/2022 7:23
26/10/2021,Nakhon Pathom,22,34473,922078,442736,479342,37242,37188,54,81,40,19/1/2022 7:23
26/10/2021,Nakhon Phanom,4,4874,717013,357096,359917,22046,22046,0,,,19/1/2022 7:23
26/10/2021,Nakhon Ratchasima,72,29005,2634213,1294009,1340204,236917,235237,1680,73,37,19/1/2022 7:23
26/10/2021,Nakhon Si Thammarat,556,27561,1549297,764402,784895,10942,10942,0,,,19/1/2022 7:23
26/10/2021,Nakhon Sawan,141,14410,1035673,505014,530659,28921,28763,158,65,35,19/1/2022 7:23
26/10/2021,Nonthaburi,120,65150,1286596,598356,688240,32482,32370,112,63,31,19/1/2022 7:23
26/10/2021,Narathiwat,322,35392,809130,400257,408873,1549,1549,0,32,14,19/1/2022 7:23
26/10/2021,Nan,0,2385,475962,238027,237935,57643,57453,190,,,19/1/2022 7:23
26/10/2021,Bueng Kan,6,1976,421923,211450,210473,7313,7296,17,,,19/1/2022 7:23
26/10/2021,Buri Ram,18,16574,1579696,783590,796106,48708,48574,134,,,19/1/2022 7:23
26/10/2021,Pathum Thani,32,40212,1187933,562786,625147,26324,26147,177,76,38,19/1/2022 7:23
26/10/2021,Prachuap Khiri Khan,128,15062,553609,274647,278962,262017,261857,160,,,19/1/2022 7:23
26/10/2021,Prachin Buri,59,21648,495017,244513,250504,17246,17246,0,75,42,19/1/2022 7:23
26/10/2021,Pattani,621,34569,729218,360169,369049,1157,1157,0,,,19/1/2022 7:23
26/10/2021,Phra Nakhon Si Ayutthaya,67,30088,820377,393914,426463,161519,160956,563,61,52,19/1/2022 7:23
26/10/2021,Phayao,14,1965,465061,226262,238799,21386,21386,0,47,18,19/1/2022 7:23
26/10/2021,Phang-nga,27,4339,268081,133851,134230,28887,21873,7014,,,19/1/2022 7:23
26/10/2021,Phatthalung,117,7970,522590,254511,268079,3107,3107,0,,,19/1/2022 7:23
26/10/2021,Phichit,21,4675,529974,258338,271636,11935,11935,0,,,19/1/2022 7:23
26/10/2021,Phitsanulok,28,5763,847418,414640,432778,52678,52480,198,,,19/1/2022 7:23
26/10/2021,Phuket,93,15155,419194,198106,221088,91363,64142,27221,57,23,19/1/2022 7:23
26/10/2021,Maha Sarakham,17,10672,949130,465310,483820,12910,12885,25,,,19/1/2022 7:23
26/10/2021,Mukdahan,0,2235,351338,175540,175798,38043,38043,0,,,19/1/2022 7:23
26/10/2021,Yala,247,38949,542002,269804,272198,1327,1327,0,48,32,19/1/2022 7:23
26/10/2021,Yasothon,30,5776,533454,266097,267357,6476,6476,0,,,19/1/2022 7:23
26/10/2021,Ranong,14,9509,194681,98240,96441,5367,5367,0,,,19/1/2022 7:23
26/10/2021,Rayong,229,40694,750107,368398,381709,51424,51159,265,74,28,19/1/2022 7:23
26/10/2021,Ratchaburi,183,35816,868830,422350,446480,88889,88772,117,,,19/1/2022 7:23
26/10/2021,Roi Et,19,13419,1296284,642133,654151,17276,17276,0,,,19/1/2022 7:23
26/10/2021,Lop Buri,18,16295,739712,368713,370999,47834,47796,38,,,19/1/2022 7:23
26/10/2021,Lampang,8,2586,725564,353383,372181,28742,28577,165,63, ,19/1/2022 7:23
26/10/2021,Lamphun,6,2630,401381,192875,208506,18167,18018,149,,,19/1/2022 7:23
26/10/2021,Si Sa Ket,12,16326,1457005,725113,731892,29110,29110,0,,,19/1/2022 7:23
26/10/2021,Sakon Nakhon,9,7586,1146320,569525,576795,37911,37911,0,,,19/1/2022 7:23
26/10/2021,Songkhla,622,45910,1431655,697409,734246,9362,9358,4,58,26,19/1/2022 7:23
26/10/2021,Satun,124,4376,324638,161492,163146,4965,4960,5,47,31,19/1/2022 7:23
26/10/2021,Samut Prakarn,194,124061,1356083,645776,710307,30524,30346,178,,,19/1/2022 7:23
26/10/2021,Samut Songkhram,40,11348,191082,91247,99835,44761,44761,0,55,19,19/1/2022 7:23
26/10/2021,Samut Sakhon,46,109653,586194,282490,303704,20981,20981,0,79,44,19/1/2022 7:23
26/10/2021,Saraburi,97,30372,644040,316399,327641,62770,62680,90,96,77,19/1/2022 7:23
26/10/2021,Sa kaeo,51,16254,561690,280406,281284,11217,10519,698,65,29,19/1/2022 7:23
26/10/2021,Sing Buri,17,2866,204869,97319,107550,15147,15124,23,,,19/1/2022 7:23
26/10/2021,Suphan Buri,70,14315,835825,403209,432616,112708,112708,0,,,19/1/2022 7:23
26/10/2021,Surat Thani,160,17978,1072403,527376,545027,9650,6323,3327,33,16,19/1/2022 7:23
26/10/2021,Surin,17,16580,1376625,684726,691899,19225,19203,22,,,19/1/2022 7:23
26/10/2021,Sukhothai,3,5914,585595,283519,302076,18172,17814,358,,,19/1/2022 7:23
26/10/2021,Nong Khai,36,3565,516972,256377,260595,29617,29500,117,32,13,19/1/2022 7:23
26/10/2021,Nong Bua Lam Phu,8,4161,508984,253786,255198,3417,3402,15,,,19/1/2022 7:23
26/10/2021,Amnat Charoen,1,2903,376306,187145,189161,4821,4821,0,,,19/1/2022 7:23
26/10/2021,Udon Thani,138,22023,1566668,775641,791027,44698,44548,150,,,19/1/2022 7:23
26/10/2021,Uttaradit,18,4183,446617,217679,228938,16832,16832,0,,,19/1/2022 7:23
26/10/2021,Uthai Thani,5,3531,325234,158965,166269,4910,4910,0,,,19/1/2022 7:23
26/10/2021,Ubon Ratchathani,57,19424,1867597,932041,935556,60742,60742,0,77,30,19/1/2022 7:23
26/10/2021,Ang Thong,7,11094,275167,131646,143521,15302,15302,0,,,19/1/2022 7:23
26/10/2021,Chiang Rai,26,4350,1298092,630910,667182,116319,115525,794,41,17,19/1/2022 7:23
26/10/2021,Chiang Mai,355,18862,1788340,863999,924341,214715,212787,1928,64,35,19/1/2022 7:23
26/10/2021,Phetchaburi,51,21499,482659,232915,249744,301889,301778,111,,,19/1/2022 7:23
26/10/2021,Phetchabun,21,10687,978584,482468,496116,84525,84467,58,,,19/1/2022 7:23
26/10/2021,Loei,18,3497,638788,319998,318790,83583,83511,72,45,24,19/1/2022 7:23
26/10/2021,Phrae,3,1757,435038,209644,225394,19532,19532,0,48,21,19/1/2022 7:23
26/10/2021,Mae Hong Son,21,1389,285804,144781,141023,33309,33043,266,50,15,19/1/2022 7:23
26/10/2021,,0,173,,,,,,,,,19/1/2022 7:23
27/10/2021,Krabi,80,7305,479040,237966,241074,6644,6408,236,,,19/1/2022 7:23
27/10/2021,Bangkok,935,425346,5534354,2596396,2937958,535508,483200,52308,86,50,19/1/2022 7:23
27/10/2021,Kanchanaburi,42,20898,894097,448418,445679,467938,467816,122,54,23,19/1/2022 7:23
27/10/2021,Kalasin,29,8744,975928,482318,493610,31863,31863,0,,,19/1/2022 7:23
27/10/2021,Kamphaeng Phet,32,7645,712417,351684,360733,10935,10935,0,,,19/1/2022 7:23
27/10/2021,Khon Kaen,140,19916,1791477,880238,911239,78172,78172,0,91,46,19/1/2022 7:23
27/10/2021,Chanthaburi,359,18300,536488,262258,274230,49181,49069,112,,,19/1/2022 7:23
27/10/2021,Chachoengsao,131,34744,723575,354550,369025,192208,192208,0,70,42,19/1/2022 7:23
27/10/2021,Chon Buri,297,102548,1582463,771883,810580,224103,223216,887,68,24,19/1/2022 7:23
27/10/2021,Chai Nat,25,2407,320853,154238,166615,25249,25249,0,,,19/1/2022 7:23
27/10/2021,Chaiyaphum,32,11425,1122445,554477,567968,24350,24317,33,,,19/1/2022 7:23
27/10/2021,Chumphon,123,12405,509477,251470,258007,7560,7560,0,,,19/1/2022 7:23
27/10/2021,Trang,219,10196,639979,312812,327167,7387,7387,0,,,19/1/2022 7:23
27/10/2021,Trat,35,7074,228426,112944,115482,51815,51639,176,,,19/1/2022 7:23
27/10/2021,Tak,174,21335,675561,341512,334049,23928,23928,0,,,19/1/2022 7:23
27/10/2021,Nakhon Nayok,26,10790,260324,128842,131482,21362,21362,0,,,19/1/2022 7:23
27/10/2021,Nakhon Pathom,18,34491,922078,442736,479342,37242,37188,54,75,37,19/1/2022 7:23
27/10/2021,Nakhon Phanom,2,4876,717013,357096,359917,22046,22046,0,,,19/1/2022 7:23
27/10/2021,Nakhon Ratchasima,110,29115,2634213,1294009,1340204,236917,235237,1680,81,30,19/1/2022 7:23
27/10/2021,Nakhon Si Thammarat,345,27906,1549297,764402,784895,10942,10942,0,,,19/1/2022 7:23
27/10/2021,Nakhon Sawan,130,14540,1035673,505014,530659,28921,28763,158,68,35,19/1/2022 7:23
27/10/2021,Nonthaburi,100,65250,1286596,598356,688240,32482,32370,112,67,29,19/1/2022 7:23
27/10/2021,Narathiwat,331,35723,809130,400257,408873,1549,1549,0,30,13,19/1/2022 7:23
27/10/2021,Nan,0,2385,475962,238027,237935,57643,57453,190,,,19/1/2022 7:23
27/10/2021,Bueng Kan,3,1979,421923,211450,210473,7313,7296,17,,,19/1/2022 7:23
27/10/2021,Buri Ram,22,16596,1579696,783590,796106,48708,48574,134,,,19/1/2022 7:23
27/10/2021,Pathum Thani,23,40235,1187933,562786,625147,26324,26147,177,66,36,19/1/2022 7:23
27/10/2021,Prachuap Khiri Khan,105,15167,553609,274647,278962,262017,261857,160,,,19/1/2022 7:23
27/10/2021,Prachin Buri,171,21819,495017,244513,250504,17246,17246,0,74,36,19/1/2022 7:23
27/10/2021,Pattani,532,35101,729218,360169,369049,1157,1157,0,,,19/1/2022 7:23
27/10/2021,Phra Nakhon Si Ayutthaya,62,30150,820377,393914,426463,161519,160956,563,71,48,19/1/2022 7:23
27/10/2021,Phayao,32,1997,465061,226262,238799,21386,21386,0,51,21,19/1/2022 7:23
27/10/2021,Phang-nga,59,4398,268081,133851,134230,28887,21873,7014,,,19/1/2022 7:23
27/10/2021,Phatthalung,169,8139,522590,254511,268079,3107,3107,0,,,19/1/2022 7:23
27/10/2021,Phichit,32,4707,529974,258338,271636,11935,11935,0,,,19/1/2022 7:23
27/10/2021,Phitsanulok,50,5813,847418,414640,432778,52678,52480,198,,,19/1/2022 7:23
27/10/2021,Phuket,83,15238,419194,198106,221088,91363,64142,27221,53,30,19/1/2022 7:23
27/10/2021,Maha Sarakham,47,10719,949130,465310,483820,12910,12885,25,,,19/1/2022 7:23
27/10/2021,Mukdahan,6,2241,351338,175540,175798,38043,38043,0,,,19/1/2022 7:23
27/10/2021,Yala,475,39424,542002,269804,272198,1327,1327,0,54,25,19/1/2022 7:23
27/10/2021,Yasothon,10,5786,533454,266097,267357,6476,6476,0,,,19/1/2022 7:23
27/10/2021,Ranong,8,9517,194681,98240,96441,5367,5367,0,,,19/1/2022 7:23
27/10/2021,Rayong,208,40902,750107,368398,381709,51424,51159,265,67,22,19/1/2022 7:23
27/10/2021,Ratchaburi,172,35988,868830,422350,446480,88889,88772,117,,,19/1/2022 7:23
27/10/2021,Roi Et,19,13438,1296284,642133,654151,17276,17276,0,,,19/1/2022 7:23
27/10/2021,Lop Buri,27,16322,739712,368713,370999,47834,47796,38,,,19/1/2022 7:23
27/10/2021,Lampang,13,2599,725564,353383,372181,28742,28577,165,60, ,19/1/2022 7:23
27/10/2021,Lamphun,19,2649,401381,192875,208506,18167,18018,149,,,19/1/2022 7:23
27/10/2021,Si Sa Ket,36,16362,1457005,725113,731892,29110,29110,0,,,19/1/2022 7:23
27/10/2021,Sakon Nakhon,6,7592,1146320,569525,576795,37911,37911,0,,,19/1/2022 7:23
27/10/2021,Songkhla,551,46461,1431655,697409,734246,9362,9358,4,51,29,19/1/2022 7:23
27/10/2021,Satun,114,4490,324638,161492,163146,4965,4960,5,51,30,19/1/2022 7:23
27/10/2021,Samut Prakarn,306,124367,1356083,645776,710307,30524,30346,178,,,19/1/2022 7:23
27/10/2021,Samut Songkhram,25,11373,191082,91247,99835,44761,44761,0,44,14,19/1/2022 7:23
27/10/2021,Samut Sakhon,72,109725,586194,282490,303704,20981,20981,0,72,42,19/1/2022 7:23
27/10/2021,Saraburi,97,30469,644040,316399,327641,62770,62680,90,101,82,19/1/2022 7:23
27/10/2021,Sa kaeo,87,16341,561690,280406,281284,11217,10519,698,68,17,19/1/2022 7:23
27/10/2021,Sing Buri,15,2881,204869,97319,107550,15147,15124,23,,,19/1/2022 7:23
27/10/2021,Suphan Buri,29,14344,835825,403209,432616,112708,112708,0,,,19/1/2022 7:23
27/10/2021,Surat Thani,199,18177,1072403,527376,545027,9650,6323,3327,44,21,19/1/2022 7:23
27/10/2021,Surin,110,16690,1376625,684726,691899,19225,19203,22,,,19/1/2022 7:23
27/10/2021,Sukhothai,12,5926,585595,283519,302076,18172,17814,358,,,19/1/2022 7:23
27/10/2021,Nong Khai,49,3614,516972,256377,260595,29617,29500,117,32,10,19/1/2022 7:23
27/10/2021,Nong Bua Lam Phu,8,4169,508984,253786,255198,3417,3402,15,,,19/1/2022 7:23
27/10/2021,Amnat Charoen,1,2904,376306,187145,189161,4821,4821,0,,,19/1/2022 7:23
27/10/2021,Udon Thani,84,22107,1566668,775641,791027,44698,44548,150,,,19/1/2022 7:23
27/10/2021,Uttaradit,8,4191,446617,217679,228938,16832,16832,0,,,19/1/2022 7:23
27/10/2021,Uthai Thani,7,3538,325234,158965,166269,4910,4910,0,,,19/1/2022 7:23
27/10/2021,Ubon Ratchathani,53,19477,1867597,932041,935556,60742,60742,0,63,17,19/1/2022 7:23
27/10/2021,Ang Thong,19,11113,275167,131646,143521,15302,15302,0,,,19/1/2022 7:23
27/10/2021,Chiang Rai,26,4376,1298092,630910,667182,116319,115525,794,43,18,19/1/2022 7:23
27/10/2021,Chiang Mai,270,19132,1788340,863999,924341,214715,212787,1928,73,24,19/1/2022 7:23
27/10/2021,Phetchaburi,132,21631,482659,232915,249744,301889,301778,111,,,19/1/2022 7:23
27/10/2021,Phetchabun,20,10707,978584,482468,496116,84525,84467,58,,,19/1/2022 7:23
27/10/2021,Loei,39,3536,638788,319998,318790,83583,83511,72,58,26,19/1/2022 7:23
27/10/2021,Phrae,3,1760,435038,209644,225394,19532,19532,0,51,21,19/1/2022 7:23
27/10/2021,Mae Hong Son,12,1401,285804,144781,141023,33309,33043,266,58,13,19/1/2022 7:23
27/10/2021,,0,173,,,,,,,,,19/1/2022 7:23
28/10/2021,Krabi,88,7393,479040,237966,241074,6644,6408,236,,,19/1/2022 7:23
28/10/2021,Bangkok,894,426240,5534354,2596396,2937958,535508,483200,52308,92,35,19/1/2022 7:23
28/10/2021,Kanchanaburi,97,20995,894097,448418,445679,467938,467816,122,55,10,19/1/2022 7:23
28/10/2021,Kalasin,143,8887,975928,482318,493610,31863,31863,0,,,19/1/2022 7:23
28/10/2021,Kamphaeng Phet,34,7679,712417,351684,360733,10935,10935,0,,,19/1/2022 7:23
28/10/2021,Khon Kaen,261,20177,1791477,880238,911239,78172,78172,0,83,32,19/1/2022 7:23
28/10/2021,Chanthaburi,220,18520,536488,262258,274230,49181,49069,112,,,19/1/2022 7:23
28/10/2021,Chachoengsao,110,34854,723575,354550,369025,192208,192208,0,78,35,19/1/2022 7:23
28/10/2021,Chon Buri,375,102923,1582463,771883,810580,224103,223216,887,56,32,19/1/2022 7:23
28/10/2021,Chai Nat,25,2432,320853,154238,166615,25249,25249,0,,,19/1/2022 7:23
28/10/2021,Chaiyaphum,19,11444,1122445,554477,567968,24350,24317,33,,,19/1/2022 7:23
28/10/2021,Chumphon,102,12507,509477,251470,258007,7560,7560,0,,,19/1/2022 7:23
28/10/2021,Trang,215,10411,639979,312812,327167,7387,7387,0,,,19/1/2022 7:23
28/10/2021,Trat,175,7249,228426,112944,115482,51815,51639,176,,,19/1/2022 7:23
28/10/2021,Tak,139,21474,675561,341512,334049,23928,23928,0,,,19/1/2022 7:23
28/10/2021,Nakhon Nayok,20,10810,260324,128842,131482,21362,21362,0,,,19/1/2022 7:23
28/10/2021,Nakhon Pathom,56,34547,922078,442736,479342,37242,37188,54,75,28,19/1/2022 7:23
28/10/2021,Nakhon Phanom,2,4878,717013,357096,359917,22046,22046,0,,,19/1/2022 7:23
28/10/2021,Nakhon Ratchasima,65,29180,2634213,1294009,1340204,236917,235237,1680,76,25,19/1/2022 7:23
28/10/2021,Nakhon Si Thammarat,614,28520,1549297,764402,784895,10942,10942,0,,,19/1/2022 7:23
28/10/2021,Nakhon Sawan,92,14632,1035673,505014,530659,28921,28763,158,66,24,19/1/2022 7:23
28/10/2021,Nonthaburi,96,65346,1286596,598356,688240,32482,32370,112,65,28,19/1/2022 7:23
28/10/2021,Narathiwat,327,36050,809130,400257,408873,1549,1549,0,30,24,19/1/2022 7:23
28/10/2021,Nan,0,2385,475962,238027,237935,57643,57453,190,,,19/1/2022 7:23
28/10/2021,Bueng Kan,5,1984,421923,211450,210473,7313,7296,17,,,19/1/2022 7:23
28/10/2021,Buri Ram,35,16631,1579696,783590,796106,48708,48574,134,,,19/1/2022 7:23
28/10/2021,Pathum Thani,99,40334,1187933,562786,625147,26324,26147,177,70,27,19/1/2022 7:23
28/10/2021,Prachuap Khiri Khan,280,15447,553609,274647,278962,262017,261857,160,,,19/1/2022 7:23
28/10/2021,Prachin Buri,92,21911,495017,244513,250504,17246,17246,0,75,37,19/1/2022 7:23
28/10/2021,Pattani,370,35471,729218,360169,369049,1157,1157,0,,,19/1/2022 7:23
28/10/2021,Phra Nakhon Si Ayutthaya,132,30282,820377,393914,426463,161519,160956,563,64,36,19/1/2022 7:23
28/10/2021,Phayao,9,2006,465061,226262,238799,21386,21386,0,48,25,19/1/2022 7:23
28/10/2021,Phang-nga,87,4485,268081,133851,134230,28887,21873,7014,,,19/1/2022 7:23
28/10/2021,Phatthalung,155,8294,522590,254511,268079,3107,3107,0,,,19/1/2022 7:23
28/10/2021,Phichit,23,4730,529974,258338,271636,11935,11935,0,,,19/1/2022 7:23
28/10/2021,Phitsanulok,45,5858,847418,414640,432778,52678,52480,198,,,19/1/2022 7:23
28/10/2021,Phuket,80,15318,419194,198106,221088,91363,64142,27221,67,30,19/1/2022 7:23
28/10/2021,Maha Sarakham,28,10747,949130,465310,483820,12910,12885,25,,,19/1/2022 7:23
28/10/2021,Mukdahan,0,2241,351338,175540,175798,38043,38043,0,,,19/1/2022 7:23
28/10/2021,Yala,534,39958,542002,269804,272198,1327,1327,0,44,27,19/1/2022 7:23
28/10/2021,Yasothon,9,5795,533454,266097,267357,6476,6476,0,,,19/1/2022 7:23
28/10/2021,Ranong,17,9534,194681,98240,96441,5367,5367,0,,,19/1/2022 7:23
28/10/2021,Rayong,273,41175,750107,368398,381709,51424,51159,265,63,24,19/1/2022 7:23
28/10/2021,Ratchaburi,227,36215,868830,422350,446480,88889,88772,117,,,19/1/2022 7:23
28/10/2021,Roi Et,32,13470,1296284,642133,654151,17276,17276,0,,,19/1/2022 7:23
28/10/2021,Lop Buri,62,16384,739712,368713,370999,47834,47796,38,,,19/1/2022 7:23
28/10/2021,Lampang,8,2607,725564,353383,372181,28742,28577,165,55, ,19/1/2022 7:23
28/10/2021,Lamphun,18,2667,401381,192875,208506,18167,18018,149,,,19/1/2022 7:23
28/10/2021,Si Sa Ket,37,16399,1457005,725113,731892,29110,29110,0,,,19/1/2022 7:23
28/10/2021,Sakon Nakhon,9,7601,1146320,569525,576795,37911,37911,0,,,19/1/2022 7:23
28/10/2021,Songkhla,678,47139,1431655,697409,734246,9362,9358,4,58,23,19/1/2022 7:23
28/10/2021,Satun,98,4588,324638,161492,163146,4965,4960,5,52,32,19/1/2022 7:23
28/10/2021,Samut Prakarn,369,124736,1356083,645776,710307,30524,30346,178,,,19/1/2022 7:23
28/10/2021,Samut Songkhram,16,11389,191082,91247,99835,44761,44761,0,40,9,19/1/2022 7:23
28/10/2021,Samut Sakhon,130,109855,586194,282490,303704,20981,20981,0,78,37,19/1/2022 7:23
28/10/2021,Saraburi,97,30566,644040,316399,327641,62770,62680,90,107,67,19/1/2022 7:23
28/10/2021,Sa kaeo,137,16478,561690,280406,281284,11217,10519,698,39,22,19/1/2022 7:23
28/10/2021,Sing Buri,14,2895,204869,97319,107550,15147,15124,23,,,19/1/2022 7:23
28/10/2021,Suphan Buri,81,14425,835825,403209,432616,112708,112708,0,,,19/1/2022 7:23
28/10/2021,Surat Thani,177,18354,1072403,527376,545027,9650,6323,3327,64,31,19/1/2022 7:23
28/10/2021,Surin,61,16751,1376625,684726,691899,19225,19203,22,,,19/1/2022 7:23
28/10/2021,Sukhothai,20,5946,585595,283519,302076,18172,17814,358,,,19/1/2022 7:23
28/10/2021,Nong Khai,41,3655,516972,256377,260595,29617,29500,117,27,12,19/1/2022 7:23
28/10/2021,Nong Bua Lam Phu,15,4184,508984,253786,255198,3417,3402,15,,,19/1/2022 7:23
28/10/2021,Amnat Charoen,12,2916,376306,187145,189161,4821,4821,0,,,19/1/2022 7:23
28/10/2021,Udon Thani,109,22216,1566668,775641,791027,44698,44548,150,,,19/1/2022 7:23
28/10/2021,Uttaradit,20,4211,446617,217679,228938,16832,16832,0,,,19/1/2022 7:23
28/10/2021,Uthai Thani,6,3544,325234,158965,166269,4910,4910,0,,,19/1/2022 7:23
28/10/2021,Ubon Ratchathani,95,19572,1867597,932041,935556,60742,60742,0,34,20,19/1/2022 7:23
28/10/2021,Ang Thong,28,11141,275167,131646,143521,15302,15302,0,,,19/1/2022 7:23
28/10/2021,Chiang Rai,26,4402,1298092,630910,667182,116319,115525,794,50,21,19/1/2022 7:23
28/10/2021,Chiang Mai,356,19488,1788340,863999,924341,214715,212787,1928,54,27,19/1/2022 7:23
28/10/2021,Phetchaburi,130,21761,482659,232915,249744,301889,301778,111,,,19/1/2022 7:23
28/10/2021,Phetchabun,91,10798,978584,482468,496116,84525,84467,58,,,19/1/2022 7:23
28/10/2021,Loei,9,3545,638788,319998,318790,83583,83511,72,61,14,19/1/2022 7:23
28/10/2021,Phrae,3,1763,435038,209644,225394,19532,19532,0,51,19,19/1/2022 7:23
28/10/2021,Mae Hong Son,4,1405,285804,144781,141023,33309,33043,266,52,16,19/1/2022 7:23
28/10/2021,,0,173,,,,,,,,,19/1/2022 7:23
29/10/2021,Krabi,83,7476,479040,237966,241074,6644,6408,236,,,19/1/2022 7:23
29/10/2021,Bangkok,812,427052,5534354,2596396,2937958,535508,483200,52308,76,45,19/1/2022 7:23
29/10/2021,Kanchanaburi,101,21096,894097,448418,445679,467938,467816,122,36,16,19/1/2022 7:23
29/10/2021,Kalasin,60,8947,975928,482318,493610,31863,31863,0,,,19/1/2022 7:23
29/10/2021,Kamphaeng Phet,20,7699,712417,351684,360733,10935,10935,0,,,19/1/2022 7:23
29/10/2021,Khon Kaen,230,20407,1791477,880238,911239,78172,78172,0,52,33,19/1/2022 7:23
29/10/2021,Chanthaburi,149,18669,536488,262258,274230,49181,49069,112,,,19/1/2022 7:23
29/10/2021,Chachoengsao,82,34936,723575,354550,369025,192208,192208,0,57,53,19/1/2022 7:23
29/10/2021,Chon Buri,385,103308,1582463,771883,810580,224103,223216,887,56,36,19/1/2022 7:23
29/10/2021,Chai Nat,9,2441,320853,154238,166615,25249,25249,0,,,19/1/2022 7:23
29/10/2021,Chaiyaphum,43,11487,1122445,554477,567968,24350,24317,33,,,19/1/2022 7:23
29/10/2021,Chumphon,96,12603,509477,251470,258007,7560,7560,0,,,19/1/2022 7:23
29/10/2021,Trang,253,10664,639979,312812,327167,7387,7387,0,,,19/1/2022 7:23
29/10/2021,Trat,75,7324,228426,112944,115482,51815,51639,176,,,19/1/2022 7:23
29/10/2021,Tak,214,21688,675561,341512,334049,23928,23928,0,,,19/1/2022 7:23
29/10/2021,Nakhon Nayok,23,10833,260324,128842,131482,21362,21362,0,,,19/1/2022 7:23
29/10/2021,Nakhon Pathom,52,34599,922078,442736,479342,37242,37188,54,71,34,19/1/2022 7:23
29/10/2021,Nakhon Phanom,2,4880,717013,357096,359917,22046,22046,0,,,19/1/2022 7:23
29/10/2021,Nakhon Ratchasima,139,29319,2634213,1294009,1340204,236917,235237,1680,58,23,19/1/2022 7:23
29/10/2021,Nakhon Si Thammarat,601,29121,1549297,764402,784895,10942,10942,0,,,19/1/2022 7:23
29/10/2021,Nakhon Sawan,118,14750,1035673,505014,530659,28921,28763,158,51,21,19/1/2022 7:23
29/10/2021,Nonthaburi,111,65457,1286596,598356,688240,32482,32370,112,59,28,19/1/2022 7:23
29/10/2021,Narathiwat,295,36345,809130,400257,408873,1549,1549,0,49,17,19/1/2022 7:23
29/10/2021,Nan,34,2419,475962,238027,237935,57643,57453,190,,,19/1/2022 7:23
29/10/2021,Bueng Kan,0,1984,421923,211450,210473,7313,7296,17,,,19/1/2022 7:23
29/10/2021,Buri Ram,35,16666,1579696,783590,796106,48708,48574,134,,,19/1/2022 7:23
29/10/2021,Pathum Thani,118,40452,1187933,562786,625147,26324,26147,177,60,37,19/1/2022 7:23
29/10/2021,Prachuap Khiri Khan,128,15575,553609,274647,278962,262017,261857,160,,,19/1/2022 7:23
29/10/2021,Prachin Buri,137,22048,495017,244513,250504,17246,17246,0,63,37,19/1/2022 7:23
29/10/2021,Pattani,390,35861,729218,360169,369049,1157,1157,0,,,19/1/2022 7:23
29/10/2021,Phra Nakhon Si Ayutthaya,100,30382,820377,393914,426463,161519,160956,563,51,45,19/1/2022 7:23
29/10/2021,Phayao,7,2013,465061,226262,238799,21386,21386,0,58,20,19/1/2022 7:23
29/10/2021,Phang-nga,46,4531,268081,133851,134230,28887,21873,7014,,,19/1/2022 7:23
29/10/2021,Phatthalung,163,8457,522590,254511,268079,3107,3107,0,,,19/1/2022 7:23
29/10/2021,Phichit,33,4763,529974,258338,271636,11935,11935,0,,,19/1/2022 7:23
29/10/2021,Phitsanulok,50,5908,847418,414640,432778,52678,52480,198,,,19/1/2022 7:23
29/10/2021,Phuket,74,15392,419194,198106,221088,91363,64142,27221,71,20,19/1/2022 7:23
29/10/2021,Maha Sarakham,22,10769,949130,465310,483820,12910,12885,25,,,19/1/2022 7:23
29/10/2021,Mukdahan,3,2244,351338,175540,175798,38043,38043,0,,,19/1/2022 7:23
29/10/2021,Yala,387,40345,542002,269804,272198,1327,1327,0,45,27,19/1/2022 7:23
29/10/2021,Yasothon,11,5806,533454,266097,267357,6476,6476,0,,,19/1/2022 7:23
29/10/2021,Ranong,9,9543,194681,98240,96441,5367,5367,0,,,19/1/2022 7:23
29/10/2021,Rayong,248,41423,750107,368398,381709,51424,51159,265,57,36,19/1/2022 7:23
29/10/2021,Ratchaburi,225,36440,868830,422350,446480,88889,88772,117,,,19/1/2022 7:23
29/10/2021,Roi Et,13,13483,1296284,642133,654151,17276,17276,0,,,19/1/2022 7:23
29/10/2021,Lop Buri,69,16453,739712,368713,370999,47834,47796,38,,,19/1/2022 7:23
29/10/2021,Lampang,8,2615,725564,353383,372181,28742,28577,165,59, ,19/1/2022 7:23
29/10/2021,Lamphun,13,2680,401381,192875,208506,18167,18018,149,,,19/1/2022 7:23
29/10/2021,Si Sa Ket,43,16442,1457005,725113,731892,29110,29110,0,,,19/1/2022 7:23
29/10/2021,Sakon Nakhon,18,7619,1146320,569525,576795,37911,37911,0,,,19/1/2022 7:23
29/10/2021,Songkhla,595,47734,1431655,697409,734246,9362,9358,4,47,23,19/1/2022 7:23
29/10/2021,Satun,102,4690,324638,161492,163146,4965,4960,5,52,27,19/1/2022 7:23
29/10/2021,Samut Prakarn,238,124974,1356083,645776,710307,30524,30346,178,,,19/1/2022 7:23
29/10/2021,Samut Songkhram,28,11417,191082,91247,99835,44761,44761,0,26,27,19/1/2022 7:23
29/10/2021,Samut Sakhon,112,109967,586194,282490,303704,20981,20981,0,62,45,19/1/2022 7:23
29/10/2021,Saraburi,99,30665,644040,316399,327641,62770,62680,90,84,79,19/1/2022 7:23
29/10/2021,Sa kaeo,127,16605,561690,280406,281284,11217,10519,698,43,22,19/1/2022 7:23
29/10/2021,Sing Buri,16,2911,204869,97319,107550,15147,15124,23,,,19/1/2022 7:23
29/10/2021,Suphan Buri,44,14469,835825,403209,432616,112708,112708,0,,,19/1/2022 7:23
29/10/2021,Surat Thani,218,18572,1072403,527376,545027,9650,6323,3327,40,21,19/1/2022 7:23
29/10/2021,Surin,43,16794,1376625,684726,691899,19225,19203,22,,,19/1/2022 7:23
29/10/2021,Sukhothai,11,5957,585595,283519,302076,18172,17814,358,,,19/1/2022 7:23
29/10/2021,Nong Khai,30,3685,516972,256377,260595,29617,29500,117,30,11,19/1/2022 7:23
29/10/2021,Nong Bua Lam Phu,2,4186,508984,253786,255198,3417,3402,15,,,19/1/2022 7:23
29/10/2021,Amnat Charoen,0,2916,376306,187145,189161,4821,4821,0,,,19/1/2022 7:23
29/10/2021,Udon Thani,136,22352,1566668,775641,791027,44698,44548,150,,,19/1/2022 7:23
29/10/2021,Uttaradit,18,4229,446617,217679,228938,16832,16832,0,,,19/1/2022 7:23
29/10/2021,Uthai Thani,6,3550,325234,158965,166269,4910,4910,0,,,19/1/2022 7:23
29/10/2021,Ubon Ratchathani,94,19666,1867597,932041,935556,60742,60742,0,35,12,19/1/2022 7:23
29/10/2021,Ang Thong,17,11158,275167,131646,143521,15302,15302,0,,,19/1/2022 7:23
29/10/2021,Chiang Rai,14,4416,1298092,630910,667182,116319,115525,794,59,18,19/1/2022 7:23
29/10/2021,Chiang Mai,403,19891,1788340,863999,924341,214715,212787,1928,64,24,19/1/2022 7:23
29/10/2021,Phetchaburi,167,21928,482659,232915,249744,301889,301778,111,,,19/1/2022 7:23
29/10/2021,Phetchabun,35,10833,978584,482468,496116,84525,84467,58,,,19/1/2022 7:23
29/10/2021,Loei,32,3577,638788,319998,318790,83583,83511,72,27,14,19/1/2022 7:23
29/10/2021,Phrae,5,1768,435038,209644,225394,19532,19532,0,46,18,19/1/2022 7:23
29/10/2021,Mae Hong Son,39,1444,285804,144781,141023,33309,33043,266,59,9,19/1/2022 7:23
29/10/2021,,0,173,,,,,,,,,19/1/2022 7:23
30/10/2021,Krabi,95,7571,479040,237966,241074,6644,6408,236,,,19/1/2022 7:23
30/10/2021,Bangkok,778,427830,5534354,2596396,2937958,535508,483200,52308,90,28,19/1/2022 7:23
30/10/2021,Kanchanaburi,161,21257,894097,448418,445679,467938,467816,122,37,12,19/1/2022 7:23
30/10/2021,Kalasin,59,9006,975928,482318,493610,31863,31863,0,,,19/1/2022 7:23
30/10/2021,Kamphaeng Phet,13,7712,712417,351684,360733,10935,10935,0,,,19/1/2022 7:23
30/10/2021,Khon Kaen,236,20643,1791477,880238,911239,78172,78172,0,55,34,19/1/2022 7:23
30/10/2021,Chanthaburi,209,18878,536488,262258,274230,49181,49069,112,,,19/1/2022 7:23
30/10/2021,Chachoengsao,90,35026,723575,354550,369025,192208,192208,0,95,33,19/1/2022 7:23
30/10/2021,Chon Buri,340,103648,1582463,771883,810580,224103,223216,887,70,23,19/1/2022 7:23
30/10/2021,Chai Nat,21,2462,320853,154238,166615,25249,25249,0,,,19/1/2022 7:23
30/10/2021,Chaiyaphum,16,11503,1122445,554477,567968,24350,24317,33,,,19/1/2022 7:23
30/10/2021,Chumphon,89,12692,509477,251470,258007,7560,7560,0,,,19/1/2022 7:23
30/10/2021,Trang,271,10935,639979,312812,327167,7387,7387,0,,,19/1/2022 7:23
30/10/2021,Trat,74,7398,228426,112944,115482,51815,51639,176,,,19/1/2022 7:23
30/10/2021,Tak,284,21972,675561,341512,334049,23928,23928,0,,,19/1/2022 7:23
30/10/2021,Nakhon Nayok,31,10864,260324,128842,131482,21362,21362,0,,,19/1/2022 7:23
30/10/2021,Nakhon Pathom,50,34649,922078,442736,479342,37242,37188,54,66,24,19/1/2022 7:23
30/10/2021,Nakhon Phanom,1,4881,717013,357096,359917,22046,22046,0,,,19/1/2022 7:23
30/10/2021,Nakhon Ratchasima,160,29479,2634213,1294009,1340204,236917,235237,1680,55,26,19/1/2022 7:23
30/10/2021,Nakhon Si Thammarat,554,29675,1549297,764402,784895,10942,10942,0,,,19/1/2022 7:23
30/10/2021,Nakhon Sawan,97,14847,1035673,505014,530659,28921,28763,158,40,20,19/1/2022 7:23
30/10/2021,Nonthaburi,102,65559,1286596,598356,688240,32482,32370,112,56,22,19/1/2022 7:23
30/10/2021,Narathiwat,290,36635,809130,400257,408873,1549,1549,0,38,13,19/1/2022 7:23
30/10/2021,Nan,9,2428,475962,238027,237935,57643,57453,190,,,19/1/2022 7:23
30/10/2021,Bueng Kan,7,1991,421923,211450,210473,7313,7296,17,,,19/1/2022 7:23
30/10/2021,Buri Ram,31,16697,1579696,783590,796106,48708,48574,134,,,19/1/2022 7:23
30/10/2021,Pathum Thani,90,40542,1187933,562786,625147,26324,26147,177,68,22,19/1/2022 7:23
30/10/2021,Prachuap Khiri Khan,282,15857,553609,274647,278962,262017,261857,160,,,19/1/2022 7:23
30/10/2021,Prachin Buri,118,22166,495017,244513,250504,17246,17246,0,67,31,19/1/2022 7:23
30/10/2021,Pattani,669,36530,729218,360169,369049,1157,1157,0,,,19/1/2022 7:23
30/10/2021,Phra Nakhon Si Ayutthaya,65,30447,820377,393914,426463,161519,160956,563,53,40,19/1/2022 7:23
30/10/2021,Phayao,9,2022,465061,226262,238799,21386,21386,0,47,19,19/1/2022 7:23
30/10/2021,Phang-nga,81,4612,268081,133851,134230,28887,21873,7014,,,19/1/2022 7:23
30/10/2021,Phatthalung,250,8707,522590,254511,268079,3107,3107,0,,,19/1/2022 7:23
30/10/2021,Phichit,24,4787,529974,258338,271636,11935,11935,0,,,19/1/2022 7:23
30/10/2021,Phitsanulok,50,5958,847418,414640,432778,52678,52480,198,,,19/1/2022 7:23
30/10/2021,Phuket,63,15455,419194,198106,221088,91363,64142,27221,56,23,19/1/2022 7:23
30/10/2021,Maha Sarakham,46,10815,949130,465310,483820,12910,12885,25,,,19/1/2022 7:23
30/10/2021,Mukdahan,2,2246,351338,175540,175798,38043,38043,0,,,19/1/2022 7:23
30/10/2021,Yala,426,40771,542002,269804,272198,1327,1327,0,48,21,19/1/2022 7:23
30/10/2021,Yasothon,9,5815,533454,266097,267357,6476,6476,0,,,19/1/2022 7:23
30/10/2021,Ranong,20,9563,194681,98240,96441,5367,5367,0,,,19/1/2022 7:23
30/10/2021,Rayong,241,41664,750107,368398,381709,51424,51159,265,80,24,19/1/2022 7:23
30/10/2021,Ratchaburi,239,36679,868830,422350,446480,88889,88772,117,,,19/1/2022 7:23
30/10/2021,Roi Et,26,13509,1296284,642133,654151,17276,17276,0,,,19/1/2022 7:23
30/10/2021,Lop Buri,46,16499,739712,368713,370999,47834,47796,38,,,19/1/2022 7:23
30/10/2021,Lampang,18,2633,725564,353383,372181,28742,28577,165,52, ,19/1/2022 7:23
30/10/2021,Lamphun,25,2705,401381,192875,208506,18167,18018,149,,,19/1/2022 7:23
30/10/2021,Si Sa Ket,21,16463,1457005,725113,731892,29110,29110,0,,,19/1/2022 7:23
30/10/2021,Sakon Nakhon,10,7629,1146320,569525,576795,37911,37911,0,,,19/1/2022 7:23
30/10/2021,Songkhla,564,48298,1431655,697409,734246,9362,9358,4,49,23,19/1/2022 7:23
30/10/2021,Satun,98,4788,324638,161492,163146,4965,4960,5,32,26,19/1/2022 7:23
30/10/2021,Samut Prakarn,252,125226,1356083,645776,710307,30524,30346,178,,,19/1/2022 7:23
30/10/2021,Samut Songkhram,15,11432,191082,91247,99835,44761,44761,0,60,21,19/1/2022 7:23
30/10/2021,Samut Sakhon,69,110036,586194,282490,303704,20981,20981,0,81,25,19/1/2022 7:23
30/10/2021,Saraburi,93,30758,644040,316399,327641,62770,62680,90,90,87,19/1/2022 7:23
30/10/2021,Sa kaeo,80,16685,561690,280406,281284,11217,10519,698,42,16,19/1/2022 7:23
30/10/2021,Sing Buri,10,2921,204869,97319,107550,15147,15124,23,,,19/1/2022 7:23
30/10/2021,Suphan Buri,53,14522,835825,403209,432616,112708,112708,0,,,19/1/2022 7:23
30/10/2021,Surat Thani,155,18727,1072403,527376,545027,9650,6323,3327,40,22,19/1/2022 7:23
30/10/2021,Surin,47,16841,1376625,684726,691899,19225,19203,22,,,19/1/2022 7:23
30/10/2021,Sukhothai,22,5979,585595,283519,302076,18172,17814,358,,,19/1/2022 7:23
30/10/2021,Nong Khai,40,3725,516972,256377,260595,29617,29500,117,27,11,19/1/2022 7:23
30/10/2021,Nong Bua Lam Phu,11,4197,508984,253786,255198,3417,3402,15,,,19/1/2022 7:23
30/10/2021,Amnat Charoen,0,2916,376306,187145,189161,4821,4821,0,,,19/1/2022 7:23
30/10/2021,Udon Thani,115,22467,1566668,775641,791027,44698,44548,150,,,19/1/2022 7:23
30/10/2021,Uttaradit,17,4246,446617,217679,228938,16832,16832,0,,,19/1/2022 7:23
30/10/2021,Uthai Thani,1,3551,325234,158965,166269,4910,4910,0,,,19/1/2022 7:23
30/10/2021,Ubon Ratchathani,89,19755,1867597,932041,935556,60742,60742,0,24,16,19/1/2022 7:23
30/10/2021,Ang Thong,15,11173,275167,131646,143521,15302,15302,0,,,19/1/2022 7:23
30/10/2021,Chiang Rai,25,4441,1298092,630910,667182,116319,115525,794,49,15,19/1/2022 7:23
30/10/2021,Chiang Mai,414,20305,1788340,863999,924341,214715,212787,1928,56,24,19/1/2022 7:23
30/10/2021,Phetchaburi,81,22009,482659,232915,249744,301889,301778,111,,,19/1/2022 7:23
30/10/2021,Phetchabun,31,10864,978584,482468,496116,84525,84467,58,,,19/1/2022 7:23
30/10/2021,Loei,6,3583,638788,319998,318790,83583,83511,72,26,17,19/1/2022 7:23
30/10/2021,Phrae,12,1780,435038,209644,225394,19532,19532,0,47,20,19/1/2022 7:23
30/10/2021,Mae Hong Son,11,1455,285804,144781,141023,33309,33043,266,40,8,19/1/2022 7:23
30/10/2021,,0,173,,,,,,,,,19/1/2022 7:23
31/10/2021,Krabi,93,7664,479040,237966,241074,6644,6408,236,,,19/1/2022 7:23
31/10/2021,Bangkok,639,428469,5534354,2596396,2937958,535508,483200,52308,61,31,19/1/2022 7:23
31/10/2021,Kanchanaburi,155,21412,894097,448418,445679,467938,467816,122,21,13,19/1/2022 7:23
31/10/2021,Kalasin,39,9045,975928,482318,493610,31863,31863,0,,,19/1/2022 7:23
31/10/2021,Kamphaeng Phet,26,7738,712417,351684,360733,10935,10935,0,,,19/1/2022 7:23
31/10/2021,Khon Kaen,207,20850,1791477,880238,911239,78172,78172,0,56,33,19/1/2022 7:23
31/10/2021,Chanthaburi,166,19044,536488,262258,274230,49181,49069,112,,,19/1/2022 7:23
31/10/2021,Chachoengsao,93,35119,723575,354550,369025,192208,192208,0,46,38,19/1/2022 7:23
31/10/2021,Chon Buri,344,103992,1582463,771883,810580,224103,223216,887,47,32,19/1/2022 7:23
31/10/2021,Chai Nat,3,2465,320853,154238,166615,25249,25249,0,,,19/1/2022 7:23
31/10/2021,Chaiyaphum,23,11526,1122445,554477,567968,24350,24317,33,,,19/1/2022 7:23
31/10/2021,Chumphon,87,12779,509477,251470,258007,7560,7560,0,,,19/1/2022 7:23
31/10/2021,Trang,282,11217,639979,312812,327167,7387,7387,0,,,19/1/2022 7:23
31/10/2021,Trat,67,7465,228426,112944,115482,51815,51639,176,,,19/1/2022 7:23
31/10/2021,Tak,121,22093,675561,341512,334049,23928,23928,0,,,19/1/2022 7:23
31/10/2021,Nakhon Nayok,17,10881,260324,128842,131482,21362,21362,0,,,19/1/2022 7:23
31/10/2021,Nakhon Pathom,86,34735,922078,442736,479342,37242,37188,54,61,22,19/1/2022 7:23
31/10/2021,Nakhon Phanom,0,4881,717013,357096,359917,22046,22046,0,,,19/1/2022 7:23
31/10/2021,Nakhon Ratchasima,155,29634,2634213,1294009,1340204,236917,235237,1680,57,25,19/1/2022 7:23
31/10/2021,Nakhon Si Thammarat,575,30250,1549297,764402,784895,10942,10942,0,,,19/1/2022 7:23
31/10/2021,Nakhon Sawan,91,14938,1035673,505014,530659,28921,28763,158,39,24,19/1/2022 7:23
31/10/2021,Nonthaburi,97,65656,1286596,598356,688240,32482,32370,112,38,23,19/1/2022 7:23
31/10/2021,Narathiwat,290,36925,809130,400257,408873,1549,1549,0,29,14,19/1/2022 7:23
31/10/2021,Nan,6,2434,475962,238027,237935,57643,57453,190,,,19/1/2022 7:23
31/10/2021,Bueng Kan,4,1995,421923,211450,210473,7313,7296,17,,,19/1/2022 7:23
31/10/2021,Buri Ram,35,16732,1579696,783590,796106,48708,48574,134,,,19/1/2022 7:23
31/10/2021,Pathum Thani,71,40613,1187933,562786,625147,26324,26147,177,42,29,19/1/2022 7:23
31/10/2021,Prachuap Khiri Khan,152,16009,553609,274647,278962,262017,261857,160,,,19/1/2022 7:23
31/10/2021,Prachin Buri,144,22310,495017,244513,250504,17246,17246,0,52,33,19/1/2022 7:23
31/10/2021,Pattani,559,37089,729218,360169,369049,1157,1157,0,,,19/1/2022 7:23
31/10/2021,Phra Nakhon Si Ayutthaya,124,30571,820377,393914,426463,161519,160956,563,41,44,19/1/2022 7:23
31/10/2021,Phayao,34,2056,465061,226262,238799,21386,21386,0,41,19,19/1/2022 7:23
31/10/2021,Phang-nga,69,4681,268081,133851,134230,28887,21873,7014,,,19/1/2022 7:23
31/10/2021,Phatthalung,87,8794,522590,254511,268079,3107,3107,0,,,19/1/2022 7:23
31/10/2021,Phichit,12,4799,529974,258338,271636,11935,11935,0,,,19/1/2022 7:23
31/10/2021,Phitsanulok,45,6003,847418,414640,432778,52678,52480,198,,,19/1/2022 7:23
31/10/2021,Phuket,62,15517,419194,198106,221088,91363,64142,27221,54,21,19/1/2022 7:23
31/10/2021,Maha Sarakham,41,10856,949130,465310,483820,12910,12885,25,,,19/1/2022 7:23
31/10/2021,Mukdahan,19,2265,351338,175540,175798,38043,38043,0,,,19/1/2022 7:23
31/10/2021,Yala,379,41150,542002,269804,272198,1327,1327,0,38,21,19/1/2022 7:23
31/10/2021,Yasothon,4,5819,533454,266097,267357,6476,6476,0,,,19/1/2022 7:23
31/10/2021,Ranong,28,9591,194681,98240,96441,5367,5367,0,,,19/1/2022 7:23
31/10/2021,Rayong,287,41951,750107,368398,381709,51424,51159,265,58,26,19/1/2022 7:23
31/10/2021,Ratchaburi,114,36793,868830,422350,446480,88889,88772,117,,,19/1/2022 7:23
31/10/2021,Roi Et,39,13548,1296284,642133,654151,17276,17276,0,,,19/1/2022 7:23
31/10/2021,Lop Buri,78,16577,739712,368713,370999,47834,47796,38,,,19/1/2022 7:23
31/10/2021,Lampang,26,2659,725564,353383,372181,28742,28577,165,46, ,19/1/2022 7:23
31/10/2021,Lamphun,16,2721,401381,192875,208506,18167,18018,149,,,19/1/2022 7:23
31/10/2021,Si Sa Ket,20,16483,1457005,725113,731892,29110,29110,0,,,19/1/2022 7:23
31/10/2021,Sakon Nakhon,22,7651,1146320,569525,576795,37911,37911,0,,,19/1/2022 7:23
31/10/2021,Songkhla,585,48883,1431655,697409,734246,9362,9358,4,50,22,19/1/2022 7:23
31/10/2021,Satun,96,4884,324638,161492,163146,4965,4960,5,31,22,19/1/2022 7:23
31/10/2021,Samut Prakarn,296,125522,1356083,645776,710307,30524,30346,178,,,19/1/2022 7:23
31/10/2021,Samut Songkhram,26,11458,191082,91247,99835,44761,44761,0,52,25,19/1/2022 7:23
31/10/2021,Samut Sakhon,102,110138,586194,282490,303704,20981,20981,0,49,36,19/1/2022 7:23
31/10/2021,Saraburi,88,30846,644040,316399,327641,62770,62680,90,94,85,19/1/2022 7:23
31/10/2021,Sa kaeo,82,16767,561690,280406,281284,11217,10519,698,29,23,19/1/2022 7:23
31/10/2021,Sing Buri,15,2936,204869,97319,107550,15147,15124,23,,,19/1/2022 7:23
31/10/2021,Suphan Buri,57,14579,835825,403209,432616,112708,112708,0,,,19/1/2022 7:23
31/10/2021,Surat Thani,195,18922,1072403,527376,545027,9650,6323,3327,34,17,19/1/2022 7:23
31/10/2021,Surin,201,17042,1376625,684726,691899,19225,19203,22,,,19/1/2022 7:23
31/10/2021,Sukhothai,9,5988,585595,283519,302076,18172,17814,358,,,19/1/2022 7:23
31/10/2021,Nong Khai,23,3748,516972,256377,260595,29617,29500,117,27,10,19/1/2022 7:23
31/10/2021,Nong Bua Lam Phu,7,4204,508984,253786,255198,3417,3402,15,,,19/1/2022 7:23
31/10/2021,Amnat Charoen,10,2926,376306,187145,189161,4821,4821,0,,,19/1/2022 7:23
31/10/2021,Udon Thani,141,22608,1566668,775641,791027,44698,44548,150,,,19/1/2022 7:23
31/10/2021,Uttaradit,8,4254,446617,217679,228938,16832,16832,0,,,19/1/2022 7:23
31/10/2021,Uthai Thani,4,3555,325234,158965,166269,4910,4910,0,,,19/1/2022 7:23
31/10/2021,Ubon Ratchathani,65,19820,1867597,932041,935556,60742,60742,0,34,17,19/1/2022 7:23
31/10/2021,Ang Thong,23,11196,275167,131646,143521,15302,15302,0,,,19/1/2022 7:23
31/10/2021,Chiang Rai,30,4471,1298092,630910,667182,116319,115525,794,35,12,19/1/2022 7:23
31/10/2021,Chiang Mai,397,20702,1788340,863999,924341,214715,212787,1928,52,22,19/1/2022 7:23
31/10/2021,Phetchaburi,105,22114,482659,232915,249744,301889,301778,111,,,19/1/2022 7:23
31/10/2021,Phetchabun,55,10919,978584,482468,496116,84525,84467,58,,,19/1/2022 7:23
31/10/2021,Loei,72,3655,638788,319998,318790,83583,83511,72,33,13,19/1/2022 7:23
31/10/2021,Phrae,17,1797,435038,209644,225394,19532,19532,0,44,17,19/1/2022 7:23
31/10/2021,Mae Hong Son,17,1472,285804,144781,141023,33309,33043,266,30,9,19/1/2022 7:23
31/10/2021,,0,173,,,,,,,,,19/1/2022 7:23
1/11/2021,Krabi,90,7754,479290,238118,241172,49198,48852,346,,,19/1/2022 7:23
1/11/2021,Bangkok,701,429170,5530283,2593687,2936596,1294781,1215564,79217,62,36,19/1/2022 7:23
1/11/2021,Kanchanaburi,147,21559,893747,448009,445738,812418,812043,375,19,13,19/1/2022 7:23
1/11/2021,Kalasin,36,9081,975840,482246,493594,39828,39803,25,,,19/1/2022 7:23
1/11/2021,Kamphaeng Phet,19,7757,712340,351623,360717,40873,40710,163,,,19/1/2022 7:23
1/11/2021,Khon Kaen,268,21118,1791302,880185,911117,195487,195350,137,56,38,19/1/2022 7:23
1/11/2021,Chanthaburi,118,19162,536572,262310,274262,127398,127173,225,,,19/1/2022 7:23
1/11/2021,Chachoengsao,58,35177,724145,354876,369269,337607,337607,0,60,49,19/1/2022 7:23
1/11/2021,Chon Buri,259,104251,1583412,772344,811068,929255,920898,8357,59,22,19/1/2022 7:23
1/11/2021,Chai Nat,3,2468,320710,154147,166563,44850,44850,0,,,19/1/2022 7:23
1/11/2021,Chaiyaphum,16,11542,1122715,554712,568003,48905,48826,79,,,19/1/2022 7:23
1/11/2021,Chumphon,71,12850,509632,251576,258056,33159,33146,13,,,19/1/2022 7:23
1/11/2021,Trang,296,11513,639941,312807,327134,25842,25842,0,,,19/1/2022 7:23
1/11/2021,Trat,52,7517,228339,112907,115432,106763,104219,2544,,,19/1/2022 7:23
1/11/2021,Tak,129,22222,676105,341755,334350,65113,65113,0,,,19/1/2022 7:23
1/11/2021,Nakhon Nayok,45,10926,260391,128848,131543,170824,170788,36,,,19/1/2022 7:23
1/11/2021,Nakhon Pathom,62,34797,921946,442578,479368,116491,116387,104,56,31,19/1/2022 7:23
1/11/2021,Nakhon Phanom,0,4881,717181,357273,359908,60530,60511,19,,,19/1/2022 7:23
1/11/2021,Nakhon Ratchasima,67,29701,2634154,1293776,1340378,473887,472075,1812,53,28,19/1/2022 7:23
1/11/2021,Nakhon Si Thammarat,540,30790,1549258,764251,785007,22828,22804,24,,,19/1/2022 7:23
1/11/2021,Nakhon Sawan,109,15047,1035583,505021,530562,75335,75110,225,45,22,19/1/2022 7:23
1/11/2021,Nonthaburi,102,65758,1287480,598638,688842,91335,90985,350,45,26,19/1/2022 7:23
1/11/2021,Narathiwat,351,37276,809341,400380,408961,3051,3051,0,32,19,19/1/2022 7:23
1/11/2021,Nan,4,2438,475894,237970,237924,103582,102713,869,,,19/1/2022 7:23
1/11/2021,Bueng Kan,11,2006,422056,211601,210455,13820,13531,289,,,19/1/2022 7:23
1/11/2021,Buri Ram,27,16759,1580074,783823,796251,77399,76979,420,,,19/1/2022 7:23
1/11/2021,Pathum Thani,35,40648,1189186,563353,625833,80926,80630,296,52,31,19/1/2022 7:23
1/11/2021,Prachuap Khiri Khan,146,16155,553198,274111,279087,450266,449376,890,,,19/1/2022 7:23
1/11/2021,Prachin Buri,96,22406,494804,244188,250616,86770,86638,132,57,34,19/1/2022 7:23
1/11/2021,Pattani,450,37539,729331,360142,369189,4532,4532,0,,,19/1/2022 7:23
1/11/2021,Phra Nakhon Si Ayutthaya,80,30651,820637,394133,426504,389058,388198,860,52,46,19/1/2022 7:23
1/11/2021,Phayao,10,2066,464807,226101,238706,52329,51787,542,40,16,19/1/2022 7:23
1/11/2021,Phang-nga,48,4729,268121,133884,134237,57579,43267,14312,,,19/1/2022 7:23
1/11/2021,Phatthalung,157,8951,522562,254456,268106,19880,19880,0,,,19/1/2022 7:23
1/11/2021,Phichit,15,4814,529730,258152,271578,28128,28128,0,,,19/1/2022 7:23
1/11/2021,Phitsanulok,42,6045,847456,414644,432812,147550,147235,315,,,19/1/2022 7:23
1/11/2021,Phuket,64,15581,418939,198000,220939,158721,117533,41188,52,21,19/1/2022 7:23
1/11/2021,Maha Sarakham,14,10870,948760,465243,483517,22566,22530,36,,,19/1/2022 7:23
1/11/2021,Mukdahan,13,2278,351477,175634,175843,91851,91830,21,,,19/1/2022 7:23
1/11/2021,Yala,290,41440,542249,269916,272333,8303,8303,0,38,27,19/1/2022 7:23
1/11/2021,Yasothon,2,5821,533387,266000,267387,11956,11956,0,,,19/1/2022 7:23
1/11/2021,Ranong,13,9604,194713,98257,96456,10718,10686,32,,,19/1/2022 7:23
1/11/2021,Rayong,240,42191,750813,368748,382065,449414,446915,2499,63,29,19/1/2022 7:23
1/11/2021,Ratchaburi,195,36988,868383,421933,446450,156792,156354,438,,,19/1/2022 7:23
1/11/2021,Roi Et,36,13584,1296246,642036,654210,29035,28998,37,,,19/1/2022 7:23
1/11/2021,Lop Buri,56,16633,739079,368209,370870,164681,164569,112,,,19/1/2022 7:23
1/11/2021,Lampang,12,2671,725197,353220,371977,91037,90339,698,57, ,19/1/2022 7:23
1/11/2021,Lamphun,13,2734,401266,192787,208479,66278,65498,780,,,19/1/2022 7:23
1/11/2021,Si Sa Ket,14,16497,1457748,725758,731990,51233,51233,0,,,19/1/2022 7:23
1/11/2021,Sakon Nakhon,9,7660,1146663,569782,576881,101215,101215,0,,,19/1/2022 7:23
1/11/2021,Songkhla,476,49359,1431562,697309,734253,24450,24434,16,48,32,19/1/2022 7:23
1/11/2021,Satun,95,4979,324802,161606,163196,53346,53307,39,29,28,19/1/2022 7:23
1/11/2021,Samut Prakarn,255,125777,1356374,645942,710432,65953,52911,13042,,,19/1/2022 7:23
1/11/2021,Samut Songkhram,12,11470,191049,91232,99817,103736,103736,0,54,22,19/1/2022 7:23
1/11/2021,Samut Sakhon,139,110277,586485,282611,303874,27110,27075,35,60,43,19/1/2022 7:23
1/11/2021,Saraburi,99,30945,643429,315725,327704,213646,213508,138,105,87,19/1/2022 7:23
1/11/2021,Sa kaeo,30,16797,561712,280407,281305,80293,79161,1132,43,19,19/1/2022 7:23
1/11/2021,Sing Buri,9,2945,204758,97261,107497,22448,22402,46,,,19/1/2022 7:23
1/11/2021,Suphan Buri,35,14614,835777,403176,432601,279513,279513,0,,,19/1/2022 7:23
1/11/2021,Surat Thani,194,19116,1072430,527357,545073,31940,27595,4345,40,20,19/1/2022 7:23
1/11/2021,Surin,357,17399,1376669,684750,691919,36906,36878,28,,,19/1/2022 7:23
1/11/2021,Sukhothai,6,5994,585572,283544,302028,59322,58638,684,,,19/1/2022 7:23
1/11/2021,Nong Khai,49,3797,516910,256357,260553,88413,88064,349,26,10,19/1/2022 7:23
1/11/2021,Nong Bua Lam Phu,2,4206,509096,253820,255276,9330,9305,25,,,19/1/2022 7:23
1/11/2021,Amnat Charoen,0,2926,376417,187215,189202,12411,12411,0,,,19/1/2022 7:23
1/11/2021,Udon Thani,143,22751,1566796,775703,791093,112923,112463,460,,,19/1/2022 7:23
1/11/2021,Uttaradit,4,4258,446358,217547,228811,51788,51679,109,,,19/1/2022 7:23
1/11/2021,Uthai Thani,1,3556,325208,158967,166241,33303,33303,0,,,19/1/2022 7:23
1/11/2021,Ubon Ratchathani,44,19864,1868052,932286,935766,119633,119591,42,31,19,19/1/2022 7:23
1/11/2021,Ang Thong,17,11213,275021,131590,143431,28564,28564,0,,,19/1/2022 7:23
1/11/2021,Chiang Rai,27,4498,1298579,631054,667525,266159,265473,686,32,12,19/1/2022 7:23
1/11/2021,Chiang Mai,378,21080,1788986,864222,924764,779417,775914,3503,47,20,19/1/2022 7:23
1/11/2021,Phetchaburi,73,22187,482577,232780,249797,479666,479543,123,,,19/1/2022 7:23
1/11/2021,Phetchabun,27,10946,978573,482421,496152,134305,133818,487,,,19/1/2022 7:23
1/11/2021,Loei,28,3683,638978,320126,318852,126076,125834,242,22,15,19/1/2022 7:23
1/11/2021,Phrae,7,1804,434895,209621,225274,51804,51653,151,43,21,19/1/2022 7:23
1/11/2021,Mae Hong Son,27,1499,285927,144863,141064,73223,71986,1237,38,8,19/1/2022 7:23
1/11/2021,,0,173,,,,,,,,,19/1/2022 7:23
2/11/2021,Krabi,89,7843,479290,238118,241172,49198,48852,346,,,19/1/2022 7:23
2/11/2021,Bangkok,823,429993,5530283,2593687,2936596,1294781,1215564,79217,69,35,19/1/2022 7:23
2/11/2021,Kanchanaburi,142,21701,893747,448009,445738,812418,812043,375,29,15,19/1/2022 7:23
2/11/2021,Kalasin,27,9108,975840,482246,493594,39828,39803,25,,,19/1/2022 7:23
2/11/2021,Kamphaeng Phet,4,7761,712340,351623,360717,40873,40710,163,,,19/1/2022 7:23
2/11/2021,Khon Kaen,320,21438,1791302,880185,911117,195487,195350,137,59,43,19/1/2022 7:23
2/11/2021,Chanthaburi,137,19299,536572,262310,274262,127398,127173,225,,,19/1/2022 7:23
2/11/2021,Chachoengsao,64,35241,724145,354876,369269,337607,337607,0,69,50,19/1/2022 7:23
2/11/2021,Chon Buri,264,104515,1583412,772344,811068,929255,920898,8357,40,37,19/1/2022 7:23
2/11/2021,Chai Nat,9,2477,320710,154147,166563,44850,44850,0,,,19/1/2022 7:23
2/11/2021,Chaiyaphum,18,11560,1122715,554712,568003,48905,48826,79,,,19/1/2022 7:23
2/11/2021,Chumphon,73,12923,509632,251576,258056,33159,33146,13,,,19/1/2022 7:23
2/11/2021,Trang,298,11811,639941,312807,327134,25842,25842,0,,,19/1/2022 7:23
2/11/2021,Trat,37,7554,228339,112907,115432,106763,104219,2544,,,19/1/2022 7:23
2/11/2021,Tak,90,22312,676105,341755,334350,65113,65113,0,,,19/1/2022 7:23
2/11/2021,Nakhon Nayok,17,10943,260391,128848,131543,170824,170788,36,,,19/1/2022 7:23
2/11/2021,Nakhon Pathom,53,34850,921946,442578,479368,116491,116387,104,69,25,19/1/2022 7:23
2/11/2021,Nakhon Phanom,0,4881,717181,357273,359908,60530,60511,19,,,19/1/2022 7:23
2/11/2021,Nakhon Ratchasima,86,29787,2634154,1293776,1340378,473887,472075,1812,59,29,19/1/2022 7:23
2/11/2021,Nakhon Si Thammarat,416,31206,1549258,764251,785007,22828,22804,24,,,19/1/2022 7:23
2/11/2021,Nakhon Sawan,100,15147,1035583,505021,530562,75335,75110,225,45,30,19/1/2022 7:23
2/11/2021,Nonthaburi,96,65854,1287480,598638,688842,91335,90985,350,49,24,19/1/2022 7:23
2/11/2021,Narathiwat,211,37487,809341,400380,408961,3051,3051,0,41,15,19/1/2022 7:23
2/11/2021,Nan,3,2441,475894,237970,237924,103582,102713,869,,,19/1/2022 7:23
2/11/2021,Bueng Kan,4,2010,422056,211601,210455,13820,13531,289,,,19/1/2022 7:23
2/11/2021,Buri Ram,25,16784,1580074,783823,796251,77399,76979,420,,,19/1/2022 7:23
2/11/2021,Pathum Thani,31,40679,1189186,563353,625833,80926,80630,296,51,29,19/1/2022 7:23
2/11/2021,Prachuap Khiri Khan,181,16336,553198,274111,279087,450266,449376,890,,,19/1/2022 7:23
2/11/2021,Prachin Buri,82,22488,494804,244188,250616,86770,86638,132,55,33,19/1/2022 7:23
2/11/2021,Pattani,632,38171,729331,360142,369189,4532,4532,0,,,19/1/2022 7:23
2/11/2021,Phra Nakhon Si Ayutthaya,50,30701,820637,394133,426504,389058,388198,860,55,41,19/1/2022 7:23
2/11/2021,Phayao,12,2078,464807,226101,238706,52329,51787,542,33,15,19/1/2022 7:23
2/11/2021,Phang-nga,40,4769,268121,133884,134237,57579,43267,14312,,,19/1/2022 7:23
2/11/2021,Phatthalung,200,9151,522562,254456,268106,19880,19880,0,,,19/1/2022 7:23
2/11/2021,Phichit,28,4842,529730,258152,271578,28128,28128,0,,,19/1/2022 7:23
2/11/2021,Phitsanulok,50,6095,847456,414644,432812,147550,147235,315,,,19/1/2022 7:23
2/11/2021,Phuket,55,15636,418939,198000,220939,158721,117533,41188,41,25,19/1/2022 7:23
2/11/2021,Maha Sarakham,7,10877,948760,465243,483517,22566,22530,36,,,19/1/2022 7:23
2/11/2021,Mukdahan,13,2291,351477,175634,175843,91851,91830,21,,,19/1/2022 7:23
2/11/2021,Yala,185,41625,542249,269916,272333,8303,8303,0,46,27,19/1/2022 7:23
2/11/2021,Yasothon,1,5822,533387,266000,267387,11956,11956,0,,,19/1/2022 7:23
2/11/2021,Ranong,26,9630,194713,98257,96456,10718,10686,32,,,19/1/2022 7:23
2/11/2021,Rayong,147,42338,750813,368748,382065,449414,446915,2499,61,32,19/1/2022 7:23
2/11/2021,Ratchaburi,150,37138,868383,421933,446450,156792,156354,438,,,19/1/2022 7:23
2/11/2021,Roi Et,44,13628,1296246,642036,654210,29035,28998,37,,,19/1/2022 7:23
2/11/2021,Lop Buri,35,16668,739079,368209,370870,164681,164569,112,,,19/1/2022 7:23
2/11/2021,Lampang,8,2679,725197,353220,371977,91037,90339,698,53, ,19/1/2022 7:23
2/11/2021,Lamphun,5,2739,401266,192787,208479,66278,65498,780,,,19/1/2022 7:23
2/11/2021,Si Sa Ket,38,16535,1457748,725758,731990,51233,51233,0,,,19/1/2022 7:23
2/11/2021,Sakon Nakhon,5,7665,1146663,569782,576881,101215,101215,0,,,19/1/2022 7:23
2/11/2021,Songkhla,402,49761,1431562,697309,734253,24450,24434,16,68,26,19/1/2022 7:23
2/11/2021,Satun,138,5117,324802,161606,163196,53346,53307,39,33,27,19/1/2022 7:23
2/11/2021,Samut Prakarn,189,125966,1356374,645942,710432,65953,52911,13042,,,19/1/2022 7:23
2/11/2021,Samut Songkhram,10,11480,191049,91232,99817,103736,103736,0,47,22,19/1/2022 7:23
2/11/2021,Samut Sakhon,31,110308,586485,282611,303874,27110,27075,35,74,37,19/1/2022 7:23
2/11/2021,Saraburi,90,31035,643429,315725,327704,213646,213508,138,97,99,19/1/2022 7:23
2/11/2021,Sa kaeo,68,16865,561712,280407,281305,80293,79161,1132,40,23,19/1/2022 7:23
2/11/2021,Sing Buri,6,2951,204758,97261,107497,22448,22402,46,,,19/1/2022 7:23
2/11/2021,Suphan Buri,28,14642,835777,403176,432601,279513,279513,0,,,19/1/2022 7:23
2/11/2021,Surat Thani,158,19274,1072430,527357,545073,31940,27595,4345,33,21,19/1/2022 7:23
2/11/2021,Surin,272,17671,1376669,684750,691919,36906,36878,28,,,19/1/2022 7:23
2/11/2021,Sukhothai,8,6002,585572,283544,302028,59322,58638,684,,,19/1/2022 7:23
2/11/2021,Nong Khai,32,3829,516910,256357,260553,88413,88064,349,26,12,19/1/2022 7:23
2/11/2021,Nong Bua Lam Phu,4,4210,509096,253820,255276,9330,9305,25,,,19/1/2022 7:23
2/11/2021,Amnat Charoen,0,2926,376417,187215,189202,12411,12411,0,,,19/1/2022 7:23
2/11/2021,Udon Thani,105,22856,1566796,775703,791093,112923,112463,460,,,19/1/2022 7:23
2/11/2021,Uttaradit,8,4266,446358,217547,228811,51788,51679,109,,,19/1/2022 7:23
2/11/2021,Uthai Thani,5,3561,325208,158967,166241,33303,33303,0,,,19/1/2022 7:23
2/11/2021,Ubon Ratchathani,31,19895,1868052,932286,935766,119633,119591,42,40,20,19/1/2022 7:23
2/11/2021,Ang Thong,8,11221,275021,131590,143431,28564,28564,0,,,19/1/2022 7:23
2/11/2021,Chiang Rai,12,4510,1298579,631054,667525,266159,265473,686,26,13,19/1/2022 7:23
2/11/2021,Chiang Mai,271,21351,1788986,864222,924764,779417,775914,3503,47,24,19/1/2022 7:23
2/11/2021,Phetchaburi,85,22272,482577,232780,249797,479666,479543,123,,,19/1/2022 7:23
2/11/2021,Phetchabun,11,10957,978573,482421,496152,134305,133818,487,,,19/1/2022 7:23
2/11/2021,Loei,64,3747,638978,320126,318852,126076,125834,242,30,17,19/1/2022 7:23
2/11/2021,Phrae,6,1810,434895,209621,225274,51804,51653,151,48,19,19/1/2022 7:23
2/11/2021,Mae Hong Son,101,1600,285927,144863,141064,73223,71986,1237,32,5,19/1/2022 7:23
2/11/2021,,0,173,,,,,,,,,19/1/2022 7:23
3/11/2021,Krabi,96,7939,479290,238118,241172,49198,48852,346,,,19/1/2022 7:23
3/11/2021,Bangkok,807,430800,5530283,2593687,2936596,1294781,1215564,79217,66,39,19/1/2022 7:23
3/11/2021,Kanchanaburi,64,21765,893747,448009,445738,812418,812043,375,25,17,19/1/2022 7:23
3/11/2021,Kalasin,24,9132,975840,482246,493594,39828,39803,25,,,19/1/2022 7:23
3/11/2021,Kamphaeng Phet,13,7774,712340,351623,360717,40873,40710,163,,,19/1/2022 7:23
3/11/2021,Khon Kaen,299,21737,1791302,880185,911117,195487,195350,137,69,41,19/1/2022 7:23
3/11/2021,Chanthaburi,168,19467,536572,262310,274262,127398,127173,225,,,19/1/2022 7:23
3/11/2021,Chachoengsao,141,35382,724145,354876,369269,337607,337607,0,75,41,19/1/2022 7:23
3/11/2021,Chon Buri,324,104839,1583412,772344,811068,929255,920898,8357,58,34,19/1/2022 7:23
3/11/2021,Chai Nat,30,2507,320710,154147,166563,44850,44850,0,,,19/1/2022 7:23
3/11/2021,Chaiyaphum,13,11573,1122715,554712,568003,48905,48826,79,,,19/1/2022 7:23
3/11/2021,Chumphon,68,12991,509632,251576,258056,33159,33146,13,,,19/1/2022 7:23
3/11/2021,Trang,249,12060,639941,312807,327134,25842,25842,0,,,19/1/2022 7:23
3/11/2021,Trat,52,7606,228339,112907,115432,106763,104219,2544,,,19/1/2022 7:23
3/11/2021,Tak,121,22433,676105,341755,334350,65113,65113,0,,,19/1/2022 7:23
3/11/2021,Nakhon Nayok,40,10983,260391,128848,131543,170824,170788,36,,,19/1/2022 7:23
3/11/2021,Nakhon Pathom,38,34888,921946,442578,479368,116491,116387,104,52,39,19/1/2022 7:23
3/11/2021,Nakhon Phanom,1,4882,717181,357273,359908,60530,60511,19,,,19/1/2022 7:23
3/11/2021,Nakhon Ratchasima,83,29870,2634154,1293776,1340378,473887,472075,1812,57,42,19/1/2022 7:23
3/11/2021,Nakhon Si Thammarat,196,31402,1549258,764251,785007,22828,22804,24,,,19/1/2022 7:23
3/11/2021,Nakhon Sawan,88,15235,1035583,505021,530562,75335,75110,225,56,32,19/1/2022 7:23
3/11/2021,Nonthaburi,85,65939,1287480,598638,688842,91335,90985,350,47,25,19/1/2022 7:23
3/11/2021,Narathiwat,207,37694,809341,400380,408961,3051,3051,0,34,19,19/1/2022 7:23
3/11/2021,Nan,2,2443,475894,237970,237924,103582,102713,869,,,19/1/2022 7:23
3/11/2021,Bueng Kan,8,2018,422056,211601,210455,13820,13531,289,,,19/1/2022 7:23
3/11/2021,Buri Ram,30,16814,1580074,783823,796251,77399,76979,420,,,19/1/2022 7:23
3/11/2021,Pathum Thani,62,40741,1189186,563353,625833,80926,80630,296,49,36,19/1/2022 7:23
3/11/2021,Prachuap Khiri Khan,113,16449,553198,274111,279087,450266,449376,890,,,19/1/2022 7:23
3/11/2021,Prachin Buri,178,22666,494804,244188,250616,86770,86638,132,51,37,19/1/2022 7:23
3/11/2021,Pattani,484,38655,729331,360142,369189,4532,4532,0,,,19/1/2022 7:23
3/11/2021,Phra Nakhon Si Ayutthaya,47,30748,820637,394133,426504,389058,388198,860,45,52,19/1/2022 7:23
3/11/2021,Phayao,21,2099,464807,226101,238706,52329,51787,542,37,17,19/1/2022 7:23
3/11/2021,Phang-nga,74,4843,268121,133884,134237,57579,43267,14312,,,19/1/2022 7:23
3/11/2021,Phatthalung,63,9214,522562,254456,268106,19880,19880,0,,,19/1/2022 7:23
3/11/2021,Phichit,12,4854,529730,258152,271578,28128,28128,0,,,19/1/2022 7:23
3/11/2021,Phitsanulok,55,6150,847456,414644,432812,147550,147235,315,,,19/1/2022 7:23
3/11/2021,Phuket,58,15694,418939,198000,220939,158721,117533,41188,38,25,19/1/2022 7:23
3/11/2021,Maha Sarakham,14,10891,948760,465243,483517,22566,22530,36,,,19/1/2022 7:23
3/11/2021,Mukdahan,19,2310,351477,175634,175843,91851,91830,21,,,19/1/2022 7:23
3/11/2021,Yala,326,41951,542249,269916,272333,8303,8303,0,46,27,19/1/2022 7:23
3/11/2021,Yasothon,6,5828,533387,266000,267387,11956,11956,0,,,19/1/2022 7:23
3/11/2021,Ranong,16,9646,194713,98257,96456,10718,10686,32,,,19/1/2022 7:23
3/11/2021,Rayong,105,42443,750813,368748,382065,449414,446915,2499,67,30,19/1/2022 7:23
3/11/2021,Ratchaburi,130,37268,868383,421933,446450,156792,156354,438,,,19/1/2022 7:23
3/11/2021,Roi Et,21,13649,1296246,642036,654210,29035,28998,37,,,19/1/2022 7:23
3/11/2021,Lop Buri,32,16700,739079,368209,370870,164681,164569,112,,,19/1/2022 7:23
3/11/2021,Lampang,15,2694,725197,353220,371977,91037,90339,698,55, ,19/1/2022 7:23
3/11/2021,Lamphun,33,2772,401266,192787,208479,66278,65498,780,,,19/1/2022 7:23
3/11/2021,Si Sa Ket,48,16583,1457748,725758,731990,51233,51233,0,,,19/1/2022 7:23
3/11/2021,Sakon Nakhon,9,7674,1146663,569782,576881,101215,101215,0,,,19/1/2022 7:23
3/11/2021,Songkhla,454,50215,1431562,697309,734253,24450,24434,16,48,22,19/1/2022 7:23
3/11/2021,Satun,135,5252,324802,161606,163196,53346,53307,39,27,23,19/1/2022 7:23
3/11/2021,Samut Prakarn,242,126208,1356374,645942,710432,65953,52911,13042,,,19/1/2022 7:23
3/11/2021,Samut Songkhram,27,11507,191049,91232,99817,103736,103736,0,49,34,19/1/2022 7:23
3/11/2021,Samut Sakhon,68,110376,586485,282611,303874,27110,27075,35,63,58,19/1/2022 7:23
3/11/2021,Saraburi,93,31128,643429,315725,327704,213646,213508,138,108,98,19/1/2022 7:23
3/11/2021,Sa kaeo,103,16968,561712,280407,281305,80293,79161,1132,40,25,19/1/2022 7:23
3/11/2021,Sing Buri,6,2957,204758,97261,107497,22448,22402,46,,,19/1/2022 7:23
3/11/2021,Suphan Buri,117,14759,835777,403176,432601,279513,279513,0,,,19/1/2022 7:23
3/11/2021,Surat Thani,183,19457,1072430,527357,545073,31940,27595,4345,44,24,19/1/2022 7:23
3/11/2021,Surin,269,17940,1376669,684750,691919,36906,36878,28,,,19/1/2022 7:23
3/11/2021,Sukhothai,9,6011,585572,283544,302028,59322,58638,684,,,19/1/2022 7:23
3/11/2021,Nong Khai,39,3868,516910,256357,260553,88413,88064,349,29,9,19/1/2022 7:23
3/11/2021,Nong Bua Lam Phu,12,4222,509096,253820,255276,9330,9305,25,,,19/1/2022 7:23
3/11/2021,Amnat Charoen,7,2933,376417,187215,189202,12411,12411,0,,,19/1/2022 7:23
3/11/2021,Udon Thani,88,22944,1566796,775703,791093,112923,112463,460,,,19/1/2022 7:23
3/11/2021,Uttaradit,13,4279,446358,217547,228811,51788,51679,109,,,19/1/2022 7:23
3/11/2021,Uthai Thani,6,3567,325208,158967,166241,33303,33303,0,,,19/1/2022 7:23
3/11/2021,Ubon Ratchathani,34,19929,1868052,932286,935766,119633,119591,42,39,26,19/1/2022 7:23
3/11/2021,Ang Thong,3,11224,275021,131590,143431,28564,28564,0,,,19/1/2022 7:23
3/11/2021,Chiang Rai,45,4555,1298579,631054,667525,266159,265473,686,29,13,19/1/2022 7:23
3/11/2021,Chiang Mai,322,21673,1788986,864222,924764,779417,775914,3503,55,30,19/1/2022 7:23
3/11/2021,Phetchaburi,77,22349,482577,232780,249797,479666,479543,123,,,19/1/2022 7:23
3/11/2021,Phetchabun,26,10983,978573,482421,496152,134305,133818,487,,,19/1/2022 7:23
3/11/2021,Loei,61,3808,638978,320126,318852,126076,125834,242,36,19,19/1/2022 7:23
3/11/2021,Phrae,8,1818,434895,209621,225274,51804,51653,151,47,22,19/1/2022 7:23
3/11/2021,Mae Hong Son,44,1644,285927,144863,141064,73223,71986,1237,23,6,19/1/2022 7:23
3/11/2021,,0,173,,,,,,,,,19/1/2022 7:23
4/11/2021,Krabi,92,8031,479290,238118,241172,49198,48852,346,,,19/1/2022 7:23
4/11/2021,Bangkok,872,431672,5530283,2593687,2936596,1294781,1215564,79217,67,34,19/1/2022 7:23
4/11/2021,Kanchanaburi,88,21853,893747,448009,445738,812418,812043,375,28,21,19/1/2022 7:23
4/11/2021,Kalasin,32,9164,975840,482246,493594,39828,39803,25,,,19/1/2022 7:23
4/11/2021,Kamphaeng Phet,6,7780,712340,351623,360717,40873,40710,163,,,19/1/2022 7:23
4/11/2021,Khon Kaen,248,21985,1791302,880185,911117,195487,195350,137,68,48,19/1/2022 7:23
4/11/2021,Chanthaburi,176,19643,536572,262310,274262,127398,127173,225,,,19/1/2022 7:23
4/11/2021,Chachoengsao,90,35472,724145,354876,369269,337607,337607,0,57,44,19/1/2022 7:23
4/11/2021,Chon Buri,280,105119,1583412,772344,811068,929255,920898,8357,57,44,19/1/2022 7:23
4/11/2021,Chai Nat,21,2528,320710,154147,166563,44850,44850,0,,,19/1/2022 7:23
4/11/2021,Chaiyaphum,21,11594,1122715,554712,568003,48905,48826,79,,,19/1/2022 7:23
4/11/2021,Chumphon,59,13050,509632,251576,258056,33159,33146,13,,,19/1/2022 7:23
4/11/2021,Trang,190,12250,639941,312807,327134,25842,25842,0,,,19/1/2022 7:23
4/11/2021,Trat,73,7679,228339,112907,115432,106763,104219,2544,,,19/1/2022 7:23
4/11/2021,Tak,129,22562,676105,341755,334350,65113,65113,0,,,19/1/2022 7:23
4/11/2021,Nakhon Nayok,20,11003,260391,128848,131543,170824,170788,36,,,19/1/2022 7:23
4/11/2021,Nakhon Pathom,46,34934,921946,442578,479368,116491,116387,104,81,40,19/1/2022 7:23
4/11/2021,Nakhon Phanom,2,4884,717181,357273,359908,60530,60511,19,,,19/1/2022 7:23
4/11/2021,Nakhon Ratchasima,63,29933,2634154,1293776,1340378,473887,472075,1812,71,41,19/1/2022 7:23
4/11/2021,Nakhon Si Thammarat,467,31869,1549258,764251,785007,22828,22804,24,,,19/1/2022 7:23
4/11/2021,Nakhon Sawan,93,15328,1035583,505021,530562,75335,75110,225,64,32,19/1/2022 7:23
4/11/2021,Nonthaburi,81,66020,1287480,598638,688842,91335,90985,350,53,56,19/1/2022 7:23
4/11/2021,Narathiwat,206,37900,809341,400380,408961,3051,3051,0,41,18,19/1/2022 7:23
4/11/2021,Nan,5,2448,475894,237970,237924,103582,102713,869,,,19/1/2022 7:23
4/11/2021,Bueng Kan,4,2022,422056,211601,210455,13820,13531,289,,,19/1/2022 7:23
4/11/2021,Buri Ram,19,16833,1580074,783823,796251,77399,76979,420,,,19/1/2022 7:23
4/11/2021,Pathum Thani,119,40860,1189186,563353,625833,80926,80630,296,64,38,19/1/2022 7:23
4/11/2021,Prachuap Khiri Khan,120,16569,553198,274111,279087,450266,449376,890,,,19/1/2022 7:23
4/11/2021,Prachin Buri,108,22774,494804,244188,250616,86770,86638,132,60,37,19/1/2022 7:23
4/11/2021,Pattani,451,39106,729331,360142,369189,4532,4532,0,,,19/1/2022 7:23
4/11/2021,Phra Nakhon Si Ayutthaya,81,30829,820637,394133,426504,389058,388198,860,68,52,19/1/2022 7:23
4/11/2021,Phayao,7,2106,464807,226101,238706,52329,51787,542,42,21,19/1/2022 7:23
4/11/2021,Phang-nga,87,4930,268121,133884,134237,57579,43267,14312,,,19/1/2022 7:23
4/11/2021,Phatthalung,143,9357,522562,254456,268106,19880,19880,0,,,19/1/2022 7:23
4/11/2021,Phichit,19,4873,529730,258152,271578,28128,28128,0,,,19/1/2022 7:23
4/11/2021,Phitsanulok,80,6230,847456,414644,432812,147550,147235,315,,,19/1/2022 7:23
4/11/2021,Phuket,53,15747,418939,198000,220939,158721,117533,41188,47,21,19/1/2022 7:23
4/11/2021,Maha Sarakham,10,10901,948760,465243,483517,22566,22530,36,,,19/1/2022 7:23
4/11/2021,Mukdahan,6,2316,351477,175634,175843,91851,91830,21,,,19/1/2022 7:23
4/11/2021,Yala,336,42287,542249,269916,272333,8303,8303,0,46,25,19/1/2022 7:23
4/11/2021,Yasothon,3,5831,533387,266000,267387,11956,11956,0,,,19/1/2022 7:23
4/11/2021,Ranong,7,9653,194713,98257,96456,10718,10686,32,,,19/1/2022 7:23
4/11/2021,Rayong,248,42691,750813,368748,382065,449414,446915,2499,67,29,19/1/2022 7:23
4/11/2021,Ratchaburi,160,37428,868383,421933,446450,156792,156354,438,,,19/1/2022 7:23
4/11/2021,Roi Et,23,13672,1296246,642036,654210,29035,28998,37,,,19/1/2022 7:23
4/11/2021,Lop Buri,42,16742,739079,368209,370870,164681,164569,112,,,19/1/2022 7:23
4/11/2021,Lampang,13,2707,725197,353220,371977,91037,90339,698,57, ,19/1/2022 7:23
4/11/2021,Lamphun,20,2792,401266,192787,208479,66278,65498,780,,,19/1/2022 7:23
4/11/2021,Si Sa Ket,44,16627,1457748,725758,731990,51233,51233,0,,,19/1/2022 7:23
4/11/2021,Sakon Nakhon,8,7682,1146663,569782,576881,101215,101215,0,,,19/1/2022 7:23
4/11/2021,Songkhla,507,50722,1431562,697309,734253,24450,24434,16,47,18,19/1/2022 7:23
4/11/2021,Satun,99,5351,324802,161606,163196,53346,53307,39,28,23,19/1/2022 7:23
4/11/2021,Samut Prakarn,222,126430,1356374,645942,710432,65953,52911,13042,,,19/1/2022 7:23
4/11/2021,Samut Songkhram,23,11530,191049,91232,99817,103736,103736,0,71,34,19/1/2022 7:23
4/11/2021,Samut Sakhon,60,110436,586485,282611,303874,27110,27075,35,91,55,19/1/2022 7:23
4/11/2021,Saraburi,94,31222,643429,315725,327704,213646,213508,138,109,94,19/1/2022 7:23
4/11/2021,Sa kaeo,112,17080,561712,280407,281305,80293,79161,1132,47,27,19/1/2022 7:23
4/11/2021,Sing Buri,11,2968,204758,97261,107497,22448,22402,46,,,19/1/2022 7:23
4/11/2021,Suphan Buri,101,14860,835777,403176,432601,279513,279513,0,,,19/1/2022 7:23
4/11/2021,Surat Thani,194,19651,1072430,527357,545073,31940,27595,4345,43,21,19/1/2022 7:23
4/11/2021,Surin,27,17967,1376669,684750,691919,36906,36878,28,,,19/1/2022 7:23
4/11/2021,Sukhothai,14,6025,585572,283544,302028,59322,58638,684,,,19/1/2022 7:23
4/11/2021,Nong Khai,44,3912,516910,256357,260553,88413,88064,349,23,7,19/1/2022 7:23
4/11/2021,Nong Bua Lam Phu,10,4232,509096,253820,255276,9330,9305,25,,,19/1/2022 7:23
4/11/2021,Amnat Charoen,2,2935,376417,187215,189202,12411,12411,0,,,19/1/2022 7:23
4/11/2021,Udon Thani,96,23040,1566796,775703,791093,112923,112463,460,,,19/1/2022 7:23
4/11/2021,Uttaradit,4,4283,446358,217547,228811,51788,51679,109,,,19/1/2022 7:23
4/11/2021,Uthai Thani,3,3570,325208,158967,166241,33303,33303,0,,,19/1/2022 7:23
4/11/2021,Ubon Ratchathani,29,19958,1868052,932286,935766,119633,119591,42,52,32,19/1/2022 7:23
4/11/2021,Ang Thong,13,11237,275021,131590,143431,28564,28564,0,,,19/1/2022 7:23
4/11/2021,Chiang Rai,38,4593,1298579,631054,667525,266159,265473,686,29,15,19/1/2022 7:23
4/11/2021,Chiang Mai,508,22181,1788986,864222,924764,779417,775914,3503,59,29,19/1/2022 7:23
4/11/2021,Phetchaburi,117,22466,482577,232780,249797,479666,479543,123,,,19/1/2022 7:23
4/11/2021,Phetchabun,20,11003,978573,482421,496152,134305,133818,487,,,19/1/2022 7:23
4/11/2021,Loei,36,3844,638978,320126,318852,126076,125834,242,42,18,19/1/2022 7:23
4/11/2021,Phrae,3,1821,434895,209621,225274,51804,51653,151,54,23,19/1/2022 7:23
4/11/2021,Mae Hong Son,22,1666,285927,144863,141064,73223,71986,1237,26,7,19/1/2022 7:23
4/11/2021,,0,173,,,,,,,,,19/1/2022 7:23
5/11/2021,Krabi,90,8121,479290,238118,241172,49198,48852,346,,,19/1/2022 7:23
5/11/2021,Bangkok,741,432413,5530283,2593687,2936596,1294781,1215564,79217,71,43,19/1/2022 7:23
5/11/2021,Kanchanaburi,94,21947,893747,448009,445738,812418,812043,375,37,27,19/1/2022 7:23
5/11/2021,Kalasin,11,9175,975840,482246,493594,39828,39803,25,,,19/1/2022 7:23
5/11/2021,Kamphaeng Phet,6,7786,712340,351623,360717,40873,40710,163,,,19/1/2022 7:23
5/11/2021,Khon Kaen,262,22247,1791302,880185,911117,195487,195350,137,79,51,19/1/2022 7:23
5/11/2021,Chanthaburi,159,19802,536572,262310,274262,127398,127173,225,,,19/1/2022 7:23
5/11/2021,Chachoengsao,89,35561,724145,354876,369269,337607,337607,0,62,37,19/1/2022 7:23
5/11/2021,Chon Buri,349,105468,1583412,772344,811068,929255,920898,8357,70,35,19/1/2022 7:23
5/11/2021,Chai Nat,19,2547,320710,154147,166563,44850,44850,0,,,19/1/2022 7:23
5/11/2021,Chaiyaphum,31,11625,1122715,554712,568003,48905,48826,79,,,19/1/2022 7:23
5/11/2021,Chumphon,82,13132,509632,251576,258056,33159,33146,13,,,19/1/2022 7:23
5/11/2021,Trang,205,12455,639941,312807,327134,25842,25842,0,,,19/1/2022 7:23
5/11/2021,Trat,44,7723,228339,112907,115432,106763,104219,2544,,,19/1/2022 7:23
5/11/2021,Tak,135,22697,676105,341755,334350,65113,65113,0,,,19/1/2022 7:23
5/11/2021,Nakhon Nayok,17,11020,260391,128848,131543,170824,170788,36,,,19/1/2022 7:23
5/11/2021,Nakhon Pathom,50,34984,921946,442578,479368,116491,116387,104,77,38,19/1/2022 7:23
5/11/2021,Nakhon Phanom,1,4885,717181,357273,359908,60530,60511,19,,,19/1/2022 7:23
5/11/2021,Nakhon Ratchasima,253,30186,2634154,1293776,1340378,473887,472075,1812,75,40,19/1/2022 7:23
5/11/2021,Nakhon Si Thammarat,294,32163,1549258,764251,785007,22828,22804,24,,,19/1/2022 7:23
5/11/2021,Nakhon Sawan,83,15411,1035583,505021,530562,75335,75110,225,63,37,19/1/2022 7:23
5/11/2021,Nonthaburi,100,66120,1287480,598638,688842,91335,90985,350,51,25,19/1/2022 7:23
5/11/2021,Narathiwat,213,38113,809341,400380,408961,3051,3051,0,40,14,19/1/2022 7:23
5/11/2021,Nan,15,2463,475894,237970,237924,103582,102713,869,,,19/1/2022 7:23
5/11/2021,Bueng Kan,27,2049,422056,211601,210455,13820,13531,289,,,19/1/2022 7:23
5/11/2021,Buri Ram,21,16854,1580074,783823,796251,77399,76979,420,,,19/1/2022 7:23
5/11/2021,Pathum Thani,43,40903,1189186,563353,625833,80926,80630,296,65,45,19/1/2022 7:23
5/11/2021,Prachuap Khiri Khan,94,16663,553198,274111,279087,450266,449376,890,,,19/1/2022 7:23
5/11/2021,Prachin Buri,191,22965,494804,244188,250616,86770,86638,132,63,45,19/1/2022 7:23
5/11/2021,Pattani,444,39550,729331,360142,369189,4532,4532,0,,,19/1/2022 7:23
5/11/2021,Phra Nakhon Si Ayutthaya,84,30913,820637,394133,426504,389058,388198,860,70,53,19/1/2022 7:23
5/11/2021,Phayao,8,2114,464807,226101,238706,52329,51787,542,53,24,19/1/2022 7:23
5/11/2021,Phang-nga,90,5020,268121,133884,134237,57579,43267,14312,,,19/1/2022 7:23
5/11/2021,Phatthalung,177,9534,522562,254456,268106,19880,19880,0,,,19/1/2022 7:23
5/11/2021,Phichit,25,4898,529730,258152,271578,28128,28128,0,,,19/1/2022 7:23
5/11/2021,Phitsanulok,108,6338,847456,414644,432812,147550,147235,315,,,19/1/2022 7:23
5/11/2021,Phuket,61,15808,418939,198000,220939,158721,117533,41188,35,19,19/1/2022 7:23
5/11/2021,Maha Sarakham,16,10917,948760,465243,483517,22566,22530,36,,,19/1/2022 7:23
5/11/2021,Mukdahan,11,2327,351477,175634,175843,91851,91830,21,,,19/1/2022 7:23
5/11/2021,Yala,375,42662,542249,269916,272333,8303,8303,0,44,21,19/1/2022 7:23
5/11/2021,Yasothon,6,5837,533387,266000,267387,11956,11956,0,,,19/1/2022 7:23
5/11/2021,Ranong,8,9661,194713,98257,96456,10718,10686,32,,,19/1/2022 7:23
5/11/2021,Rayong,144,42835,750813,368748,382065,449414,446915,2499,63,26,19/1/2022 7:23
5/11/2021,Ratchaburi,161,37589,868383,421933,446450,156792,156354,438,,,19/1/2022 7:23
5/11/2021,Roi Et,12,13684,1296246,642036,654210,29035,28998,37,,,19/1/2022 7:23
5/11/2021,Lop Buri,56,16798,739079,368209,370870,164681,164569,112,,,19/1/2022 7:23
5/11/2021,Lampang,8,2715,725197,353220,371977,91037,90339,698,61, ,19/1/2022 7:23
5/11/2021,Lamphun,21,2813,401266,192787,208479,66278,65498,780,,,19/1/2022 7:23
5/11/2021,Si Sa Ket,36,16663,1457748,725758,731990,51233,51233,0,,,19/1/2022 7:23
5/11/2021,Sakon Nakhon,8,7690,1146663,569782,576881,101215,101215,0,,,19/1/2022 7:23
5/11/2021,Songkhla,500,51222,1431562,697309,734253,24450,24434,16,38,31,19/1/2022 7:23
5/11/2021,Satun,101,5452,324802,161606,163196,53346,53307,39,26,25,19/1/2022 7:23
5/11/2021,Samut Prakarn,244,126674,1356374,645942,710432,65953,52911,13042,,,19/1/2022 7:23
5/11/2021,Samut Songkhram,17,11547,191049,91232,99817,103736,103736,0,72,28,19/1/2022 7:23
5/11/2021,Samut Sakhon,91,110527,586485,282611,303874,27110,27075,35,91,62,19/1/2022 7:23
5/11/2021,Saraburi,81,31303,643429,315725,327704,213646,213508,138,104,89,19/1/2022 7:23
5/11/2021,Sa kaeo,70,17150,561712,280407,281305,80293,79161,1132,50,22,19/1/2022 7:23
5/11/2021,Sing Buri,23,2991,204758,97261,107497,22448,22402,46,,,19/1/2022 7:23
5/11/2021,Suphan Buri,34,14894,835777,403176,432601,279513,279513,0,,,19/1/2022 7:23
5/11/2021,Surat Thani,176,19827,1072430,527357,545073,31940,27595,4345,38,20,19/1/2022 7:23
5/11/2021,Surin,256,18223,1376669,684750,691919,36906,36878,28,,,19/1/2022 7:23
5/11/2021,Sukhothai,15,6040,585572,283544,302028,59322,58638,684,,,19/1/2022 7:23
5/11/2021,Nong Khai,50,3962,516910,256357,260553,88413,88064,349,18,9,19/1/2022 7:23
5/11/2021,Nong Bua Lam Phu,15,4247,509096,253820,255276,9330,9305,25,,,19/1/2022 7:23
5/11/2021,Amnat Charoen,0,2935,376417,187215,189202,12411,12411,0,,,19/1/2022 7:23
5/11/2021,Udon Thani,102,23142,1566796,775703,791093,112923,112463,460,,,19/1/2022 7:23
5/11/2021,Uttaradit,4,4287,446358,217547,228811,51788,51679,109,,,19/1/2022 7:23
5/11/2021,Uthai Thani,0,3570,325208,158967,166241,33303,33303,0,,,19/1/2022 7:23
5/11/2021,Ubon Ratchathani,70,20028,1868052,932286,935766,119633,119591,42,57,30,19/1/2022 7:23
5/11/2021,Ang Thong,4,11241,275021,131590,143431,28564,28564,0,,,19/1/2022 7:23
5/11/2021,Chiang Rai,41,4634,1298579,631054,667525,266159,265473,686,35,16,19/1/2022 7:23
5/11/2021,Chiang Mai,413,22594,1788986,864222,924764,779417,775914,3503,61,30,19/1/2022 7:23
5/11/2021,Phetchaburi,98,22564,482577,232780,249797,479666,479543,123,,,19/1/2022 7:23
5/11/2021,Phetchabun,38,11041,978573,482421,496152,134305,133818,487,,,19/1/2022 7:23
5/11/2021,Loei,29,3873,638978,320126,318852,126076,125834,242,40,18,19/1/2022 7:23
5/11/2021,Phrae,3,1824,434895,209621,225274,51804,51653,151,58,25,19/1/2022 7:23
5/11/2021,Mae Hong Son,97,1763,285927,144863,141064,73223,71986,1237,26,13,19/1/2022 7:23
5/11/2021,,0,173,,,,,,,,,19/1/2022 7:23
6/11/2021,Krabi,94,8215,479290,238118,241172,49198,48852,346,,,19/1/2022 7:23
6/11/2021,Bangkok,923,433336,5530283,2593687,2936596,1294781,1215564,79217,81,31,19/1/2022 7:23
6/11/2021,Kanchanaburi,97,22044,893747,448009,445738,812418,812043,375,37,29,19/1/2022 7:23
6/11/2021,Kalasin,33,9208,975840,482246,493594,39828,39803,25,,,19/1/2022 7:23
6/11/2021,Kamphaeng Phet,9,7795,712340,351623,360717,40873,40710,163,,,19/1/2022 7:23
6/11/2021,Khon Kaen,427,22674,1791302,880185,911117,195487,195350,137,82,55,19/1/2022 7:23
6/11/2021,Chanthaburi,123,19925,536572,262310,274262,127398,127173,225,,,19/1/2022 7:23
6/11/2021,Chachoengsao,87,35648,724145,354876,369269,337607,337607,0,61,39,19/1/2022 7:23
6/11/2021,Chon Buri,294,105762,1583412,772344,811068,929255,920898,8357,62,37,19/1/2022 7:23
6/11/2021,Chai Nat,15,2562,320710,154147,166563,44850,44850,0,,,19/1/2022 7:23
6/11/2021,Chaiyaphum,21,11646,1122715,554712,568003,48905,48826,79,,,19/1/2022 7:23
6/11/2021,Chumphon,66,13198,509632,251576,258056,33159,33146,13,,,19/1/2022 7:23
6/11/2021,Trang,185,12640,639941,312807,327134,25842,25842,0,,,19/1/2022 7:23
6/11/2021,Trat,54,7777,228339,112907,115432,106763,104219,2544,,,19/1/2022 7:23
6/11/2021,Tak,124,22821,676105,341755,334350,65113,65113,0,,,19/1/2022 7:23
6/11/2021,Nakhon Nayok,18,11038,260391,128848,131543,170824,170788,36,,,19/1/2022 7:23
6/11/2021,Nakhon Pathom,34,35018,921946,442578,479368,116491,116387,104,78,43,19/1/2022 7:23
6/11/2021,Nakhon Phanom,3,4888,717181,357273,359908,60530,60511,19,,,19/1/2022 7:23
6/11/2021,Nakhon Ratchasima,487,30673,2634154,1293776,1340378,473887,472075,1812,77,29,19/1/2022 7:23
6/11/2021,Nakhon Si Thammarat,504,32667,1549258,764251,785007,22828,22804,24,,,19/1/2022 7:23
6/11/2021,Nakhon Sawan,87,15498,1035583,505021,530562,75335,75110,225,71,41,19/1/2022 7:23
6/11/2021,Nonthaburi,110,66230,1287480,598638,688842,91335,90985,350,78,14,19/1/2022 7:23
6/11/2021,Narathiwat,218,38331,809341,400380,408961,3051,3051,0,31,19,19/1/2022 7:23
6/11/2021,Nan,2,2465,475894,237970,237924,103582,102713,869,,,19/1/2022 7:23
6/11/2021,Bueng Kan,9,2058,422056,211601,210455,13820,13531,289,,,19/1/2022 7:23
6/11/2021,Buri Ram,73,16927,1580074,783823,796251,77399,76979,420,,,19/1/2022 7:23
6/11/2021,Pathum Thani,68,40971,1189186,563353,625833,80926,80630,296,83,30,19/1/2022 7:23
6/11/2021,Prachuap Khiri Khan,82,16745,553198,274111,279087,450266,449376,890,,,19/1/2022 7:23
6/11/2021,Prachin Buri,137,23102,494804,244188,250616,86770,86638,132,77,34,19/1/2022 7:23
6/11/2021,Pattani,437,39987,729331,360142,369189,4532,4532,0,,,19/1/2022 7:23
6/11/2021,Phra Nakhon Si Ayutthaya,98,31011,820637,394133,426504,389058,388198,860,77,43,19/1/2022 7:23
6/11/2021,Phayao,7,2121,464807,226101,238706,52329,51787,542,57,22,19/1/2022 7:23
6/11/2021,Phang-nga,90,5110,268121,133884,134237,57579,43267,14312,,,19/1/2022 7:23
6/11/2021,Phatthalung,116,9650,522562,254456,268106,19880,19880,0,,,19/1/2022 7:23
6/11/2021,Phichit,28,4926,529730,258152,271578,28128,28128,0,,,19/1/2022 7:23
6/11/2021,Phitsanulok,81,6419,847456,414644,432812,147550,147235,315,,,19/1/2022 7:23
6/11/2021,Phuket,65,15873,418939,198000,220939,158721,117533,41188,30,21,19/1/2022 7:23
6/11/2021,Maha Sarakham,27,10944,948760,465243,483517,22566,22530,36,,,19/1/2022 7:23
6/11/2021,Mukdahan,15,2342,351477,175634,175843,91851,91830,21,,,19/1/2022 7:23
6/11/2021,Yala,321,42983,542249,269916,272333,8303,8303,0,39,18,19/1/2022 7:23
6/11/2021,Yasothon,2,5839,533387,266000,267387,11956,11956,0,,,19/1/2022 7:23
6/11/2021,Ranong,9,9670,194713,98257,96456,10718,10686,32,,,19/1/2022 7:23
6/11/2021,Rayong,149,42984,750813,368748,382065,449414,446915,2499,61,32,19/1/2022 7:23
6/11/2021,Ratchaburi,170,37759,868383,421933,446450,156792,156354,438,,,19/1/2022 7:23
6/11/2021,Roi Et,14,13698,1296246,642036,654210,29035,28998,37,,,19/1/2022 7:23
6/11/2021,Lop Buri,53,16851,739079,368209,370870,164681,164569,112,,,19/1/2022 7:23
6/11/2021,Lampang,25,2740,725197,353220,371977,91037,90339,698,63, ,19/1/2022 7:23
6/11/2021,Lamphun,10,2823,401266,192787,208479,66278,65498,780,,,19/1/2022 7:23
6/11/2021,Si Sa Ket,21,16684,1457748,725758,731990,51233,51233,0,,,19/1/2022 7:23
6/11/2021,Sakon Nakhon,18,7708,1146663,569782,576881,101215,101215,0,,,19/1/2022 7:23
6/11/2021,Songkhla,464,51686,1431562,697309,734253,24450,24434,16,72,20,19/1/2022 7:23
6/11/2021,Satun,97,5549,324802,161606,163196,53346,53307,39,28,25,19/1/2022 7:23
6/11/2021,Samut Prakarn,198,126872,1356374,645942,710432,65953,52911,13042,,,19/1/2022 7:23
6/11/2021,Samut Songkhram,31,11578,191049,91232,99817,103736,103736,0,63,25,19/1/2022 7:23
6/11/2021,Samut Sakhon,48,110575,586485,282611,303874,27110,27075,35,98,52,19/1/2022 7:23
6/11/2021,Saraburi,84,31387,643429,315725,327704,213646,213508,138,121,87,19/1/2022 7:23
6/11/2021,Sa kaeo,99,17249,561712,280407,281305,80293,79161,1132,44,26,19/1/2022 7:23
6/11/2021,Sing Buri,15,3006,204758,97261,107497,22448,22402,46,,,19/1/2022 7:23
6/11/2021,Suphan Buri,35,14929,835777,403176,432601,279513,279513,0,,,19/1/2022 7:23
6/11/2021,Surat Thani,152,19979,1072430,527357,545073,31940,27595,4345,34,18,19/1/2022 7:23
6/11/2021,Surin,32,18255,1376669,684750,691919,36906,36878,28,,,19/1/2022 7:23
6/11/2021,Sukhothai,18,6058,585572,283544,302028,59322,58638,684,,,19/1/2022 7:23
6/11/2021,Nong Khai,33,3995,516910,256357,260553,88413,88064,349,21,9,19/1/2022 7:23
6/11/2021,Nong Bua Lam Phu,0,4247,509096,253820,255276,9330,9305,25,,,19/1/2022 7:23
6/11/2021,Amnat Charoen,4,2939,376417,187215,189202,12411,12411,0,,,19/1/2022 7:23
6/11/2021,Udon Thani,133,23275,1566796,775703,791093,112923,112463,460,,,19/1/2022 7:23
6/11/2021,Uttaradit,8,4295,446358,217547,228811,51788,51679,109,,,19/1/2022 7:23
6/11/2021,Uthai Thani,3,3573,325208,158967,166241,33303,33303,0,,,19/1/2022 7:23
6/11/2021,Ubon Ratchathani,71,20099,1868052,932286,935766,119633,119591,42,62,27,19/1/2022 7:23
6/11/2021,Ang Thong,11,11252,275021,131590,143431,28564,28564,0,,,19/1/2022 7:23
6/11/2021,Chiang Rai,49,4683,1298579,631054,667525,266159,265473,686,41,14,19/1/2022 7:23
6/11/2021,Chiang Mai,504,23098,1788986,864222,924764,779417,775914,3503,63,29,19/1/2022 7:23
6/11/2021,Phetchaburi,85,22649,482577,232780,249797,479666,479543,123,,,19/1/2022 7:23
6/11/2021,Phetchabun,74,11115,978573,482421,496152,134305,133818,487,,,19/1/2022 7:23
6/11/2021,Loei,31,3904,638978,320126,318852,126076,125834,242,39,20,19/1/2022 7:23
6/11/2021,Phrae,8,1832,434895,209621,225274,51804,51653,151,60,25,19/1/2022 7:23
6/11/2021,Mae Hong Son,40,1803,285927,144863,141064,73223,71986,1237,44,11,19/1/2022 7:23
6/11/2021,,0,173,,,,,,,,,19/1/2022 7:23
7/11/2021,Krabi,90,8305,479290,238118,241172,49198,48852,346,,,19/1/2022 7:23
7/11/2021,Bangkok,765,434101,5530283,2593687,2936596,1294781,1215564,79217,72,39,19/1/2022 7:23
7/11/2021,Kanchanaburi,99,22143,893747,448009,445738,812418,812043,375,36,25,19/1/2022 7:23
7/11/2021,Kalasin,25,9233,975840,482246,493594,39828,39803,25,,,19/1/2022 7:23
7/11/2021,Kamphaeng Phet,14,7809,712340,351623,360717,40873,40710,163,,,19/1/2022 7:23
7/11/2021,Khon Kaen,142,22816,1791302,880185,911117,195487,195350,137,99,45,19/1/2022 7:23
7/11/2021,Chanthaburi,157,20082,536572,262310,274262,127398,127173,225,,,19/1/2022 7:23
7/11/2021,Chachoengsao,108,35756,724145,354876,369269,337607,337607,0,52,33,19/1/2022 7:23
7/11/2021,Chon Buri,252,106014,1583412,772344,811068,929255,920898,8357,71,26,19/1/2022 7:23
7/11/2021,Chai Nat,8,2570,320710,154147,166563,44850,44850,0,,,19/1/2022 7:23
7/11/2021,Chaiyaphum,31,11677,1122715,554712,568003,48905,48826,79,,,19/1/2022 7:23
7/11/2021,Chumphon,67,13265,509632,251576,258056,33159,33146,13,,,19/1/2022 7:23
7/11/2021,Trang,169,12809,639941,312807,327134,25842,25842,0,,,19/1/2022 7:23
7/11/2021,Trat,38,7815,228339,112907,115432,106763,104219,2544,,,19/1/2022 7:23
7/11/2021,Tak,125,22946,676105,341755,334350,65113,65113,0,,,19/1/2022 7:23
7/11/2021,Nakhon Nayok,30,11068,260391,128848,131543,170824,170788,36,,,19/1/2022 7:23
7/11/2021,Nakhon Pathom,30,35048,921946,442578,479368,116491,116387,104,79,38,19/1/2022 7:23
7/11/2021,Nakhon Phanom,21,4909,717181,357273,359908,60530,60511,19,,,19/1/2022 7:23
7/11/2021,Nakhon Ratchasima,422,31095,2634154,1293776,1340378,473887,472075,1812,63,28,19/1/2022 7:23
7/11/2021,Nakhon Si Thammarat,392,33059,1549258,764251,785007,22828,22804,24,,,19/1/2022 7:23
7/11/2021,Nakhon Sawan,81,15579,1035583,505021,530562,75335,75110,225,79,30,19/1/2022 7:23
7/11/2021,Nonthaburi,110,66340,1287480,598638,688842,91335,90985,350,44,16,19/1/2022 7:23
7/11/2021,Narathiwat,348,38679,809341,400380,408961,3051,3051,0,40,21,19/1/2022 7:23
7/11/2021,Nan,3,2468,475894,237970,237924,103582,102713,869,,,19/1/2022 7:23
7/11/2021,Bueng Kan,13,2071,422056,211601,210455,13820,13531,289,,,19/1/2022 7:23
7/11/2021,Buri Ram,23,16950,1580074,783823,796251,77399,76979,420,,,19/1/2022 7:23
7/11/2021,Pathum Thani,82,41053,1189186,563353,625833,80926,80630,296,58,36,19/1/2022 7:23
7/11/2021,Prachuap Khiri Khan,207,16952,553198,274111,279087,450266,449376,890,,,19/1/2022 7:23
7/11/2021,Prachin Buri,106,23208,494804,244188,250616,86770,86638,132,61,36,19/1/2022 7:23
7/11/2021,Pattani,409,40396,729331,360142,369189,4532,4532,0,,,19/1/2022 7:23
7/11/2021,Phra Nakhon Si Ayutthaya,113,31124,820637,394133,426504,389058,388198,860,49,53,19/1/2022 7:23
7/11/2021,Phayao,4,2125,464807,226101,238706,52329,51787,542,50,29,19/1/2022 7:23
7/11/2021,Phang-nga,60,5170,268121,133884,134237,57579,43267,14312,,,19/1/2022 7:23
7/11/2021,Phatthalung,150,9800,522562,254456,268106,19880,19880,0,,,19/1/2022 7:23
7/11/2021,Phichit,23,4949,529730,258152,271578,28128,28128,0,,,19/1/2022 7:23
7/11/2021,Phitsanulok,93,6512,847456,414644,432812,147550,147235,315,,,19/1/2022 7:23
7/11/2021,Phuket,56,15929,418939,198000,220939,158721,117533,41188,33,20,19/1/2022 7:23
7/11/2021,Maha Sarakham,19,10963,948760,465243,483517,22566,22530,36,,,19/1/2022 7:23
7/11/2021,Mukdahan,5,2347,351477,175634,175843,91851,91830,21,,,19/1/2022 7:23
7/11/2021,Yala,344,43327,542249,269916,272333,8303,8303,0,33,26,19/1/2022 7:23
7/11/2021,Yasothon,1,5840,533387,266000,267387,11956,11956,0,,,19/1/2022 7:23
7/11/2021,Ranong,8,9678,194713,98257,96456,10718,10686,32,,,19/1/2022 7:23
7/11/2021,Rayong,167,43151,750813,368748,382065,449414,446915,2499,76,24,19/1/2022 7:23
7/11/2021,Ratchaburi,194,37953,868383,421933,446450,156792,156354,438,,,19/1/2022 7:23
7/11/2021,Roi Et,17,13715,1296246,642036,654210,29035,28998,37,,,19/1/2022 7:23
7/11/2021,Lop Buri,71,16922,739079,368209,370870,164681,164569,112,,,19/1/2022 7:23
7/11/2021,Lampang,32,2772,725197,353220,371977,91037,90339,698,74, ,19/1/2022 7:23
7/11/2021,Lamphun,13,2836,401266,192787,208479,66278,65498,780,,,19/1/2022 7:23
7/11/2021,Si Sa Ket,27,16711,1457748,725758,731990,51233,51233,0,,,19/1/2022 7:23
7/11/2021,Sakon Nakhon,12,7720,1146663,569782,576881,101215,101215,0,,,19/1/2022 7:23
7/11/2021,Songkhla,418,52104,1431562,697309,734253,24450,24434,16,40,25,19/1/2022 7:23
7/11/2021,Satun,96,5645,324802,161606,163196,53346,53307,39,34,26,19/1/2022 7:23
7/11/2021,Samut Prakarn,219,127091,1356374,645942,710432,65953,52911,13042,,,19/1/2022 7:23
7/11/2021,Samut Songkhram,22,11600,191049,91232,99817,103736,103736,0,62,30,19/1/2022 7:23
7/11/2021,Samut Sakhon,53,110628,586485,282611,303874,27110,27075,35,93,42,19/1/2022 7:23
7/11/2021,Saraburi,79,31466,643429,315725,327704,213646,213508,138,105,70,19/1/2022 7:23
7/11/2021,Sa kaeo,108,17357,561712,280407,281305,80293,79161,1132,45,18,19/1/2022 7:23
7/11/2021,Sing Buri,10,3016,204758,97261,107497,22448,22402,46,,,19/1/2022 7:23
7/11/2021,Suphan Buri,48,14977,835777,403176,432601,279513,279513,0,,,19/1/2022 7:23
7/11/2021,Surat Thani,147,20126,1072430,527357,545073,31940,27595,4345,32,17,19/1/2022 7:23
7/11/2021,Surin,29,18284,1376669,684750,691919,36906,36878,28,,,19/1/2022 7:23
7/11/2021,Sukhothai,17,6075,585572,283544,302028,59322,58638,684,,,19/1/2022 7:23
7/11/2021,Nong Khai,33,4028,516910,256357,260553,88413,88064,349,21,8,19/1/2022 7:23
7/11/2021,Nong Bua Lam Phu,15,4262,509096,253820,255276,9330,9305,25,,,19/1/2022 7:23
7/11/2021,Amnat Charoen,7,2946,376417,187215,189202,12411,12411,0,,,19/1/2022 7:23
7/11/2021,Udon Thani,57,23332,1566796,775703,791093,112923,112463,460,,,19/1/2022 7:23
7/11/2021,Uttaradit,17,4312,446358,217547,228811,51788,51679,109,,,19/1/2022 7:23
7/11/2021,Uthai Thani,1,3574,325208,158967,166241,33303,33303,0,,,19/1/2022 7:23
7/11/2021,Ubon Ratchathani,76,20175,1868052,932286,935766,119633,119591,42,60,26,19/1/2022 7:23
7/11/2021,Ang Thong,29,11281,275021,131590,143431,28564,28564,0,,,19/1/2022 7:23
7/11/2021,Chiang Rai,25,4708,1298579,631054,667525,266159,265473,686,41,19,19/1/2022 7:23
7/11/2021,Chiang Mai,482,23580,1788986,864222,924764,779417,775914,3503,64,35,19/1/2022 7:23
7/11/2021,Phetchaburi,99,22748,482577,232780,249797,479666,479543,123,,,19/1/2022 7:23
7/11/2021,Phetchabun,19,11134,978573,482421,496152,134305,133818,487,,,19/1/2022 7:23
7/11/2021,Loei,31,3935,638978,320126,318852,126076,125834,242,43,21,19/1/2022 7:23
7/11/2021,Phrae,6,1838,434895,209621,225274,51804,51653,151,66,25,19/1/2022 7:23
7/11/2021,Mae Hong Son,41,1844,285927,144863,141064,73223,71986,1237,43,17,19/1/2022 7:23
7/11/2021,,0,173,,,,,,,,,19/1/2022 7:23
8/11/2021,Krabi,89,8394,479290,238118,241172,49198,48852,346,,,19/1/2022 7:23
8/11/2021,Bangkok,879,434980,5530283,2593687,2936596,1294781,1215564,79217,71,35,19/1/2022 7:23
8/11/2021,Kanchanaburi,95,22238,893747,448009,445738,812418,812043,375,31,23,19/1/2022 7:23
8/11/2021,Kalasin,31,9264,975840,482246,493594,39828,39803,25,,,19/1/2022 7:23
8/11/2021,Kamphaeng Phet,12,7821,712340,351623,360717,40873,40710,163,,,19/1/2022 7:23
8/11/2021,Khon Kaen,175,22991,1791302,880185,911117,195487,195350,137,65,33,19/1/2022 7:23
8/11/2021,Chanthaburi,88,20170,536572,262310,274262,127398,127173,225,,,19/1/2022 7:23
8/11/2021,Chachoengsao,50,35806,724145,354876,369269,337607,337607,0,50,32,19/1/2022 7:23
8/11/2021,Chon Buri,180,106194,1583412,772344,811068,929255,920898,8357,59,23,19/1/2022 7:23
8/11/2021,Chai Nat,4,2574,320710,154147,166563,44850,44850,0,,,19/1/2022 7:23
8/11/2021,Chaiyaphum,30,11707,1122715,554712,568003,48905,48826,79,,,19/1/2022 7:23
8/11/2021,Chumphon,60,13325,509632,251576,258056,33159,33146,13,,,19/1/2022 7:23
8/11/2021,Trang,166,12975,639941,312807,327134,25842,25842,0,,,19/1/2022 7:23
8/11/2021,Trat,24,7839,228339,112907,115432,106763,104219,2544,,,19/1/2022 7:23
8/11/2021,Tak,95,23041,676105,341755,334350,65113,65113,0,,,19/1/2022 7:23
8/11/2021,Nakhon Nayok,8,11076,260391,128848,131543,170824,170788,36,,,19/1/2022 7:23
8/11/2021,Nakhon Pathom,40,35088,921946,442578,479368,116491,116387,104,69,39,19/1/2022 7:23
8/11/2021,Nakhon Phanom,10,4919,717181,357273,359908,60530,60511,19,,,19/1/2022 7:23
8/11/2021,Nakhon Ratchasima,733,31828,2634154,1293776,1340378,473887,472075,1812,61,22,19/1/2022 7:23
8/11/2021,Nakhon Si Thammarat,373,33432,1549258,764251,785007,22828,22804,24,,,19/1/2022 7:23
8/11/2021,Nakhon Sawan,61,15640,1035583,505021,530562,75335,75110,225,59,27,19/1/2022 7:23
8/11/2021,Nonthaburi,104,66444,1287480,598638,688842,91335,90985,350,66,14,19/1/2022 7:23
8/11/2021,Narathiwat,295,38974,809341,400380,408961,3051,3051,0,45,21,19/1/2022 7:23
8/11/2021,Nan,7,2475,475894,237970,237924,103582,102713,869,,,19/1/2022 7:23
8/11/2021,Bueng Kan,0,2071,422056,211601,210455,13820,13531,289,,,19/1/2022 7:23
8/11/2021,Buri Ram,19,16969,1580074,783823,796251,77399,76979,420,,,19/1/2022 7:23
8/11/2021,Pathum Thani,43,41096,1189186,563353,625833,80926,80630,296,60,28,19/1/2022 7:23
8/11/2021,Prachuap Khiri Khan,123,17075,553198,274111,279087,450266,449376,890,,,19/1/2022 7:23
8/11/2021,Prachin Buri,102,23310,494804,244188,250616,86770,86638,132,63,30,19/1/2022 7:23
8/11/2021,Pattani,406,40802,729331,360142,369189,4532,4532,0,,,19/1/2022 7:23
8/11/2021,Phra Nakhon Si Ayutthaya,75,31199,820637,394133,426504,389058,388198,860,54,50,19/1/2022 7:23
8/11/2021,Phayao,7,2132,464807,226101,238706,52329,51787,542,60,24,19/1/2022 7:23
8/11/2021,Phang-nga,36,5206,268121,133884,134237,57579,43267,14312,,,19/1/2022 7:23
8/11/2021,Phatthalung,130,9930,522562,254456,268106,19880,19880,0,,,19/1/2022 7:23
8/11/2021,Phichit,23,4972,529730,258152,271578,28128,28128,0,,,19/1/2022 7:23
8/11/2021,Phitsanulok,80,6592,847456,414644,432812,147550,147235,315,,,19/1/2022 7:23
8/11/2021,Phuket,49,15978,418939,198000,220939,158721,117533,41188,30,23,19/1/2022 7:23
8/11/2021,Maha Sarakham,10,10973,948760,465243,483517,22566,22530,36,,,19/1/2022 7:23
8/11/2021,Mukdahan,5,2352,351477,175634,175843,91851,91830,21,,,19/1/2022 7:23
8/11/2021,Yala,269,43596,542249,269916,272333,8303,8303,0,45,24,19/1/2022 7:23
8/11/2021,Yasothon,24,5864,533387,266000,267387,11956,11956,0,,,19/1/2022 7:23
8/11/2021,Ranong,11,9689,194713,98257,96456,10718,10686,32,,,19/1/2022 7:23
8/11/2021,Rayong,135,43286,750813,368748,382065,449414,446915,2499,59,17,19/1/2022 7:23
8/11/2021,Ratchaburi,140,38093,868383,421933,446450,156792,156354,438,,,19/1/2022 7:23
8/11/2021,Roi Et,32,13747,1296246,642036,654210,29035,28998,37,,,19/1/2022 7:23
8/11/2021,Lop Buri,63,16985,739079,368209,370870,164681,164569,112,,,19/1/2022 7:23
8/11/2021,Lampang,10,2782,725197,353220,371977,91037,90339,698,81, ,19/1/2022 7:23
8/11/2021,Lamphun,19,2855,401266,192787,208479,66278,65498,780,,,19/1/2022 7:23
8/11/2021,Si Sa Ket,23,16734,1457748,725758,731990,51233,51233,0,,,19/1/2022 7:23
8/11/2021,Sakon Nakhon,2,7722,1146663,569782,576881,101215,101215,0,,,19/1/2022 7:23
8/11/2021,Songkhla,463,52567,1431562,697309,734253,24450,24434,16,51,21,19/1/2022 7:23
8/11/2021,Satun,95,5740,324802,161606,163196,53346,53307,39,31,24,19/1/2022 7:23
8/11/2021,Samut Prakarn,220,127311,1356374,645942,710432,65953,52911,13042,,,19/1/2022 7:23
8/11/2021,Samut Songkhram,13,11613,191049,91232,99817,103736,103736,0,69,23,19/1/2022 7:23
8/11/2021,Samut Sakhon,26,110654,586485,282611,303874,27110,27075,35,67,32,19/1/2022 7:23
8/11/2021,Saraburi,76,31542,643429,315725,327704,213646,213508,138,72,61,19/1/2022 7:23
8/11/2021,Sa kaeo,37,17394,561712,280407,281305,80293,79161,1132,37,15,19/1/2022 7:23
8/11/2021,Sing Buri,11,3027,204758,97261,107497,22448,22402,46,,,19/1/2022 7:23
8/11/2021,Suphan Buri,113,15090,835777,403176,432601,279513,279513,0,,,19/1/2022 7:23
8/11/2021,Surat Thani,179,20305,1072430,527357,545073,31940,27595,4345,45,22,19/1/2022 7:23
8/11/2021,Surin,34,18318,1376669,684750,691919,36906,36878,28,,,19/1/2022 7:23
8/11/2021,Sukhothai,18,6093,585572,283544,302028,59322,58638,684,,,19/1/2022 7:23
8/11/2021,Nong Khai,27,4055,516910,256357,260553,88413,88064,349,19, ,19/1/2022 7:23
8/11/2021,Nong Bua Lam Phu,27,4289,509096,253820,255276,9330,9305,25,,,19/1/2022 7:23
8/11/2021,Amnat Charoen,7,2953,376417,187215,189202,12411,12411,0,,,19/1/2022 7:23
8/11/2021,Udon Thani,85,23417,1566796,775703,791093,112923,112463,460,,,19/1/2022 7:23
8/11/2021,Uttaradit,5,4317,446358,217547,228811,51788,51679,109,,,19/1/2022 7:23
8/11/2021,Uthai Thani,3,3577,325208,158967,166241,33303,33303,0,,,19/1/2022 7:23
8/11/2021,Ubon Ratchathani,96,20271,1868052,932286,935766,119633,119591,42,35,21,19/1/2022 7:23
8/11/2021,Ang Thong,17,11298,275021,131590,143431,28564,28564,0,,,19/1/2022 7:23
8/11/2021,Chiang Rai,23,4731,1298579,631054,667525,266159,265473,686,52,25,19/1/2022 7:23
8/11/2021,Chiang Mai,429,24009,1788986,864222,924764,779417,775914,3503,66,34,19/1/2022 7:23
8/11/2021,Phetchaburi,88,22836,482577,232780,249797,479666,479543,123,,,19/1/2022 7:23
8/11/2021,Phetchabun,18,11152,978573,482421,496152,134305,133818,487,,,19/1/2022 7:23
8/11/2021,Loei,24,3959,638978,320126,318852,126076,125834,242,46,16,19/1/2022 7:23
8/11/2021,Phrae,1,1839,434895,209621,225274,51804,51653,151,63,23,19/1/2022 7:23
8/11/2021,Mae Hong Son,12,1856,285927,144863,141064,73223,71986,1237,62,14,19/1/2022 7:23
8/11/2021,,0,173,,,,,,,,,19/1/2022 7:23
9/11/2021,Krabi,93,8487,479290,238118,241172,49198,48852,346,,,19/1/2022 7:23
9/11/2021,Bangkok,829,435809,5530283,2593687,2936596,1294781,1215564,79217,61,39,19/1/2022 7:23
9/11/2021,Kanchanaburi,99,22337,893747,448009,445738,812418,812043,375,28,19,19/1/2022 7:23
9/11/2021,Kalasin,32,9296,975840,482246,493594,39828,39803,25,,,19/1/2022 7:23
9/11/2021,Kamphaeng Phet,1,7822,712340,351623,360717,40873,40710,163,,,19/1/2022 7:23
9/11/2021,Khon Kaen,206,23197,1791302,880185,911117,195487,195350,137,56,43,19/1/2022 7:23
9/11/2021,Chanthaburi,117,20287,536572,262310,274262,127398,127173,225,,,19/1/2022 7:23
9/11/2021,Chachoengsao,61,35867,724145,354876,369269,337607,337607,0,41,33,19/1/2022 7:23
9/11/2021,Chon Buri,195,106389,1583412,772344,811068,929255,920898,8357,47,28,19/1/2022 7:23
9/11/2021,Chai Nat,10,2584,320710,154147,166563,44850,44850,0,,,19/1/2022 7:23
9/11/2021,Chaiyaphum,12,11719,1122715,554712,568003,48905,48826,79,,,19/1/2022 7:23
9/11/2021,Chumphon,48,13373,509632,251576,258056,33159,33146,13,,,19/1/2022 7:23
9/11/2021,Trang,171,13146,639941,312807,327134,25842,25842,0,,,19/1/2022 7:23
9/11/2021,Trat,13,7852,228339,112907,115432,106763,104219,2544,,,19/1/2022 7:23
9/11/2021,Tak,57,23098,676105,341755,334350,65113,65113,0,,,19/1/2022 7:23
9/11/2021,Nakhon Nayok,5,11081,260391,128848,131543,170824,170788,36,,,19/1/2022 7:23
9/11/2021,Nakhon Pathom,25,35113,921946,442578,479368,116491,116387,104,75,27,19/1/2022 7:23
9/11/2021,Nakhon Phanom,6,4925,717181,357273,359908,60530,60511,19,,,19/1/2022 7:23
9/11/2021,Nakhon Ratchasima,303,32131,2634154,1293776,1340378,473887,472075,1812,44,31,19/1/2022 7:23
9/11/2021,Nakhon Si Thammarat,320,33752,1549258,764251,785007,22828,22804,24,,,19/1/2022 7:23
9/11/2021,Nakhon Sawan,95,15735,1035583,505021,530562,75335,75110,225,54,32,19/1/2022 7:23
9/11/2021,Nonthaburi,90,66534,1287480,598638,688842,91335,90985,350,40,15,19/1/2022 7:23
9/11/2021,Narathiwat,223,39197,809341,400380,408961,3051,3051,0,44,11,19/1/2022 7:23
9/11/2021,Nan,18,2493,475894,237970,237924,103582,102713,869,,,19/1/2022 7:23
9/11/2021,Bueng Kan,27,2098,422056,211601,210455,13820,13531,289,,,19/1/2022 7:23
9/11/2021,Buri Ram,20,16989,1580074,783823,796251,77399,76979,420,,,19/1/2022 7:23
9/11/2021,Pathum Thani,59,41155,1189186,563353,625833,80926,80630,296,46,32,19/1/2022 7:23
9/11/2021,Prachuap Khiri Khan,92,17167,553198,274111,279087,450266,449376,890,,,19/1/2022 7:23
9/11/2021,Prachin Buri,89,23399,494804,244188,250616,86770,86638,132,48,35,19/1/2022 7:23
9/11/2021,Pattani,380,41182,729331,360142,369189,4532,4532,0,,,19/1/2022 7:23
9/11/2021,Phra Nakhon Si Ayutthaya,54,31253,820637,394133,426504,389058,388198,860,39,85,19/1/2022 7:23
9/11/2021,Phayao,8,2140,464807,226101,238706,52329,51787,542,46,22,19/1/2022 7:23
9/11/2021,Phang-nga,74,5280,268121,133884,134237,57579,43267,14312,,,19/1/2022 7:23
9/11/2021,Phatthalung,161,10091,522562,254456,268106,19880,19880,0,,,19/1/2022 7:23
9/11/2021,Phichit,11,4983,529730,258152,271578,28128,28128,0,,,19/1/2022 7:23
9/11/2021,Phitsanulok,80,6672,847456,414644,432812,147550,147235,315,,,19/1/2022 7:23
9/11/2021,Phuket,50,16028,418939,198000,220939,158721,117533,41188,38,26,19/1/2022 7:23
9/11/2021,Maha Sarakham,0,10973,948760,465243,483517,22566,22530,36,,,19/1/2022 7:23
9/11/2021,Mukdahan,12,2364,351477,175634,175843,91851,91830,21,,,19/1/2022 7:23
9/11/2021,Yala,143,43739,542249,269916,272333,8303,8303,0,43,20,19/1/2022 7:23
9/11/2021,Yasothon,2,5866,533387,266000,267387,11956,11956,0,,,19/1/2022 7:23
9/11/2021,Ranong,8,9697,194713,98257,96456,10718,10686,32,,,19/1/2022 7:23
9/11/2021,Rayong,104,43390,750813,368748,382065,449414,446915,2499,43,20,19/1/2022 7:23
9/11/2021,Ratchaburi,105,38198,868383,421933,446450,156792,156354,438,,,19/1/2022 7:23
9/11/2021,Roi Et,31,13778,1296246,642036,654210,29035,28998,37,,,19/1/2022 7:23
9/11/2021,Lop Buri,34,17019,739079,368209,370870,164681,164569,112,,,19/1/2022 7:23
9/11/2021,Lampang,11,2793,725197,353220,371977,91037,90339,698,73, ,19/1/2022 7:23
9/11/2021,Lamphun,18,2873,401266,192787,208479,66278,65498,780,,,19/1/2022 7:23
9/11/2021,Si Sa Ket,30,16764,1457748,725758,731990,51233,51233,0,,,19/1/2022 7:23
9/11/2021,Sakon Nakhon,5,7727,1146663,569782,576881,101215,101215,0,,,19/1/2022 7:23
9/11/2021,Songkhla,493,53060,1431562,697309,734253,24450,24434,16,39,20,19/1/2022 7:23
9/11/2021,Satun,96,5836,324802,161606,163196,53346,53307,39,31,20,19/1/2022 7:23
9/11/2021,Samut Prakarn,200,127511,1356374,645942,710432,65953,52911,13042,,,19/1/2022 7:23
9/11/2021,Samut Songkhram,17,11630,191049,91232,99817,103736,103736,0,47,31,19/1/2022 7:23
9/11/2021,Samut Sakhon,41,110695,586485,282611,303874,27110,27075,35,54,36,19/1/2022 7:23
9/11/2021,Saraburi,73,31615,643429,315725,327704,213646,213508,138,63,67,19/1/2022 7:23
9/11/2021,Sa kaeo,330,17724,561712,280407,281305,80293,79161,1132,28,23,19/1/2022 7:23
9/11/2021,Sing Buri,21,3048,204758,97261,107497,22448,22402,46,,,19/1/2022 7:23
9/11/2021,Suphan Buri,33,15123,835777,403176,432601,279513,279513,0,,,19/1/2022 7:23
9/11/2021,Surat Thani,196,20501,1072430,527357,545073,31940,27595,4345,33,17,19/1/2022 7:23
9/11/2021,Surin,20,18338,1376669,684750,691919,36906,36878,28,,,19/1/2022 7:23
9/11/2021,Sukhothai,15,6108,585572,283544,302028,59322,58638,684,,,19/1/2022 7:23
9/11/2021,Nong Khai,15,4070,516910,256357,260553,88413,88064,349, ,8,19/1/2022 7:23
9/11/2021,Nong Bua Lam Phu,28,4317,509096,253820,255276,9330,9305,25,,,19/1/2022 7:23
9/11/2021,Amnat Charoen,2,2955,376417,187215,189202,12411,12411,0,,,19/1/2022 7:23
9/11/2021,Udon Thani,56,23473,1566796,775703,791093,112923,112463,460,,,19/1/2022 7:23
9/11/2021,Uttaradit,14,4331,446358,217547,228811,51788,51679,109,,,19/1/2022 7:23
9/11/2021,Uthai Thani,5,3582,325208,158967,166241,33303,33303,0,,,19/1/2022 7:23
9/11/2021,Ubon Ratchathani,84,20355,1868052,932286,935766,119633,119591,42,37,25,19/1/2022 7:23
9/11/2021,Ang Thong,14,11312,275021,131590,143431,28564,28564,0,,,19/1/2022 7:23
9/11/2021,Chiang Rai,34,4765,1298579,631054,667525,266159,265473,686,67,21,19/1/2022 7:23
9/11/2021,Chiang Mai,374,24383,1788986,864222,924764,779417,775914,3503,74,32,19/1/2022 7:23
9/11/2021,Phetchaburi,47,22883,482577,232780,249797,479666,479543,123,,,19/1/2022 7:23
9/11/2021,Phetchabun,27,11179,978573,482421,496152,134305,133818,487,,,19/1/2022 7:23
9/11/2021,Loei,17,3976,638978,320126,318852,126076,125834,242,30,22,19/1/2022 7:23
9/11/2021,Phrae,1,1840,434895,209621,225274,51804,51653,151,57,23,19/1/2022 7:23
9/11/2021,Mae Hong Son,14,1870,285927,144863,141064,73223,71986,1237,54,12,19/1/2022 7:23
9/11/2021,,0,173,,,,,,,,,19/1/2022 7:23
10/11/2021,Krabi,91,8578,479290,238118,241172,49198,48852,346,,,19/1/2022 7:23
10/11/2021,Bangkok,957,436766,5530283,2593687,2936596,1294781,1215564,79217,74,52,19/1/2022 7:23
10/11/2021,Kanchanaburi,98,22435,893747,448009,445738,812418,812043,375,26,29,19/1/2022 7:23
10/11/2021,Kalasin,30,9326,975840,482246,493594,39828,39803,25,,,19/1/2022 7:23
10/11/2021,Kamphaeng Phet,7,7829,712340,351623,360717,40873,40710,163,,,19/1/2022 7:23
10/11/2021,Khon Kaen,133,23330,1791302,880185,911117,195487,195350,137,68,49,19/1/2022 7:23
10/11/2021,Chanthaburi,138,20425,536572,262310,274262,127398,127173,225,,,19/1/2022 7:23
10/11/2021,Chachoengsao,130,35997,724145,354876,369269,337607,337607,0,44,38,19/1/2022 7:23
10/11/2021,Chon Buri,203,106592,1583412,772344,811068,929255,920898,8357,55,42,19/1/2022 7:23
10/11/2021,Chai Nat,9,2593,320710,154147,166563,44850,44850,0,,,19/1/2022 7:23
10/11/2021,Chaiyaphum,54,11773,1122715,554712,568003,48905,48826,79,,,19/1/2022 7:23
10/11/2021,Chumphon,73,13446,509632,251576,258056,33159,33146,13,,,19/1/2022 7:23
10/11/2021,Trang,168,13314,639941,312807,327134,25842,25842,0,,,19/1/2022 7:23
10/11/2021,Trat,92,7944,228339,112907,115432,106763,104219,2544,,,19/1/2022 7:23
10/11/2021,Tak,103,23201,676105,341755,334350,65113,65113,0,,,19/1/2022 7:23
10/11/2021,Nakhon Nayok,26,11107,260391,128848,131543,170824,170788,36,,,19/1/2022 7:23
10/11/2021,Nakhon Pathom,26,35139,921946,442578,479368,116491,116387,104,62,39,19/1/2022 7:23
10/11/2021,Nakhon Phanom,4,4929,717181,357273,359908,60530,60511,19,,,19/1/2022 7:23
10/11/2021,Nakhon Ratchasima,226,32357,2634154,1293776,1340378,473887,472075,1812,61,38,19/1/2022 7:23
10/11/2021,Nakhon Si Thammarat,224,33976,1549258,764251,785007,22828,22804,24,,,19/1/2022 7:23
10/11/2021,Nakhon Sawan,77,15812,1035583,505021,530562,75335,75110,225,67,37,19/1/2022 7:23
10/11/2021,Nonthaburi,79,66613,1287480,598638,688842,91335,90985,350,50,37,19/1/2022 7:23
10/11/2021,Narathiwat,192,39389,809341,400380,408961,3051,3051,0,24,15,19/1/2022 7:23
10/11/2021,Nan,4,2497,475894,237970,237924,103582,102713,869,,,19/1/2022 7:23
10/11/2021,Bueng Kan,12,2110,422056,211601,210455,13820,13531,289,,,19/1/2022 7:23
10/11/2021,Buri Ram,21,17010,1580074,783823,796251,77399,76979,420,,,19/1/2022 7:23
10/11/2021,Pathum Thani,57,41212,1189186,563353,625833,80926,80630,296,50,43,19/1/2022 7:23
10/11/2021,Prachuap Khiri Khan,70,17237,553198,274111,279087,450266,449376,890,,,19/1/2022 7:23
10/11/2021,Prachin Buri,127,23526,494804,244188,250616,86770,86638,132,60,37,19/1/2022 7:23
10/11/2021,Pattani,358,41540,729331,360142,369189,4532,4532,0,,,19/1/2022 7:23
10/11/2021,Phra Nakhon Si Ayutthaya,33,31286,820637,394133,426504,389058,388198,860,60,57,19/1/2022 7:23
10/11/2021,Phayao,40,2180,464807,226101,238706,52329,51787,542,49,25,19/1/2022 7:23
10/11/2021,Phang-nga,69,5349,268121,133884,134237,57579,43267,14312,,,19/1/2022 7:23
10/11/2021,Phatthalung,101,10192,522562,254456,268106,19880,19880,0,,,19/1/2022 7:23
10/11/2021,Phichit,9,4992,529730,258152,271578,28128,28128,0,,,19/1/2022 7:23
10/11/2021,Phitsanulok,96,6768,847456,414644,432812,147550,147235,315,,,19/1/2022 7:23
10/11/2021,Phuket,54,16082,418939,198000,220939,158721,117533,41188,42,19,19/1/2022 7:23
10/11/2021,Maha Sarakham,18,10991,948760,465243,483517,22566,22530,36,,,19/1/2022 7:23
10/11/2021,Mukdahan,17,2381,351477,175634,175843,91851,91830,21,,,19/1/2022 7:23
10/11/2021,Yala,202,43941,542249,269916,272333,8303,8303,0,36,23,19/1/2022 7:23
10/11/2021,Yasothon,8,5874,533387,266000,267387,11956,11956,0,,,19/1/2022 7:23
10/11/2021,Ranong,11,9708,194713,98257,96456,10718,10686,32,,,19/1/2022 7:23
10/11/2021,Rayong,83,43473,750813,368748,382065,449414,446915,2499,51,25,19/1/2022 7:23
10/11/2021,Ratchaburi,140,38338,868383,421933,446450,156792,156354,438,,,19/1/2022 7:23
10/11/2021,Roi Et,9,13787,1296246,642036,654210,29035,28998,37,,,19/1/2022 7:23
10/11/2021,Lop Buri,26,17045,739079,368209,370870,164681,164569,112,,,19/1/2022 7:23
10/11/2021,Lampang,16,2809,725197,353220,371977,91037,90339,698,65, ,19/1/2022 7:23
10/11/2021,Lamphun,26,2899,401266,192787,208479,66278,65498,780,,,19/1/2022 7:23
10/11/2021,Si Sa Ket,90,16854,1457748,725758,731990,51233,51233,0,,,19/1/2022 7:23
10/11/2021,Sakon Nakhon,1,7728,1146663,569782,576881,101215,101215,0,,,19/1/2022 7:23
10/11/2021,Songkhla,479,53539,1431562,697309,734253,24450,24434,16,38,17,19/1/2022 7:23
10/11/2021,Satun,93,5929,324802,161606,163196,53346,53307,39,25,28,19/1/2022 7:23
10/11/2021,Samut Prakarn,233,127744,1356374,645942,710432,65953,52911,13042,,,19/1/2022 7:23
10/11/2021,Samut Songkhram,26,11656,191049,91232,99817,103736,103736,0,58,43,19/1/2022 7:23
10/11/2021,Samut Sakhon,46,110741,586485,282611,303874,27110,27075,35,58,46,19/1/2022 7:23
10/11/2021,Saraburi,80,31695,643429,315725,327704,213646,213508,138,77,70,19/1/2022 7:23
10/11/2021,Sa kaeo,98,17822,561712,280407,281305,80293,79161,1132,51,30,19/1/2022 7:23
10/11/2021,Sing Buri,13,3061,204758,97261,107497,22448,22402,46,,,19/1/2022 7:23
10/11/2021,Suphan Buri,52,15175,835777,403176,432601,279513,279513,0,,,19/1/2022 7:23
10/11/2021,Surat Thani,183,20684,1072430,527357,545073,31940,27595,4345,27,13,19/1/2022 7:23
10/11/2021,Surin,24,18362,1376669,684750,691919,36906,36878,28,,,19/1/2022 7:23
10/11/2021,Sukhothai,25,6133,585572,283544,302028,59322,58638,684,,,19/1/2022 7:23
10/11/2021,Nong Khai,21,4091,516910,256357,260553,88413,88064,349,19,9,19/1/2022 7:23
10/11/2021,Nong Bua Lam Phu,3,4320,509096,253820,255276,9330,9305,25,,,19/1/2022 7:23
10/11/2021,Amnat Charoen,12,2967,376417,187215,189202,12411,12411,0,,,19/1/2022 7:23
10/11/2021,Udon Thani,63,23536,1566796,775703,791093,112923,112463,460,,,19/1/2022 7:23
10/11/2021,Uttaradit,15,4346,446358,217547,228811,51788,51679,109,,,19/1/2022 7:23
10/11/2021,Uthai Thani,7,3589,325208,158967,166241,33303,33303,0,,,19/1/2022 7:23
10/11/2021,Ubon Ratchathani,49,20404,1868052,932286,935766,119633,119591,42,49,26,19/1/2022 7:23
10/11/2021,Ang Thong,11,11323,275021,131590,143431,28564,28564,0,,,19/1/2022 7:23
10/11/2021,Chiang Rai,30,4795,1298579,631054,667525,266159,265473,686,56,14,19/1/2022 7:23
10/11/2021,Chiang Mai,408,24791,1788986,864222,924764,779417,775914,3503,67,31,19/1/2022 7:23
10/11/2021,Phetchaburi,94,22977,482577,232780,249797,479666,479543,123,,,19/1/2022 7:23
10/11/2021,Phetchabun,27,11206,978573,482421,496152,134305,133818,487,,,19/1/2022 7:23
10/11/2021,Loei,11,3987,638978,320126,318852,126076,125834,242,46,25,19/1/2022 7:23
10/11/2021,Phrae,5,1845,434895,209621,225274,51804,51653,151,57,24,19/1/2022 7:23
10/11/2021,Mae Hong Son,32,1902,285927,144863,141064,73223,71986,1237,48,14,19/1/2022 7:23
10/11/2021,,0,173,,,,,,,,,19/1/2022 7:23
11/11/2021,Krabi,87,8665,479290,238118,241172,49198,48852,346,,,19/1/2022 7:23
11/11/2021,Bangkok,761,437527,5530283,2593687,2936596,1294781,1215564,79217,88,48,19/1/2022 7:23
11/11/2021,Kanchanaburi,123,22558,893747,448009,445738,812418,812043,375,40,32,19/1/2022 7:23
11/11/2021,Kalasin,26,9352,975840,482246,493594,39828,39803,25,,,19/1/2022 7:23
11/11/2021,Kamphaeng Phet,21,7850,712340,351623,360717,40873,40710,163,,,19/1/2022 7:23
11/11/2021,Khon Kaen,171,23501,1791302,880185,911117,195487,195350,137,77,51,19/1/2022 7:23
11/11/2021,Chanthaburi,132,20557,536572,262310,274262,127398,127173,225,,,19/1/2022 7:23
11/11/2021,Chachoengsao,90,36087,724145,354876,369269,337607,337607,0,60,48,19/1/2022 7:23
11/11/2021,Chon Buri,224,106816,1583412,772344,811068,929255,920898,8357,65,31,19/1/2022 7:23
11/11/2021,Chai Nat,10,2603,320710,154147,166563,44850,44850,0,,,19/1/2022 7:23
11/11/2021,Chaiyaphum,43,11816,1122715,554712,568003,48905,48826,79,,,19/1/2022 7:23
11/11/2021,Chumphon,49,13495,509632,251576,258056,33159,33146,13,,,19/1/2022 7:23
11/11/2021,Trang,163,13477,639941,312807,327134,25842,25842,0,,,19/1/2022 7:23
11/11/2021,Trat,42,7986,228339,112907,115432,106763,104219,2544,,,19/1/2022 7:23
11/11/2021,Tak,130,23331,676105,341755,334350,65113,65113,0,,,19/1/2022 7:23
11/11/2021,Nakhon Nayok,22,11129,260391,128848,131543,170824,170788,36,,,19/1/2022 7:23
11/11/2021,Nakhon Pathom,32,35171,921946,442578,479368,116491,116387,104,70,44,19/1/2022 7:23
11/11/2021,Nakhon Phanom,6,4935,717181,357273,359908,60530,60511,19,,,19/1/2022 7:23
11/11/2021,Nakhon Ratchasima,238,32595,2634154,1293776,1340378,473887,472075,1812,74,41,19/1/2022 7:23
11/11/2021,Nakhon Si Thammarat,375,34351,1549258,764251,785007,22828,22804,24,,,19/1/2022 7:23
11/11/2021,Nakhon Sawan,100,15912,1035583,505021,530562,75335,75110,225,74,43,19/1/2022 7:23
11/11/2021,Nonthaburi,90,66703,1287480,598638,688842,91335,90985,350,65,46,19/1/2022 7:23
11/11/2021,Narathiwat,191,39580,809341,400380,408961,3051,3051,0,31,9,19/1/2022 7:23
11/11/2021,Nan,15,2512,475894,237970,237924,103582,102713,869,,,19/1/2022 7:23
11/11/2021,Bueng Kan,8,2118,422056,211601,210455,13820,13531,289,,,19/1/2022 7:23
11/11/2021,Buri Ram,12,17022,1580074,783823,796251,77399,76979,420,,,19/1/2022 7:23
11/11/2021,Pathum Thani,29,41241,1189186,563353,625833,80926,80630,296,66,48,19/1/2022 7:23
11/11/2021,Prachuap Khiri Khan,88,17325,553198,274111,279087,450266,449376,890,,,19/1/2022 7:23
11/11/2021,Prachin Buri,144,23670,494804,244188,250616,86770,86638,132,66,43,19/1/2022 7:23
11/11/2021,Pattani,368,41908,729331,360142,369189,4532,4532,0,,,19/1/2022 7:23
11/11/2021,Phra Nakhon Si Ayutthaya,67,31353,820637,394133,426504,389058,388198,860,58,61,19/1/2022 7:23
11/11/2021,Phayao,4,2184,464807,226101,238706,52329,51787,542,55,23,19/1/2022 7:23
11/11/2021,Phang-nga,86,5435,268121,133884,134237,57579,43267,14312,,,19/1/2022 7:23
11/11/2021,Phatthalung,91,10283,522562,254456,268106,19880,19880,0,,,19/1/2022 7:23
11/11/2021,Phichit,13,5005,529730,258152,271578,28128,28128,0,,,19/1/2022 7:23
11/11/2021,Phitsanulok,89,6857,847456,414644,432812,147550,147235,315,,,19/1/2022 7:23
11/11/2021,Phuket,73,16155,418939,198000,220939,158721,117533,41188,26,23,19/1/2022 7:23
11/11/2021,Maha Sarakham,12,11003,948760,465243,483517,22566,22530,36,,,19/1/2022 7:23
11/11/2021,Mukdahan,6,2387,351477,175634,175843,91851,91830,21,,,19/1/2022 7:23
11/11/2021,Yala,275,44216,542249,269916,272333,8303,8303,0,42,16,19/1/2022 7:23
11/11/2021,Yasothon,4,5878,533387,266000,267387,11956,11956,0,,,19/1/2022 7:23
11/11/2021,Ranong,14,9722,194713,98257,96456,10718,10686,32,,,19/1/2022 7:23
11/11/2021,Rayong,192,43665,750813,368748,382065,449414,446915,2499,60,23,19/1/2022 7:23
11/11/2021,Ratchaburi,123,38461,868383,421933,446450,156792,156354,438,,,19/1/2022 7:23
11/11/2021,Roi Et,30,13817,1296246,642036,654210,29035,28998,37,,,19/1/2022 7:23
11/11/2021,Lop Buri,72,17117,739079,368209,370870,164681,164569,112,,,19/1/2022 7:23
11/11/2021,Lampang,22,2831,725197,353220,371977,91037,90339,698,66, ,19/1/2022 7:23
11/11/2021,Lamphun,28,2927,401266,192787,208479,66278,65498,780,,,19/1/2022 7:23
11/11/2021,Si Sa Ket,71,16925,1457748,725758,731990,51233,51233,0,,,19/1/2022 7:23
11/11/2021,Sakon Nakhon,9,7737,1146663,569782,576881,101215,101215,0,,,19/1/2022 7:23
11/11/2021,Songkhla,524,54063,1431562,697309,734253,24450,24434,16,36,17,19/1/2022 7:23
11/11/2021,Satun,93,6022,324802,161606,163196,53346,53307,39,33,18,19/1/2022 7:23
11/11/2021,Samut Prakarn,281,128025,1356374,645942,710432,65953,52911,13042,,,19/1/2022 7:23
11/11/2021,Samut Songkhram,51,11707,191049,91232,99817,103736,103736,0,73,46,19/1/2022 7:23
11/11/2021,Samut Sakhon,69,110810,586485,282611,303874,27110,27075,35,69,50,19/1/2022 7:23
11/11/2021,Saraburi,85,31780,643429,315725,327704,213646,213508,138,78,72,19/1/2022 7:23
11/11/2021,Sa kaeo,74,17896,561712,280407,281305,80293,79161,1132,60,29,19/1/2022 7:23
11/11/2021,Sing Buri,20,3081,204758,97261,107497,22448,22402,46,,,19/1/2022 7:23
11/11/2021,Suphan Buri,75,15250,835777,403176,432601,279513,279513,0,,,19/1/2022 7:23
11/11/2021,Surat Thani,233,20917,1072430,527357,545073,31940,27595,4345,26,14,19/1/2022 7:23
11/11/2021,Surin,42,18404,1376669,684750,691919,36906,36878,28,,,19/1/2022 7:23
11/11/2021,Sukhothai,21,6154,585572,283544,302028,59322,58638,684,,,19/1/2022 7:23
11/11/2021,Nong Khai,17,4108,516910,256357,260553,88413,88064,349,24,10,19/1/2022 7:23
11/11/2021,Nong Bua Lam Phu,8,4328,509096,253820,255276,9330,9305,25,,,19/1/2022 7:23
11/11/2021,Amnat Charoen,9,2976,376417,187215,189202,12411,12411,0,,,19/1/2022 7:23
11/11/2021,Udon Thani,94,23630,1566796,775703,791093,112923,112463,460,,,19/1/2022 7:23
11/11/2021,Uttaradit,1,4347,446358,217547,228811,51788,51679,109,,,19/1/2022 7:23
11/11/2021,Uthai Thani,6,3595,325208,158967,166241,33303,33303,0,,,19/1/2022 7:23
11/11/2021,Ubon Ratchathani,51,20455,1868052,932286,935766,119633,119591,42,52,26,19/1/2022 7:23
11/11/2021,Ang Thong,19,11342,275021,131590,143431,28564,28564,0,,,19/1/2022 7:23
11/11/2021,Chiang Rai,53,4848,1298579,631054,667525,266159,265473,686,44,13,19/1/2022 7:23
11/11/2021,Chiang Mai,418,25209,1788986,864222,924764,779417,775914,3503,67,31,19/1/2022 7:23
11/11/2021,Phetchaburi,89,23066,482577,232780,249797,479666,479543,123,,,19/1/2022 7:23
11/11/2021,Phetchabun,42,11248,978573,482421,496152,134305,133818,487,,,19/1/2022 7:23
11/11/2021,Loei,11,3998,638978,320126,318852,126076,125834,242,56,28,19/1/2022 7:23
11/11/2021,Phrae,5,1850,434895,209621,225274,51804,51653,151,59,25,19/1/2022 7:23
11/11/2021,Mae Hong Son,34,1936,285927,144863,141064,73223,71986,1237,55,12,19/1/2022 7:23
11/11/2021,,0,173,,,,,,,,,19/1/2022 7:23
12/11/2021,Krabi,86,8751,479290,238118,241172,49198,48852,346,,,19/1/2022 7:23
12/11/2021,Bangkok,684,438211,5530283,2593687,2936596,1294781,1215564,79217,81,45,19/1/2022 7:23
12/11/2021,Kanchanaburi,101,22659,893747,448009,445738,812418,812043,375,41,30,19/1/2022 7:23
12/11/2021,Kalasin,35,9387,975840,482246,493594,39828,39803,25,,,19/1/2022 7:23
12/11/2021,Kamphaeng Phet,33,7883,712340,351623,360717,40873,40710,163,,,19/1/2022 7:23
12/11/2021,Khon Kaen,178,23679,1791302,880185,911117,195487,195350,137,83,53,19/1/2022 7:23
12/11/2021,Chanthaburi,106,20663,536572,262310,274262,127398,127173,225,,,19/1/2022 7:23
12/11/2021,Chachoengsao,84,36171,724145,354876,369269,337607,337607,0,65,42,19/1/2022 7:23
12/11/2021,Chon Buri,250,107066,1583412,772344,811068,929255,920898,8357,62,70,19/1/2022 7:23
12/11/2021,Chai Nat,7,2610,320710,154147,166563,44850,44850,0,,,19/1/2022 7:23
12/11/2021,Chaiyaphum,16,11832,1122715,554712,568003,48905,48826,79,,,19/1/2022 7:23
12/11/2021,Chumphon,95,13590,509632,251576,258056,33159,33146,13,,,19/1/2022 7:23
12/11/2021,Trang,164,13641,639941,312807,327134,25842,25842,0,,,19/1/2022 7:23
12/11/2021,Trat,54,8040,228339,112907,115432,106763,104219,2544,,,19/1/2022 7:23
12/11/2021,Tak,93,23424,676105,341755,334350,65113,65113,0,,,19/1/2022 7:23
12/11/2021,Nakhon Nayok,45,11174,260391,128848,131543,170824,170788,36,,,19/1/2022 7:23
12/11/2021,Nakhon Pathom,47,35218,921946,442578,479368,116491,116387,104,86,40,19/1/2022 7:23
12/11/2021,Nakhon Phanom,11,4946,717181,357273,359908,60530,60511,19,,,19/1/2022 7:23
12/11/2021,Nakhon Ratchasima,199,32794,2634154,1293776,1340378,473887,472075,1812,82,35,19/1/2022 7:23
12/11/2021,Nakhon Si Thammarat,376,34727,1549258,764251,785007,22828,22804,24,,,19/1/2022 7:23
12/11/2021,Nakhon Sawan,77,15989,1035583,505021,530562,75335,75110,225,84,39,19/1/2022 7:23
12/11/2021,Nonthaburi,91,66794,1287480,598638,688842,91335,90985,350,65,44,19/1/2022 7:23
12/11/2021,Narathiwat,186,39766,809341,400380,408961,3051,3051,0,18,11,19/1/2022 7:23
12/11/2021,Nan,20,2532,475894,237970,237924,103582,102713,869,,,19/1/2022 7:23
12/11/2021,Bueng Kan,10,2128,422056,211601,210455,13820,13531,289,,,19/1/2022 7:23
12/11/2021,Buri Ram,21,17043,1580074,783823,796251,77399,76979,420,,,19/1/2022 7:23
12/11/2021,Pathum Thani,52,41293,1189186,563353,625833,80926,80630,296,77,39,19/1/2022 7:23
12/11/2021,Prachuap Khiri Khan,94,17419,553198,274111,279087,450266,449376,890,,,19/1/2022 7:23
12/11/2021,Prachin Buri,113,23783,494804,244188,250616,86770,86638,132,76,41,19/1/2022 7:23
12/11/2021,Pattani,357,42265,729331,360142,369189,4532,4532,0,,,19/1/2022 7:23
12/11/2021,Phra Nakhon Si Ayutthaya,98,31451,820637,394133,426504,389058,388198,860,69,56,19/1/2022 7:23
12/11/2021,Phayao,25,2209,464807,226101,238706,52329,51787,542,52,25,19/1/2022 7:23
12/11/2021,Phang-nga,76,5511,268121,133884,134237,57579,43267,14312,,,19/1/2022 7:23
12/11/2021,Phatthalung,107,10390,522562,254456,268106,19880,19880,0,,,19/1/2022 7:23
12/11/2021,Phichit,24,5029,529730,258152,271578,28128,28128,0,,,19/1/2022 7:23
12/11/2021,Phitsanulok,95,6952,847456,414644,432812,147550,147235,315,,,19/1/2022 7:23
12/11/2021,Phuket,56,16211,418939,198000,220939,158721,117533,41188,41,20,19/1/2022 7:23
12/11/2021,Maha Sarakham,4,11007,948760,465243,483517,22566,22530,36,,,19/1/2022 7:23
12/11/2021,Mukdahan,1,2388,351477,175634,175843,91851,91830,21,,,19/1/2022 7:23
12/11/2021,Yala,241,44457,542249,269916,272333,8303,8303,0,36,15,19/1/2022 7:23
12/11/2021,Yasothon,2,5880,533387,266000,267387,11956,11956,0,,,19/1/2022 7:23
12/11/2021,Ranong,6,9728,194713,98257,96456,10718,10686,32,,,19/1/2022 7:23
12/11/2021,Rayong,186,43851,750813,368748,382065,449414,446915,2499,59,24,19/1/2022 7:23
12/11/2021,Ratchaburi,147,38608,868383,421933,446450,156792,156354,438,,,19/1/2022 7:23
12/11/2021,Roi Et,19,13836,1296246,642036,654210,29035,28998,37,,,19/1/2022 7:23
12/11/2021,Lop Buri,72,17189,739079,368209,370870,164681,164569,112,,,19/1/2022 7:23
12/11/2021,Lampang,3,2834,725197,353220,371977,91037,90339,698,65, ,19/1/2022 7:23
12/11/2021,Lamphun,7,2934,401266,192787,208479,66278,65498,780,,,19/1/2022 7:23
12/11/2021,Si Sa Ket,119,17044,1457748,725758,731990,51233,51233,0,,,19/1/2022 7:23
12/11/2021,Sakon Nakhon,6,7743,1146663,569782,576881,101215,101215,0,,,19/1/2022 7:23
12/11/2021,Songkhla,475,54538,1431562,697309,734253,24450,24434,16,36,29,19/1/2022 7:23
12/11/2021,Satun,92,6114,324802,161606,163196,53346,53307,39,26,22,19/1/2022 7:23
12/11/2021,Samut Prakarn,223,128248,1356374,645942,710432,65953,52911,13042,,,19/1/2022 7:23
12/11/2021,Samut Songkhram,23,11730,191049,91232,99817,103736,103736,0,84,37,19/1/2022 7:23
12/11/2021,Samut Sakhon,49,110859,586485,282611,303874,27110,27075,35,79,44,19/1/2022 7:23
12/11/2021,Saraburi,93,31873,643429,315725,327704,213646,213508,138,92,66,19/1/2022 7:23
12/11/2021,Sa kaeo,77,17973,561712,280407,281305,80293,79161,1132,60,27,19/1/2022 7:23
12/11/2021,Sing Buri,18,3099,204758,97261,107497,22448,22402,46,,,19/1/2022 7:23
12/11/2021,Suphan Buri,38,15288,835777,403176,432601,279513,279513,0,,,19/1/2022 7:23
12/11/2021,Surat Thani,216,21133,1072430,527357,545073,31940,27595,4345,26,12,19/1/2022 7:23
12/11/2021,Surin,27,18431,1376669,684750,691919,36906,36878,28,,,19/1/2022 7:23
12/11/2021,Sukhothai,44,6198,585572,283544,302028,59322,58638,684,,,19/1/2022 7:23
12/11/2021,Nong Khai,25,4133,516910,256357,260553,88413,88064,349,25,10,19/1/2022 7:23
12/11/2021,Nong Bua Lam Phu,23,4351,509096,253820,255276,9330,9305,25,,,19/1/2022 7:23
12/11/2021,Amnat Charoen,9,2985,376417,187215,189202,12411,12411,0,,,19/1/2022 7:23
12/11/2021,Udon Thani,98,23728,1566796,775703,791093,112923,112463,460,,,19/1/2022 7:23
12/11/2021,Uttaradit,7,4354,446358,217547,228811,51788,51679,109,,,19/1/2022 7:23
12/11/2021,Uthai Thani,2,3597,325208,158967,166241,33303,33303,0,,,19/1/2022 7:23
12/11/2021,Ubon Ratchathani,118,20573,1868052,932286,935766,119633,119591,42,52,28,19/1/2022 7:23
12/11/2021,Ang Thong,15,11357,275021,131590,143431,28564,28564,0,,,19/1/2022 7:23
12/11/2021,Chiang Rai,49,4897,1298579,631054,667525,266159,265473,686,38,20,19/1/2022 7:23
12/11/2021,Chiang Mai,452,25661,1788986,864222,924764,779417,775914,3503,67,29,19/1/2022 7:23
12/11/2021,Phetchaburi,83,23149,482577,232780,249797,479666,479543,123,,,19/1/2022 7:23
12/11/2021,Phetchabun,40,11288,978573,482421,496152,134305,133818,487,,,19/1/2022 7:23
12/11/2021,Loei,3,4001,638978,320126,318852,126076,125834,242,61,27,19/1/2022 7:23
12/11/2021,Phrae,3,1853,434895,209621,225274,51804,51653,151,63,30,19/1/2022 7:23
12/11/2021,Mae Hong Son,24,1960,285927,144863,141064,73223,71986,1237,48,10,19/1/2022 7:23
12/11/2021,,0,173,,,,,,,,,19/1/2022 7:23
13/11/2021,Krabi,97,8848,479290,238118,241172,49198,48852,346,,,19/1/2022 7:23
13/11/2021,Bangkok,698,438909,5530283,2593687,2936596,1294781,1215564,79217,84,44,19/1/2022 7:23
13/11/2021,Kanchanaburi,142,22801,893747,448009,445738,812418,812043,375,41,37,19/1/2022 7:23
13/11/2021,Kalasin,103,9490,975840,482246,493594,39828,39803,25,,,19/1/2022 7:23
13/11/2021,Kamphaeng Phet,13,7896,712340,351623,360717,40873,40710,163,,,19/1/2022 7:23
13/11/2021,Khon Kaen,184,23863,1791302,880185,911117,195487,195350,137,98,49,19/1/2022 7:23
13/11/2021,Chanthaburi,125,20788,536572,262310,274262,127398,127173,225,,,19/1/2022 7:23
13/11/2021,Chachoengsao,66,36237,724145,354876,369269,337607,337607,0,71,40,19/1/2022 7:23
13/11/2021,Chon Buri,203,107269,1583412,772344,811068,929255,920898,8357,103,29,19/1/2022 7:23
13/11/2021,Chai Nat,8,2618,320710,154147,166563,44850,44850,0,,,19/1/2022 7:23
13/11/2021,Chaiyaphum,13,11845,1122715,554712,568003,48905,48826,79,,,19/1/2022 7:23
13/11/2021,Chumphon,83,13673,509632,251576,258056,33159,33146,13,,,19/1/2022 7:23
13/11/2021,Trang,163,13804,639941,312807,327134,25842,25842,0,,,19/1/2022 7:23
13/11/2021,Trat,44,8084,228339,112907,115432,106763,104219,2544,,,19/1/2022 7:23
13/11/2021,Tak,103,23527,676105,341755,334350,65113,65113,0,,,19/1/2022 7:23
13/11/2021,Nakhon Nayok,22,11196,260391,128848,131543,170824,170788,36,,,19/1/2022 7:23
13/11/2021,Nakhon Pathom,31,35249,921946,442578,479368,116491,116387,104,84,48,19/1/2022 7:23
13/11/2021,Nakhon Phanom,11,4957,717181,357273,359908,60530,60511,19,,,19/1/2022 7:23
13/11/2021,Nakhon Ratchasima,111,32905,2634154,1293776,1340378,473887,472075,1812,74,41,19/1/2022 7:23
13/11/2021,Nakhon Si Thammarat,351,35078,1549258,764251,785007,22828,22804,24,,,19/1/2022 7:23
13/11/2021,Nakhon Sawan,52,16041,1035583,505021,530562,75335,75110,225,78,41,19/1/2022 7:23
13/11/2021,Nonthaburi,98,66892,1287480,598638,688842,91335,90985,350,65,59,19/1/2022 7:23
13/11/2021,Narathiwat,186,39952,809341,400380,408961,3051,3051,0,16,13,19/1/2022 7:23
13/11/2021,Nan,12,2544,475894,237970,237924,103582,102713,869,,,19/1/2022 7:23
13/11/2021,Bueng Kan,5,2133,422056,211601,210455,13820,13531,289,,,19/1/2022 7:23
13/11/2021,Buri Ram,19,17062,1580074,783823,796251,77399,76979,420,,,19/1/2022 7:23
13/11/2021,Pathum Thani,67,41360,1189186,563353,625833,80926,80630,296,67,48,19/1/2022 7:23
13/11/2021,Prachuap Khiri Khan,58,17477,553198,274111,279087,450266,449376,890,,,19/1/2022 7:23
13/11/2021,Prachin Buri,111,23894,494804,244188,250616,86770,86638,132,71,48,19/1/2022 7:23
13/11/2021,Pattani,379,42644,729331,360142,369189,4532,4532,0,,,19/1/2022 7:23
13/11/2021,Phra Nakhon Si Ayutthaya,64,31515,820637,394133,426504,389058,388198,860,62,61,19/1/2022 7:23
13/11/2021,Phayao,45,2254,464807,226101,238706,52329,51787,542,55,28,19/1/2022 7:23
13/11/2021,Phang-nga,67,5578,268121,133884,134237,57579,43267,14312,,,19/1/2022 7:23
13/11/2021,Phatthalung,114,10504,522562,254456,268106,19880,19880,0,,,19/1/2022 7:23
13/11/2021,Phichit,23,5052,529730,258152,271578,28128,28128,0,,,19/1/2022 7:23
13/11/2021,Phitsanulok,85,7037,847456,414644,432812,147550,147235,315,,,19/1/2022 7:23
13/11/2021,Phuket,62,16273,418939,198000,220939,158721,117533,41188,32,26,19/1/2022 7:23
13/11/2021,Maha Sarakham,11,11018,948760,465243,483517,22566,22530,36,,,19/1/2022 7:23
13/11/2021,Mukdahan,3,2391,351477,175634,175843,91851,91830,21,,,19/1/2022 7:23
13/11/2021,Yala,213,44670,542249,269916,272333,8303,8303,0,30,19,19/1/2022 7:23
13/11/2021,Yasothon,13,5893,533387,266000,267387,11956,11956,0,,,19/1/2022 7:23
13/11/2021,Ranong,23,9751,194713,98257,96456,10718,10686,32,,,19/1/2022 7:23
13/11/2021,Rayong,144,43995,750813,368748,382065,449414,446915,2499,63,23,19/1/2022 7:23
13/11/2021,Ratchaburi,114,38722,868383,421933,446450,156792,156354,438,,,19/1/2022 7:23
13/11/2021,Roi Et,20,13856,1296246,642036,654210,29035,28998,37,,,19/1/2022 7:23
13/11/2021,Lop Buri,60,17249,739079,368209,370870,164681,164569,112,,,19/1/2022 7:23
13/11/2021,Lampang,11,2845,725197,353220,371977,91037,90339,698,68, ,19/1/2022 7:23
13/11/2021,Lamphun,19,2953,401266,192787,208479,66278,65498,780,,,19/1/2022 7:23
13/11/2021,Si Sa Ket,19,17063,1457748,725758,731990,51233,51233,0,,,19/1/2022 7:23
13/11/2021,Sakon Nakhon,6,7749,1146663,569782,576881,101215,101215,0,,,19/1/2022 7:23
13/11/2021,Songkhla,473,55011,1431562,697309,734253,24450,24434,16,55,30,19/1/2022 7:23
13/11/2021,Satun,98,6212,324802,161606,163196,53346,53307,39,28,27,19/1/2022 7:23
13/11/2021,Samut Prakarn,281,128529,1356374,645942,710432,65953,52911,13042,,,19/1/2022 7:23
13/11/2021,Samut Songkhram,23,11753,191049,91232,99817,103736,103736,0,74,45,19/1/2022 7:23
13/11/2021,Samut Sakhon,68,110927,586485,282611,303874,27110,27075,35,70,48,19/1/2022 7:23
13/11/2021,Saraburi,87,31960,643429,315725,327704,213646,213508,138,80,71,19/1/2022 7:23
13/11/2021,Sa kaeo,87,18060,561712,280407,281305,80293,79161,1132,60,35,19/1/2022 7:23
13/11/2021,Sing Buri,17,3116,204758,97261,107497,22448,22402,46,,,19/1/2022 7:23
13/11/2021,Suphan Buri,42,15330,835777,403176,432601,279513,279513,0,,,19/1/2022 7:23
13/11/2021,Surat Thani,245,21378,1072430,527357,545073,31940,27595,4345,14,10,19/1/2022 7:23
13/11/2021,Surin,29,18460,1376669,684750,691919,36906,36878,28,,,19/1/2022 7:23
13/11/2021,Sukhothai,32,6230,585572,283544,302028,59322,58638,684,,,19/1/2022 7:23
13/11/2021,Nong Khai,17,4150,516910,256357,260553,88413,88064,349,26,11,19/1/2022 7:23
13/11/2021,Nong Bua Lam Phu,2,4353,509096,253820,255276,9330,9305,25,,,19/1/2022 7:23
13/11/2021,Amnat Charoen,3,2988,376417,187215,189202,12411,12411,0,,,19/1/2022 7:23
13/11/2021,Udon Thani,96,23824,1566796,775703,791093,112923,112463,460,,,19/1/2022 7:23
13/11/2021,Uttaradit,10,4364,446358,217547,228811,51788,51679,109,,,19/1/2022 7:23
13/11/2021,Uthai Thani,0,3597,325208,158967,166241,33303,33303,0,,,19/1/2022 7:23
13/11/2021,Ubon Ratchathani,68,20641,1868052,932286,935766,119633,119591,42,57,31,19/1/2022 7:23
13/11/2021,Ang Thong,7,11364,275021,131590,143431,28564,28564,0,,,19/1/2022 7:23
13/11/2021,Chiang Rai,36,4933,1298579,631054,667525,266159,265473,686,53,17,19/1/2022 7:23
13/11/2021,Chiang Mai,505,26166,1788986,864222,924764,779417,775914,3503,65,34,19/1/2022 7:23
13/11/2021,Phetchaburi,71,23220,482577,232780,249797,479666,479543,123,,,19/1/2022 7:23
13/11/2021,Phetchabun,47,11335,978573,482421,496152,134305,133818,487,,,19/1/2022 7:23
13/11/2021,Loei,15,4016,638978,320126,318852,126076,125834,242,61,29,19/1/2022 7:23
13/11/2021,Phrae,9,1862,434895,209621,225274,51804,51653,151,71,33,19/1/2022 7:23
13/11/2021,Mae Hong Son,15,1975,285927,144863,141064,73223,71986,1237,42,19,19/1/2022 7:23
13/11/2021,,0,173,,,,,,,,,19/1/2022 7:23
14/11/2021,Krabi,86,8934,479290,238118,241172,49198,48852,346,,,19/1/2022 7:23
14/11/2021,Bangkok,712,439621,5530283,2593687,2936596,1294781,1215564,79217,90,45,19/1/2022 7:23
14/11/2021,Kanchanaburi,99,22900,893747,448009,445738,812418,812043,375,53,35,19/1/2022 7:23
14/11/2021,Kalasin,19,9509,975840,482246,493594,39828,39803,25,,,19/1/2022 7:23
14/11/2021,Kamphaeng Phet,14,7910,712340,351623,360717,40873,40710,163,,,19/1/2022 7:23
14/11/2021,Khon Kaen,118,23981,1791302,880185,911117,195487,195350,137,91,49,19/1/2022 7:23
14/11/2021,Chanthaburi,115,20903,536572,262310,274262,127398,127173,225,,,19/1/2022 7:23
14/11/2021,Chachoengsao,50,36287,724145,354876,369269,337607,337607,0,71,42,19/1/2022 7:23
14/11/2021,Chon Buri,180,107449,1583412,772344,811068,929255,920898,8357,63,34,19/1/2022 7:23
14/11/2021,Chai Nat,8,2626,320710,154147,166563,44850,44850,0,,,19/1/2022 7:23
14/11/2021,Chaiyaphum,40,11885,1122715,554712,568003,48905,48826,79,,,19/1/2022 7:23
14/11/2021,Chumphon,83,13756,509632,251576,258056,33159,33146,13,,,19/1/2022 7:23
14/11/2021,Trang,167,13971,639941,312807,327134,25842,25842,0,,,19/1/2022 7:23
14/11/2021,Trat,49,8133,228339,112907,115432,106763,104219,2544,,,19/1/2022 7:23
14/11/2021,Tak,96,23623,676105,341755,334350,65113,65113,0,,,19/1/2022 7:23
14/11/2021,Nakhon Nayok,49,11245,260391,128848,131543,170824,170788,36,,,19/1/2022 7:23
14/11/2021,Nakhon Pathom,48,35297,921946,442578,479368,116491,116387,104,95,47,19/1/2022 7:23
14/11/2021,Nakhon Phanom,4,4961,717181,357273,359908,60530,60511,19,,,19/1/2022 7:23
14/11/2021,Nakhon Ratchasima,147,33052,2634154,1293776,1340378,473887,472075,1812,85,35,19/1/2022 7:23
14/11/2021,Nakhon Si Thammarat,349,35427,1549258,764251,785007,22828,22804,24,,,19/1/2022 7:23
14/11/2021,Nakhon Sawan,52,16093,1035583,505021,530562,75335,75110,225,79,47,19/1/2022 7:23
14/11/2021,Nonthaburi,90,66982,1287480,598638,688842,91335,90985,350,87, ,19/1/2022 7:23
14/11/2021,Narathiwat,339,40291,809341,400380,408961,3051,3051,0,19,14,19/1/2022 7:23
14/11/2021,Nan,11,2555,475894,237970,237924,103582,102713,869,,,19/1/2022 7:23
14/11/2021,Bueng Kan,3,2136,422056,211601,210455,13820,13531,289,,,19/1/2022 7:23
14/11/2021,Buri Ram,22,17084,1580074,783823,796251,77399,76979,420,,,19/1/2022 7:23
14/11/2021,Pathum Thani,55,41415,1189186,563353,625833,80926,80630,296,84,45,19/1/2022 7:23
14/11/2021,Prachuap Khiri Khan,147,17624,553198,274111,279087,450266,449376,890,,,19/1/2022 7:23
14/11/2021,Prachin Buri,99,23993,494804,244188,250616,86770,86638,132,89,41,19/1/2022 7:23
14/11/2021,Pattani,371,43015,729331,360142,369189,4532,4532,0,,,19/1/2022 7:23
14/11/2021,Phra Nakhon Si Ayutthaya,76,31591,820637,394133,426504,389058,388198,860,81,60,19/1/2022 7:23
14/11/2021,Phayao,8,2262,464807,226101,238706,52329,51787,542,66,31,19/1/2022 7:23
14/11/2021,Phang-nga,46,5624,268121,133884,134237,57579,43267,14312,,,19/1/2022 7:23
14/11/2021,Phatthalung,119,10623,522562,254456,268106,19880,19880,0,,,19/1/2022 7:23
14/11/2021,Phichit,15,5067,529730,258152,271578,28128,28128,0,,,19/1/2022 7:23
14/11/2021,Phitsanulok,85,7122,847456,414644,432812,147550,147235,315,,,19/1/2022 7:23
14/11/2021,Phuket,50,16323,418939,198000,220939,158721,117533,41188,44,21,19/1/2022 7:23
14/11/2021,Maha Sarakham,10,11028,948760,465243,483517,22566,22530,36,,,19/1/2022 7:23
14/11/2021,Mukdahan,1,2392,351477,175634,175843,91851,91830,21,,,19/1/2022 7:23
14/11/2021,Yala,204,44874,542249,269916,272333,8303,8303,0,40,26,19/1/2022 7:23
14/11/2021,Yasothon,4,5897,533387,266000,267387,11956,11956,0,,,19/1/2022 7:23
14/11/2021,Ranong,7,9758,194713,98257,96456,10718,10686,32,,,19/1/2022 7:23
14/11/2021,Rayong,134,44129,750813,368748,382065,449414,446915,2499,59,26,19/1/2022 7:23
14/11/2021,Ratchaburi,147,38869,868383,421933,446450,156792,156354,438,,,19/1/2022 7:23
14/11/2021,Roi Et,23,13879,1296246,642036,654210,29035,28998,37,,,19/1/2022 7:23
14/11/2021,Lop Buri,57,17306,739079,368209,370870,164681,164569,112,,,19/1/2022 7:23
14/11/2021,Lampang,8,2853,725197,353220,371977,91037,90339,698,83, ,19/1/2022 7:23
14/11/2021,Lamphun,56,3009,401266,192787,208479,66278,65498,780,,,19/1/2022 7:23
14/11/2021,Si Sa Ket,53,17116,1457748,725758,731990,51233,51233,0,,,19/1/2022 7:23
14/11/2021,Sakon Nakhon,2,7751,1146663,569782,576881,101215,101215,0,,,19/1/2022 7:23
14/11/2021,Songkhla,461,55472,1431562,697309,734253,24450,24434,16,57,33,19/1/2022 7:23
14/11/2021,Satun,97,6309,324802,161606,163196,53346,53307,39,23,30,19/1/2022 7:23
14/11/2021,Samut Prakarn,250,128779,1356374,645942,710432,65953,52911,13042,,,19/1/2022 7:23
14/11/2021,Samut Songkhram,14,11767,191049,91232,99817,103736,103736,0,98,45,19/1/2022 7:23
14/11/2021,Samut Sakhon,55,110982,586485,282611,303874,27110,27075,35,79,101,19/1/2022 7:23
14/11/2021,Saraburi,90,32050,643429,315725,327704,213646,213508,138,101,74,19/1/2022 7:23
14/11/2021,Sa kaeo,111,18171,561712,280407,281305,80293,79161,1132,70,32,19/1/2022 7:23
14/11/2021,Sing Buri,41,3157,204758,97261,107497,22448,22402,46,,,19/1/2022 7:23
14/11/2021,Suphan Buri,138,15468,835777,403176,432601,279513,279513,0,,,19/1/2022 7:23
14/11/2021,Surat Thani,244,21622,1072430,527357,545073,31940,27595,4345,30,15,19/1/2022 7:23
14/11/2021,Surin,39,18499,1376669,684750,691919,36906,36878,28,,,19/1/2022 7:23
14/11/2021,Sukhothai,28,6258,585572,283544,302028,59322,58638,684,,,19/1/2022 7:23
14/11/2021,Nong Khai,19,4169,516910,256357,260553,88413,88064,349,28,9,19/1/2022 7:23
14/11/2021,Nong Bua Lam Phu,13,4366,509096,253820,255276,9330,9305,25,,,19/1/2022 7:23
14/11/2021,Amnat Charoen,11,2999,376417,187215,189202,12411,12411,0,,,19/1/2022 7:23
14/11/2021,Udon Thani,84,23908,1566796,775703,791093,112923,112463,460,,,19/1/2022 7:23
14/11/2021,Uttaradit,15,4379,446358,217547,228811,51788,51679,109,,,19/1/2022 7:23
14/11/2021,Uthai Thani,8,3605,325208,158967,166241,33303,33303,0,,,19/1/2022 7:23
14/11/2021,Ubon Ratchathani,65,20706,1868052,932286,935766,119633,119591,42,67,24,19/1/2022 7:23
14/11/2021,Ang Thong,10,11374,275021,131590,143431,28564,28564,0,,,19/1/2022 7:23
14/11/2021,Chiang Rai,21,4954,1298579,631054,667525,266159,265473,686,55,26,19/1/2022 7:23
14/11/2021,Chiang Mai,357,26523,1788986,864222,924764,779417,775914,3503,69,37,19/1/2022 7:23
14/11/2021,Phetchaburi,85,23305,482577,232780,249797,479666,479543,123,,,19/1/2022 7:23
14/11/2021,Phetchabun,53,11388,978573,482421,496152,134305,133818,487,,,19/1/2022 7:23
14/11/2021,Loei,13,4029,638978,320126,318852,126076,125834,242,66,28,19/1/2022 7:23
14/11/2021,Phrae,8,1870,434895,209621,225274,51804,51653,151,82,33,19/1/2022 7:23
14/11/2021,Mae Hong Son,22,1997,285927,144863,141064,73223,71986,1237,68,16,19/1/2022 7:23
14/11/2021,,0,173,,,,,,,,,19/1/2022 7:23
15/11/2021,Krabi,84,9018,479290,238118,241172,49198,48852,346,,,19/1/2022 7:23
15/11/2021,Bangkok,794,440415,5530283,2593687,2936596,1294781,1215564,79217,92,33,19/1/2022 7:23
15/11/2021,Kanchanaburi,113,23013,893747,448009,445738,812418,812043,375,49,37,19/1/2022 7:23
15/11/2021,Kalasin,20,9529,975840,482246,493594,39828,39803,25,,,19/1/2022 7:23
15/11/2021,Kamphaeng Phet,18,7928,712340,351623,360717,40873,40710,163,,,19/1/2022 7:23
15/11/2021,Khon Kaen,63,24044,1791302,880185,911117,195487,195350,137,93,47,19/1/2022 7:23
15/11/2021,Chanthaburi,67,20970,536572,262310,274262,127398,127173,225,,,19/1/2022 7:23
15/11/2021,Chachoengsao,22,36309,724145,354876,369269,337607,337607,0,71,34,19/1/2022 7:23
15/11/2021,Chon Buri,188,107637,1583412,772344,811068,929255,920898,8357,71,28,19/1/2022 7:23
15/11/2021,Chai Nat,5,2631,320710,154147,166563,44850,44850,0,,,19/1/2022 7:23
15/11/2021,Chaiyaphum,9,11894,1122715,554712,568003,48905,48826,79,,,19/1/2022 7:23
15/11/2021,Chumphon,48,13804,509632,251576,258056,33159,33146,13,,,19/1/2022 7:23
15/11/2021,Trang,159,14130,639941,312807,327134,25842,25842,0,,,19/1/2022 7:23
15/11/2021,Trat,16,8149,228339,112907,115432,106763,104219,2544,,,19/1/2022 7:23
15/11/2021,Tak,61,23684,676105,341755,334350,65113,65113,0,,,19/1/2022 7:23
15/11/2021,Nakhon Nayok,6,11251,260391,128848,131543,170824,170788,36,,,19/1/2022 7:23
15/11/2021,Nakhon Pathom,55,35352,921946,442578,479368,116491,116387,104,87,50,19/1/2022 7:23
15/11/2021,Nakhon Phanom,6,4967,717181,357273,359908,60530,60511,19,,,19/1/2022 7:23
15/11/2021,Nakhon Ratchasima,153,33205,2634154,1293776,1340378,473887,472075,1812,74,30,19/1/2022 7:23
15/11/2021,Nakhon Si Thammarat,428,35855,1549258,764251,785007,22828,22804,24,,,19/1/2022 7:23
15/11/2021,Nakhon Sawan,47,16140,1035583,505021,530562,75335,75110,225,92,43,19/1/2022 7:23
15/11/2021,Nonthaburi,84,67066,1287480,598638,688842,91335,90985,350,71, ,19/1/2022 7:23
15/11/2021,Narathiwat,193,40484,809341,400380,408961,3051,3051,0,31,15,19/1/2022 7:23
15/11/2021,Nan,5,2560,475894,237970,237924,103582,102713,869,,,19/1/2022 7:23
15/11/2021,Bueng Kan,8,2144,422056,211601,210455,13820,13531,289,,,19/1/2022 7:23
15/11/2021,Buri Ram,6,17090,1580074,783823,796251,77399,76979,420,,,19/1/2022 7:23
15/11/2021,Pathum Thani,33,41448,1189186,563353,625833,80926,80630,296,79,43,19/1/2022 7:23
15/11/2021,Prachuap Khiri Khan,63,17687,553198,274111,279087,450266,449376,890,,,19/1/2022 7:23
15/11/2021,Prachin Buri,80,24073,494804,244188,250616,86770,86638,132,75,34,19/1/2022 7:23
15/11/2021,Pattani,321,43336,729331,360142,369189,4532,4532,0,,,19/1/2022 7:23
15/11/2021,Phra Nakhon Si Ayutthaya,59,31650,820637,394133,426504,389058,388198,860,73,56,19/1/2022 7:23
15/11/2021,Phayao,48,2310,464807,226101,238706,52329,51787,542,68,30,19/1/2022 7:23
15/11/2021,Phang-nga,22,5646,268121,133884,134237,57579,43267,14312,,,19/1/2022 7:23
15/11/2021,Phatthalung,108,10731,522562,254456,268106,19880,19880,0,,,19/1/2022 7:23
15/11/2021,Phichit,14,5081,529730,258152,271578,28128,28128,0,,,19/1/2022 7:23
15/11/2021,Phitsanulok,72,7194,847456,414644,432812,147550,147235,315,,,19/1/2022 7:23
15/11/2021,Phuket,56,16379,418939,198000,220939,158721,117533,41188,28,24,19/1/2022 7:23
15/11/2021,Maha Sarakham,7,11035,948760,465243,483517,22566,22530,36,,,19/1/2022 7:23
15/11/2021,Mukdahan,1,2393,351477,175634,175843,91851,91830,21,,,19/1/2022 7:23
15/11/2021,Yala,207,45081,542249,269916,272333,8303,8303,0,48,22,19/1/2022 7:23
15/11/2021,Yasothon,10,5907,533387,266000,267387,11956,11956,0,,,19/1/2022 7:23
15/11/2021,Ranong,6,9764,194713,98257,96456,10718,10686,32,,,19/1/2022 7:23
15/11/2021,Rayong,97,44226,750813,368748,382065,449414,446915,2499,65,28,19/1/2022 7:23
15/11/2021,Ratchaburi,134,39003,868383,421933,446450,156792,156354,438,,,19/1/2022 7:23
15/11/2021,Roi Et,27,13906,1296246,642036,654210,29035,28998,37,,,19/1/2022 7:23
15/11/2021,Lop Buri,37,17343,739079,368209,370870,164681,164569,112,,,19/1/2022 7:23
15/11/2021,Lampang,10,2863,725197,353220,371977,91037,90339,698,85, ,19/1/2022 7:23
15/11/2021,Lamphun,14,3023,401266,192787,208479,66278,65498,780,,,19/1/2022 7:23
15/11/2021,Si Sa Ket,170,17286,1457748,725758,731990,51233,51233,0,,,19/1/2022 7:23
15/11/2021,Sakon Nakhon,7,7758,1146663,569782,576881,101215,101215,0,,,19/1/2022 7:23
15/11/2021,Songkhla,466,55938,1431562,697309,734253,24450,24434,16,60,24,19/1/2022 7:23
15/11/2021,Satun,98,6407,324802,161606,163196,53346,53307,39,37,23,19/1/2022 7:23
15/11/2021,Samut Prakarn,173,128952,1356374,645942,710432,65953,52911,13042,,,19/1/2022 7:23
15/11/2021,Samut Songkhram,5,11772,191049,91232,99817,103736,103736,0,93,35,19/1/2022 7:23
15/11/2021,Samut Sakhon,51,111033,586485,282611,303874,27110,27075,35,87,50,19/1/2022 7:23
15/11/2021,Saraburi,95,32145,643429,315725,327704,213646,213508,138,98,82,19/1/2022 7:23
15/11/2021,Sa kaeo,77,18248,561712,280407,281305,80293,79161,1132,65,17,19/1/2022 7:23
15/11/2021,Sing Buri,39,3196,204758,97261,107497,22448,22402,46,,,19/1/2022 7:23
15/11/2021,Suphan Buri,49,15517,835777,403176,432601,279513,279513,0,,,19/1/2022 7:23
15/11/2021,Surat Thani,231,21853,1072430,527357,545073,31940,27595,4345,22,14,19/1/2022 7:23
15/11/2021,Surin,26,18525,1376669,684750,691919,36906,36878,28,,,19/1/2022 7:23
15/11/2021,Sukhothai,17,6275,585572,283544,302028,59322,58638,684,,,19/1/2022 7:23
15/11/2021,Nong Khai,16,4185,516910,256357,260553,88413,88064,349,22,8,19/1/2022 7:23
15/11/2021,Nong Bua Lam Phu,2,4368,509096,253820,255276,9330,9305,25,,,19/1/2022 7:23
15/11/2021,Amnat Charoen,13,3012,376417,187215,189202,12411,12411,0,,,19/1/2022 7:23
15/11/2021,Udon Thani,93,24001,1566796,775703,791093,112923,112463,460,,,19/1/2022 7:23
15/11/2021,Uttaradit,14,4393,446358,217547,228811,51788,51679,109,,,19/1/2022 7:23
15/11/2021,Uthai Thani,6,3611,325208,158967,166241,33303,33303,0,,,19/1/2022 7:23
15/11/2021,Ubon Ratchathani,85,20791,1868052,932286,935766,119633,119591,42,56,22,19/1/2022 7:23
15/11/2021,Ang Thong,5,11379,275021,131590,143431,28564,28564,0,,,19/1/2022 7:23
15/11/2021,Chiang Rai,22,4976,1298579,631054,667525,266159,265473,686,77,26,19/1/2022 7:23
15/11/2021,Chiang Mai,377,26900,1788986,864222,924764,779417,775914,3503,71,35,19/1/2022 7:23
15/11/2021,Phetchaburi,53,23358,482577,232780,249797,479666,479543,123,,,19/1/2022 7:23
15/11/2021,Phetchabun,45,11433,978573,482421,496152,134305,133818,487,,,19/1/2022 7:23
15/11/2021,Loei,15,4044,638978,320126,318852,126076,125834,242,66,28,19/1/2022 7:23
15/11/2021,Phrae,4,1874,434895,209621,225274,51804,51653,151,81,27,19/1/2022 7:23
15/11/2021,Mae Hong Son,5,2002,285927,144863,141064,73223,71986,1237,60,16,19/1/2022 7:23
15/11/2021,,0,173,,,,,,,,,19/1/2022 7:23
16/11/2021,Krabi,91,9109,479290,238118,241172,49198,48852,346,,,19/1/2022 7:23
16/11/2021,Bangkok,859,441274,5530283,2593687,2936596,1294781,1215564,79217,69,26,19/1/2022 7:23
16/11/2021,Kanchanaburi,94,23107,893747,448009,445738,812418,812043,375,64,29,19/1/2022 7:23
16/11/2021,Kalasin,27,9556,975840,482246,493594,39828,39803,25,,,19/1/2022 7:23
16/11/2021,Kamphaeng Phet,9,7937,712340,351623,360717,40873,40710,163,,,19/1/2022 7:23
16/11/2021,Khon Kaen,91,24135,1791302,880185,911117,195487,195350,137,82,40,19/1/2022 7:23
16/11/2021,Chanthaburi,83,21053,536572,262310,274262,127398,127173,225,,,19/1/2022 7:23
16/11/2021,Chachoengsao,34,36343,724145,354876,369269,337607,337607,0,52,31,19/1/2022 7:23
16/11/2021,Chon Buri,163,107800,1583412,772344,811068,929255,920898,8357,56,21,19/1/2022 7:23
16/11/2021,Chai Nat,15,2646,320710,154147,166563,44850,44850,0,,,19/1/2022 7:23
16/11/2021,Chaiyaphum,15,11909,1122715,554712,568003,48905,48826,79,,,19/1/2022 7:23
16/11/2021,Chumphon,58,13862,509632,251576,258056,33159,33146,13,,,19/1/2022 7:23
16/11/2021,Trang,162,14292,639941,312807,327134,25842,25842,0,,,19/1/2022 7:23
16/11/2021,Trat,16,8165,228339,112907,115432,106763,104219,2544,,,19/1/2022 7:23
16/11/2021,Tak,95,23779,676105,341755,334350,65113,65113,0,,,19/1/2022 7:23
16/11/2021,Nakhon Nayok,21,11272,260391,128848,131543,170824,170788,36,,,19/1/2022 7:23
16/11/2021,Nakhon Pathom,41,35393,921946,442578,479368,116491,116387,104,100,35,19/1/2022 7:23
16/11/2021,Nakhon Phanom,3,4970,717181,357273,359908,60530,60511,19,,,19/1/2022 7:23
16/11/2021,Nakhon Ratchasima,153,33358,2634154,1293776,1340378,473887,472075,1812,65,33,19/1/2022 7:23
16/11/2021,Nakhon Si Thammarat,260,36115,1549258,764251,785007,22828,22804,24,,,19/1/2022 7:23
16/11/2021,Nakhon Sawan,41,16181,1035583,505021,530562,75335,75110,225,86,40,19/1/2022 7:23
16/11/2021,Nonthaburi,91,67157,1287480,598638,688842,91335,90985,350,58, ,19/1/2022 7:23
16/11/2021,Narathiwat,205,40689,809341,400380,408961,3051,3051,0,24,15,19/1/2022 7:23
16/11/2021,Nan,3,2563,475894,237970,237924,103582,102713,869,,,19/1/2022 7:23
16/11/2021,Bueng Kan,4,2148,422056,211601,210455,13820,13531,289,,,19/1/2022 7:23
16/11/2021,Buri Ram,7,17097,1580074,783823,796251,77399,76979,420,,,19/1/2022 7:23
16/11/2021,Pathum Thani,38,41486,1189186,563353,625833,80926,80630,296,78,27,19/1/2022 7:23
16/11/2021,Prachuap Khiri Khan,62,17749,553198,274111,279087,450266,449376,890,,,19/1/2022 7:23
16/11/2021,Prachin Buri,66,24139,494804,244188,250616,86770,86638,132,62,33,19/1/2022 7:23
16/11/2021,Pattani,326,43662,729331,360142,369189,4532,4532,0,,,19/1/2022 7:23
16/11/2021,Phra Nakhon Si Ayutthaya,57,31707,820637,394133,426504,389058,388198,860,70,56,19/1/2022 7:23
16/11/2021,Phayao,5,2315,464807,226101,238706,52329,51787,542,67,26,19/1/2022 7:23
16/11/2021,Phang-nga,45,5691,268121,133884,134237,57579,43267,14312,,,19/1/2022 7:23
16/11/2021,Phatthalung,95,10826,522562,254456,268106,19880,19880,0,,,19/1/2022 7:23
16/11/2021,Phichit,18,5099,529730,258152,271578,28128,28128,0,,,19/1/2022 7:23
16/11/2021,Phitsanulok,73,7267,847456,414644,432812,147550,147235,315,,,19/1/2022 7:23
16/11/2021,Phuket,50,16429,418939,198000,220939,158721,117533,41188,35,20,19/1/2022 7:23
16/11/2021,Maha Sarakham,3,11038,948760,465243,483517,22566,22530,36,,,19/1/2022 7:23
16/11/2021,Mukdahan,3,2396,351477,175634,175843,91851,91830,21,,,19/1/2022 7:23
16/11/2021,Yala,149,45230,542249,269916,272333,8303,8303,0,47,15,19/1/2022 7:23
16/11/2021,Yasothon,3,5910,533387,266000,267387,11956,11956,0,,,19/1/2022 7:23
16/11/2021,Ranong,2,9766,194713,98257,96456,10718,10686,32,,,19/1/2022 7:23
16/11/2021,Rayong,106,44332,750813,368748,382065,449414,446915,2499,70,22,19/1/2022 7:23
16/11/2021,Ratchaburi,149,39152,868383,421933,446450,156792,156354,438,,,19/1/2022 7:23
16/11/2021,Roi Et,19,13925,1296246,642036,654210,29035,28998,37,,,19/1/2022 7:23
16/11/2021,Lop Buri,44,17387,739079,368209,370870,164681,164569,112,,,19/1/2022 7:23
16/11/2021,Lampang,14,2877,725197,353220,371977,91037,90339,698,77, ,19/1/2022 7:23
16/11/2021,Lamphun,37,3060,401266,192787,208479,66278,65498,780,,,19/1/2022 7:23
16/11/2021,Si Sa Ket,70,17356,1457748,725758,731990,51233,51233,0,,,19/1/2022 7:23
16/11/2021,Sakon Nakhon,4,7762,1146663,569782,576881,101215,101215,0,,,19/1/2022 7:23
16/11/2021,Songkhla,458,56396,1431562,697309,734253,24450,24434,16,47,17,19/1/2022 7:23
16/11/2021,Satun,92,6499,324802,161606,163196,53346,53307,39,27,24,19/1/2022 7:23
16/11/2021,Samut Prakarn,173,129125,1356374,645942,710432,65953,52911,13042,,,19/1/2022 7:23
16/11/2021,Samut Songkhram,5,11777,191049,91232,99817,103736,103736,0,75,25,19/1/2022 7:23
16/11/2021,Samut Sakhon,41,111074,586485,282611,303874,27110,27075,35,87,33,19/1/2022 7:23
16/11/2021,Saraburi,93,32238,643429,315725,327704,213646,213508,138,105,82,19/1/2022 7:23
16/11/2021,Sa kaeo,34,18282,561712,280407,281305,80293,79161,1132,33,19,19/1/2022 7:23
16/11/2021,Sing Buri,20,3216,204758,97261,107497,22448,22402,46,,,19/1/2022 7:23
16/11/2021,Suphan Buri,55,15572,835777,403176,432601,279513,279513,0,,,19/1/2022 7:23
16/11/2021,Surat Thani,189,22042,1072430,527357,545073,31940,27595,4345,18,13,19/1/2022 7:23
16/11/2021,Surin,28,18553,1376669,684750,691919,36906,36878,28,,,19/1/2022 7:23
16/11/2021,Sukhothai,15,6290,585572,283544,302028,59322,58638,684,,,19/1/2022 7:23
16/11/2021,Nong Khai,8,4193,516910,256357,260553,88413,88064,349,20,9,19/1/2022 7:23
16/11/2021,Nong Bua Lam Phu,6,4374,509096,253820,255276,9330,9305,25,,,19/1/2022 7:23
16/11/2021,Amnat Charoen,2,3014,376417,187215,189202,12411,12411,0,,,19/1/2022 7:23
16/11/2021,Udon Thani,81,24082,1566796,775703,791093,112923,112463,460,,,19/1/2022 7:23
16/11/2021,Uttaradit,6,4399,446358,217547,228811,51788,51679,109,,,19/1/2022 7:23
16/11/2021,Uthai Thani,1,3612,325208,158967,166241,33303,33303,0,,,19/1/2022 7:23
16/11/2021,Ubon Ratchathani,65,20856,1868052,932286,935766,119633,119591,42,41,22,19/1/2022 7:23
16/11/2021,Ang Thong,1,11380,275021,131590,143431,28564,28564,0,,,19/1/2022 7:23
16/11/2021,Chiang Rai,32,5008,1298579,631054,667525,266159,265473,686,75,21,19/1/2022 7:23
16/11/2021,Chiang Mai,349,27249,1788986,864222,924764,779417,775914,3503,75,35,19/1/2022 7:23
16/11/2021,Phetchaburi,35,23393,482577,232780,249797,479666,479543,123,,,19/1/2022 7:23
16/11/2021,Phetchabun,41,11474,978573,482421,496152,134305,133818,487,,,19/1/2022 7:23
16/11/2021,Loei,13,4057,638978,320126,318852,126076,125834,242,62,22,19/1/2022 7:23
16/11/2021,Phrae,7,1881,434895,209621,225274,51804,51653,151,70,29,19/1/2022 7:23
16/11/2021,Mae Hong Son,18,2020,285927,144863,141064,73223,71986,1237,59,16,19/1/2022 7:23
16/11/2021,,0,173,,,,,,,,,19/1/2022 7:23
17/11/2021,Krabi,97,9206,479290,238118,241172,49198,48852,346,,,19/1/2022 7:23
17/11/2021,Bangkok,931,442205,5530283,2593687,2936596,1294781,1215564,79217,55,30,19/1/2022 7:23
17/11/2021,Kanchanaburi,58,23165,893747,448009,445738,812418,812043,375,60,31,19/1/2022 7:23
17/11/2021,Kalasin,35,9591,975840,482246,493594,39828,39803,25,,,19/1/2022 7:23
17/11/2021,Kamphaeng Phet,15,7952,712340,351623,360717,40873,40710,163,,,19/1/2022 7:23
17/11/2021,Khon Kaen,116,24251,1791302,880185,911117,195487,195350,137,65,41,19/1/2022 7:23
17/11/2021,Chanthaburi,87,21140,536572,262310,274262,127398,127173,225,,,19/1/2022 7:23
17/11/2021,Chachoengsao,77,36420,724145,354876,369269,337607,337607,0,49,38,19/1/2022 7:23
17/11/2021,Chon Buri,212,108012,1583412,772344,811068,929255,920898,8357,44,24,19/1/2022 7:23
17/11/2021,Chai Nat,17,2663,320710,154147,166563,44850,44850,0,,,19/1/2022 7:23
17/11/2021,Chaiyaphum,25,11934,1122715,554712,568003,48905,48826,79,,,19/1/2022 7:23
17/11/2021,Chumphon,126,13988,509632,251576,258056,33159,33146,13,,,19/1/2022 7:23
17/11/2021,Trang,153,14445,639941,312807,327134,25842,25842,0,,,19/1/2022 7:23
17/11/2021,Trat,70,8235,228339,112907,115432,106763,104219,2544,,,19/1/2022 7:23
17/11/2021,Tak,153,23932,676105,341755,334350,65113,65113,0,,,19/1/2022 7:23
17/11/2021,Nakhon Nayok,25,11297,260391,128848,131543,170824,170788,36,,,19/1/2022 7:23
17/11/2021,Nakhon Pathom,25,35418,921946,442578,479368,116491,116387,104,68,45,19/1/2022 7:23
17/11/2021,Nakhon Phanom,2,4972,717181,357273,359908,60530,60511,19,,,19/1/2022 7:23
17/11/2021,Nakhon Ratchasima,106,33464,2634154,1293776,1340378,473887,472075,1812,63,28,19/1/2022 7:23
17/11/2021,Nakhon Si Thammarat,290,36405,1549258,764251,785007,22828,22804,24,,,19/1/2022 7:23
17/11/2021,Nakhon Sawan,63,16244,1035583,505021,530562,75335,75110,225,77,36,19/1/2022 7:23
17/11/2021,Nonthaburi,92,67249,1287480,598638,688842,91335,90985,350,49, ,19/1/2022 7:23
17/11/2021,Narathiwat,142,40831,809341,400380,408961,3051,3051,0,32,10,19/1/2022 7:23
17/11/2021,Nan,10,2573,475894,237970,237924,103582,102713,869,,,19/1/2022 7:23
17/11/2021,Bueng Kan,2,2150,422056,211601,210455,13820,13531,289,,,19/1/2022 7:23
17/11/2021,Buri Ram,21,17118,1580074,783823,796251,77399,76979,420,,,19/1/2022 7:23
17/11/2021,Pathum Thani,31,41517,1189186,563353,625833,80926,80630,296,50,35,19/1/2022 7:23
17/11/2021,Prachuap Khiri Khan,77,17826,553198,274111,279087,450266,449376,890,,,19/1/2022 7:23
17/11/2021,Prachin Buri,98,24237,494804,244188,250616,86770,86638,132,59,43,19/1/2022 7:23
17/11/2021,Pattani,192,43854,729331,360142,369189,4532,4532,0,,,19/1/2022 7:23
17/11/2021,Phra Nakhon Si Ayutthaya,71,31778,820637,394133,426504,389058,388198,860,65,54,19/1/2022 7:23
17/11/2021,Phayao,8,2323,464807,226101,238706,52329,51787,542,61,30,19/1/2022 7:23
17/11/2021,Phang-nga,66,5757,268121,133884,134237,57579,43267,14312,,,19/1/2022 7:23
17/11/2021,Phatthalung,65,10891,522562,254456,268106,19880,19880,0,,,19/1/2022 7:23
17/11/2021,Phichit,19,5118,529730,258152,271578,28128,28128,0,,,19/1/2022 7:23
17/11/2021,Phitsanulok,95,7362,847456,414644,432812,147550,147235,315,,,19/1/2022 7:23
17/11/2021,Phuket,53,16482,418939,198000,220939,158721,117533,41188,28,17,19/1/2022 7:23
17/11/2021,Maha Sarakham,10,11048,948760,465243,483517,22566,22530,36,,,19/1/2022 7:23
17/11/2021,Mukdahan,8,2404,351477,175634,175843,91851,91830,21,,,19/1/2022 7:23
17/11/2021,Yala,182,45412,542249,269916,272333,8303,8303,0,40,14,19/1/2022 7:23
17/11/2021,Yasothon,4,5914,533387,266000,267387,11956,11956,0,,,19/1/2022 7:23
17/11/2021,Ranong,14,9780,194713,98257,96456,10718,10686,32,,,19/1/2022 7:23
17/11/2021,Rayong,75,44407,750813,368748,382065,449414,446915,2499,50,21,19/1/2022 7:23
17/11/2021,Ratchaburi,152,39304,868383,421933,446450,156792,156354,438,,,19/1/2022 7:23
17/11/2021,Roi Et,2,13927,1296246,642036,654210,29035,28998,37,,,19/1/2022 7:23
17/11/2021,Lop Buri,24,17411,739079,368209,370870,164681,164569,112,,,19/1/2022 7:23
17/11/2021,Lampang,15,2892,725197,353220,371977,91037,90339,698,70, ,19/1/2022 7:23
17/11/2021,Lamphun,40,3100,401266,192787,208479,66278,65498,780,,,19/1/2022 7:23
17/11/2021,Si Sa Ket,76,17432,1457748,725758,731990,51233,51233,0,,,19/1/2022 7:23
17/11/2021,Sakon Nakhon,4,7766,1146663,569782,576881,101215,101215,0,,,19/1/2022 7:23
17/11/2021,Songkhla,430,56826,1431562,697309,734253,24450,24434,16,34,21,19/1/2022 7:23
17/11/2021,Satun,89,6588,324802,161606,163196,53346,53307,39,13,21,19/1/2022 7:23
17/11/2021,Samut Prakarn,262,129387,1356374,645942,710432,65953,52911,13042,,,19/1/2022 7:23
17/11/2021,Samut Songkhram,11,11788,191049,91232,99817,103736,103736,0,57,30,19/1/2022 7:23
17/11/2021,Samut Sakhon,40,111114,586485,282611,303874,27110,27075,35,56,49,19/1/2022 7:23
17/11/2021,Saraburi,90,32328,643429,315725,327704,213646,213508,138,94,70,19/1/2022 7:23
17/11/2021,Sa kaeo,103,18385,561712,280407,281305,80293,79161,1132,36,20,19/1/2022 7:23
17/11/2021,Sing Buri,18,3234,204758,97261,107497,22448,22402,46,,,19/1/2022 7:23
17/11/2021,Suphan Buri,36,15608,835777,403176,432601,279513,279513,0,,,19/1/2022 7:23
17/11/2021,Surat Thani,162,22204,1072430,527357,545073,31940,27595,4345,20,11,19/1/2022 7:23
17/11/2021,Surin,22,18575,1376669,684750,691919,36906,36878,28,,,19/1/2022 7:23
17/11/2021,Sukhothai,19,6309,585572,283544,302028,59322,58638,684,,,19/1/2022 7:23
17/11/2021,Nong Khai,18,4211,516910,256357,260553,88413,88064,349,21,9,19/1/2022 7:23
17/11/2021,Nong Bua Lam Phu,12,4386,509096,253820,255276,9330,9305,25,,,19/1/2022 7:23
17/11/2021,Amnat Charoen,0,3014,376417,187215,189202,12411,12411,0,,,19/1/2022 7:23
17/11/2021,Udon Thani,78,24160,1566796,775703,791093,112923,112463,460,,,19/1/2022 7:23
17/11/2021,Uttaradit,9,4408,446358,217547,228811,51788,51679,109,,,19/1/2022 7:23
17/11/2021,Uthai Thani,3,3615,325208,158967,166241,33303,33303,0,,,19/1/2022 7:23
17/11/2021,Ubon Ratchathani,109,20965,1868052,932286,935766,119633,119591,42,44,20,19/1/2022 7:23
17/11/2021,Ang Thong,0,11380,275021,131590,143431,28564,28564,0,,,19/1/2022 7:23
17/11/2021,Chiang Rai,39,5047,1298579,631054,667525,266159,265473,686,58,23,19/1/2022 7:23
17/11/2021,Chiang Mai,522,27771,1788986,864222,924764,779417,775914,3503,75,36,19/1/2022 7:23
17/11/2021,Phetchaburi,48,23441,482577,232780,249797,479666,479543,123,,,19/1/2022 7:23
17/11/2021,Phetchabun,32,11506,978573,482421,496152,134305,133818,487,,,19/1/2022 7:23
17/11/2021,Loei,12,4069,638978,320126,318852,126076,125834,242,50,18,19/1/2022 7:23
17/11/2021,Phrae,7,1888,434895,209621,225274,51804,51653,151,73,23,19/1/2022 7:23
17/11/2021,Mae Hong Son,22,2042,285927,144863,141064,73223,71986,1237,59,20,19/1/2022 7:23
17/11/2021,,0,173,,,,,,,,,19/1/2022 7:23
18/11/2021,Krabi,84,9290,479290,238118,241172,49198,48852,346,,,19/1/2022 7:23
18/11/2021,Bangkok,910,443115,5530283,2593687,2936596,1294781,1215564,79217,63,35,19/1/2022 7:23
18/11/2021,Kanchanaburi,77,23242,893747,448009,445738,812418,812043,375,55,29,19/1/2022 7:23
18/11/2021,Kalasin,53,9644,975840,482246,493594,39828,39803,25,,,19/1/2022 7:23
18/11/2021,Kamphaeng Phet,20,7972,712340,351623,360717,40873,40710,163,,,19/1/2022 7:23
18/11/2021,Khon Kaen,143,24394,1791302,880185,911117,195487,195350,137,64,39,19/1/2022 7:23
18/11/2021,Chanthaburi,112,21252,536572,262310,274262,127398,127173,225,,,19/1/2022 7:23
18/11/2021,Chachoengsao,56,36476,724145,354876,369269,337607,337607,0,55,38,19/1/2022 7:23
18/11/2021,Chon Buri,205,108217,1583412,772344,811068,929255,920898,8357,52,33,19/1/2022 7:23
18/11/2021,Chai Nat,4,2667,320710,154147,166563,44850,44850,0,,,19/1/2022 7:23
18/11/2021,Chaiyaphum,19,11953,1122715,554712,568003,48905,48826,79,,,19/1/2022 7:23
18/11/2021,Chumphon,66,14054,509632,251576,258056,33159,33146,13,,,19/1/2022 7:23
18/11/2021,Trang,140,14585,639941,312807,327134,25842,25842,0,,,19/1/2022 7:23
18/11/2021,Trat,45,8280,228339,112907,115432,106763,104219,2544,,,19/1/2022 7:23
18/11/2021,Tak,152,24084,676105,341755,334350,65113,65113,0,,,19/1/2022 7:23
18/11/2021,Nakhon Nayok,18,11315,260391,128848,131543,170824,170788,36,,,19/1/2022 7:23
18/11/2021,Nakhon Pathom,74,35492,921946,442578,479368,116491,116387,104,79,46,19/1/2022 7:23
18/11/2021,Nakhon Phanom,3,4975,717181,357273,359908,60530,60511,19,,,19/1/2022 7:23
18/11/2021,Nakhon Ratchasima,91,33555,2634154,1293776,1340378,473887,472075,1812,58,28,19/1/2022 7:23
18/11/2021,Nakhon Si Thammarat,412,36817,1549258,764251,785007,22828,22804,24,,,19/1/2022 7:23
18/11/2021,Nakhon Sawan,26,16270,1035583,505021,530562,75335,75110,225,71,34,19/1/2022 7:23
18/11/2021,Nonthaburi,88,67337,1287480,598638,688842,91335,90985,350,55, ,19/1/2022 7:23
18/11/2021,Narathiwat,149,40980,809341,400380,408961,3051,3051,0,30,15,19/1/2022 7:23
18/11/2021,Nan,9,2582,475894,237970,237924,103582,102713,869,,,19/1/2022 7:23
18/11/2021,Bueng Kan,1,2151,422056,211601,210455,13820,13531,289,,,19/1/2022 7:23
18/11/2021,Buri Ram,23,17141,1580074,783823,796251,77399,76979,420,,,19/1/2022 7:23
18/11/2021,Pathum Thani,55,41572,1189186,563353,625833,80926,80630,296,60,41,19/1/2022 7:23
18/11/2021,Prachuap Khiri Khan,104,17930,553198,274111,279087,450266,449376,890,,,19/1/2022 7:23
18/11/2021,Prachin Buri,103,24340,494804,244188,250616,86770,86638,132,78,36,19/1/2022 7:23
18/11/2021,Pattani,201,44055,729331,360142,369189,4532,4532,0,,,19/1/2022 7:23
18/11/2021,Phra Nakhon Si Ayutthaya,73,31851,820637,394133,426504,389058,388198,860,62,52,19/1/2022 7:23
18/11/2021,Phayao,25,2348,464807,226101,238706,52329,51787,542,63,27,19/1/2022 7:23
18/11/2021,Phang-nga,71,5828,268121,133884,134237,57579,43267,14312,,,19/1/2022 7:23
18/11/2021,Phatthalung,97,10988,522562,254456,268106,19880,19880,0,,,19/1/2022 7:23
18/11/2021,Phichit,23,5141,529730,258152,271578,28128,28128,0,,,19/1/2022 7:23
18/11/2021,Phitsanulok,90,7452,847456,414644,432812,147550,147235,315,,,19/1/2022 7:23
18/11/2021,Phuket,70,16552,418939,198000,220939,158721,117533,41188,24,20,19/1/2022 7:23
18/11/2021,Maha Sarakham,1,11049,948760,465243,483517,22566,22530,36,,,19/1/2022 7:23
18/11/2021,Mukdahan,3,2407,351477,175634,175843,91851,91830,21,,,19/1/2022 7:23
18/11/2021,Yala,214,45626,542249,269916,272333,8303,8303,0,32,17,19/1/2022 7:23
18/11/2021,Yasothon,6,5920,533387,266000,267387,11956,11956,0,,,19/1/2022 7:23
18/11/2021,Ranong,5,9785,194713,98257,96456,10718,10686,32,,,19/1/2022 7:23
18/11/2021,Rayong,150,44557,750813,368748,382065,449414,446915,2499,54,22,19/1/2022 7:23
18/11/2021,Ratchaburi,137,39441,868383,421933,446450,156792,156354,438,,,19/1/2022 7:23
18/11/2021,Roi Et,20,13947,1296246,642036,654210,29035,28998,37,,,19/1/2022 7:23
18/11/2021,Lop Buri,49,17460,739079,368209,370870,164681,164569,112,,,19/1/2022 7:23
18/11/2021,Lampang,37,2929,725197,353220,371977,91037,90339,698,67, ,19/1/2022 7:23
18/11/2021,Lamphun,35,3135,401266,192787,208479,66278,65498,780,,,19/1/2022 7:23
18/11/2021,Si Sa Ket,83,17515,1457748,725758,731990,51233,51233,0,,,19/1/2022 7:23
18/11/2021,Sakon Nakhon,4,7770,1146663,569782,576881,101215,101215,0,,,19/1/2022 7:23
18/11/2021,Songkhla,592,57418,1431562,697309,734253,24450,24434,16,41,26,19/1/2022 7:23
18/11/2021,Satun,86,6674,324802,161606,163196,53346,53307,39,17,24,19/1/2022 7:23
18/11/2021,Samut Prakarn,188,129575,1356374,645942,710432,65953,52911,13042,,,19/1/2022 7:23
18/11/2021,Samut Songkhram,8,11796,191049,91232,99817,103736,103736,0,64,26,19/1/2022 7:23
18/11/2021,Samut Sakhon,35,111149,586485,282611,303874,27110,27075,35,80,64,19/1/2022 7:23
18/11/2021,Saraburi,85,32413,643429,315725,327704,213646,213508,138,82,70,19/1/2022 7:23
18/11/2021,Sa kaeo,94,18479,561712,280407,281305,80293,79161,1132,39,22,19/1/2022 7:23
18/11/2021,Sing Buri,22,3256,204758,97261,107497,22448,22402,46,,,19/1/2022 7:23
18/11/2021,Suphan Buri,75,15683,835777,403176,432601,279513,279513,0,,,19/1/2022 7:23
18/11/2021,Surat Thani,201,22405,1072430,527357,545073,31940,27595,4345,19,10,19/1/2022 7:23
18/11/2021,Surin,36,18611,1376669,684750,691919,36906,36878,28,,,19/1/2022 7:23
18/11/2021,Sukhothai,16,6325,585572,283544,302028,59322,58638,684,,,19/1/2022 7:23
18/11/2021,Nong Khai,18,4229,516910,256357,260553,88413,88064,349,21,8,19/1/2022 7:23
18/11/2021,Nong Bua Lam Phu,21,4407,509096,253820,255276,9330,9305,25,,,19/1/2022 7:23
18/11/2021,Amnat Charoen,5,3019,376417,187215,189202,12411,12411,0,,,19/1/2022 7:23
18/11/2021,Udon Thani,71,24231,1566796,775703,791093,112923,112463,460,,,19/1/2022 7:23
18/11/2021,Uttaradit,7,4415,446358,217547,228811,51788,51679,109,,,19/1/2022 7:23
18/11/2021,Uthai Thani,30,3645,325208,158967,166241,33303,33303,0,,,19/1/2022 7:23
18/11/2021,Ubon Ratchathani,126,21091,1868052,932286,935766,119633,119591,42,31,22,19/1/2022 7:23
18/11/2021,Ang Thong,15,11395,275021,131590,143431,28564,28564,0,,,19/1/2022 7:23
18/11/2021,Chiang Rai,36,5083,1298579,631054,667525,266159,265473,686,61,22,19/1/2022 7:23
18/11/2021,Chiang Mai,280,28051,1788986,864222,924764,779417,775914,3503,77,38,19/1/2022 7:23
18/11/2021,Phetchaburi,75,23516,482577,232780,249797,479666,479543,123,,,19/1/2022 7:23
18/11/2021,Phetchabun,105,11611,978573,482421,496152,134305,133818,487,,,19/1/2022 7:23
18/11/2021,Loei,5,4074,638978,320126,318852,126076,125834,242,40,18,19/1/2022 7:23
18/11/2021,Phrae,8,1896,434895,209621,225274,51804,51653,151,60,28,19/1/2022 7:23
18/11/2021,Mae Hong Son,25,2067,285927,144863,141064,73223,71986,1237,67,16,19/1/2022 7:23
18/11/2021,,0,173,,,,,,,,,19/1/2022 7:23
19/11/2021,Krabi,86,9376,479290,238118,241172,49198,48852,346,,,19/1/2022 7:23
19/11/2021,Bangkok,811,443926,5530283,2593687,2936596,1294781,1215564,79217,70,39,19/1/2022 7:23
19/11/2021,Kanchanaburi,47,23289,893747,448009,445738,812418,812043,375,59,30,19/1/2022 7:23
19/11/2021,Kalasin,24,9668,975840,482246,493594,39828,39803,25,,,19/1/2022 7:23
19/11/2021,Kamphaeng Phet,23,7995,712340,351623,360717,40873,40710,163,,,19/1/2022 7:23
19/11/2021,Khon Kaen,111,24505,1791302,880185,911117,195487,195350,137,62,54,19/1/2022 7:23
19/11/2021,Chanthaburi,112,21364,536572,262310,274262,127398,127173,225,,,19/1/2022 7:23
19/11/2021,Chachoengsao,88,36564,724145,354876,369269,337607,337607,0,58,58,19/1/2022 7:23
19/11/2021,Chon Buri,224,108441,1583412,772344,811068,929255,920898,8357,56,33,19/1/2022 7:23
19/11/2021,Chai Nat,12,2679,320710,154147,166563,44850,44850,0,,,19/1/2022 7:23
19/11/2021,Chaiyaphum,19,11972,1122715,554712,568003,48905,48826,79,,,19/1/2022 7:23
19/11/2021,Chumphon,113,14167,509632,251576,258056,33159,33146,13,,,19/1/2022 7:23
19/11/2021,Trang,124,14709,639941,312807,327134,25842,25842,0,,,19/1/2022 7:23
19/11/2021,Trat,40,8320,228339,112907,115432,106763,104219,2544,,,19/1/2022 7:23
19/11/2021,Tak,97,24181,676105,341755,334350,65113,65113,0,,,19/1/2022 7:23
19/11/2021,Nakhon Nayok,18,11333,260391,128848,131543,170824,170788,36,,,19/1/2022 7:23
19/11/2021,Nakhon Pathom,56,35548,921946,442578,479368,116491,116387,104,94,38,19/1/2022 7:23
19/11/2021,Nakhon Phanom,7,4982,717181,357273,359908,60530,60511,19,,,19/1/2022 7:23
19/11/2021,Nakhon Ratchasima,105,33660,2634154,1293776,1340378,473887,472075,1812,54,40,19/1/2022 7:23
19/11/2021,Nakhon Si Thammarat,426,37243,1549258,764251,785007,22828,22804,24,,,19/1/2022 7:23
19/11/2021,Nakhon Sawan,64,16334,1035583,505021,530562,75335,75110,225,69,117,19/1/2022 7:23
19/11/2021,Nonthaburi,98,67435,1287480,598638,688842,91335,90985,350,51, ,19/1/2022 7:23
19/11/2021,Narathiwat,129,41109,809341,400380,408961,3051,3051,0,39,17,19/1/2022 7:23
19/11/2021,Nan,8,2590,475894,237970,237924,103582,102713,869,,,19/1/2022 7:23
19/11/2021,Bueng Kan,7,2158,422056,211601,210455,13820,13531,289,,,19/1/2022 7:23
19/11/2021,Buri Ram,7,17148,1580074,783823,796251,77399,76979,420,,,19/1/2022 7:23
19/11/2021,Pathum Thani,48,41620,1189186,563353,625833,80926,80630,296,70,42,19/1/2022 7:23
19/11/2021,Prachuap Khiri Khan,75,18005,553198,274111,279087,450266,449376,890,,,19/1/2022 7:23
19/11/2021,Prachin Buri,70,24410,494804,244188,250616,86770,86638,132,60,38,19/1/2022 7:23
19/11/2021,Pattani,224,44279,729331,360142,369189,4532,4532,0,,,19/1/2022 7:23
19/11/2021,Phra Nakhon Si Ayutthaya,91,31942,820637,394133,426504,389058,388198,860,66,56,19/1/2022 7:23
19/11/2021,Phayao,14,2362,464807,226101,238706,52329,51787,542,58,24,19/1/2022 7:23
19/11/2021,Phang-nga,70,5898,268121,133884,134237,57579,43267,14312,,,19/1/2022 7:23
19/11/2021,Phatthalung,107,11095,522562,254456,268106,19880,19880,0,,,19/1/2022 7:23
19/11/2021,Phichit,22,5163,529730,258152,271578,28128,28128,0,,,19/1/2022 7:23
19/11/2021,Phitsanulok,47,7499,847456,414644,432812,147550,147235,315,,,19/1/2022 7:23
19/11/2021,Phuket,74,16626,418939,198000,220939,158721,117533,41188,23,19,19/1/2022 7:23
19/11/2021,Maha Sarakham,2,11051,948760,465243,483517,22566,22530,36,,,19/1/2022 7:23
19/11/2021,Mukdahan,0,2407,351477,175634,175843,91851,91830,21,,,19/1/2022 7:23
19/11/2021,Yala,169,45795,542249,269916,272333,8303,8303,0,39,17,19/1/2022 7:23
19/11/2021,Yasothon,3,5923,533387,266000,267387,11956,11956,0,,,19/1/2022 7:23
19/11/2021,Ranong,6,9791,194713,98257,96456,10718,10686,32,,,19/1/2022 7:23
19/11/2021,Rayong,87,44644,750813,368748,382065,449414,446915,2499,54,33,19/1/2022 7:23
19/11/2021,Ratchaburi,221,39662,868383,421933,446450,156792,156354,438,,,19/1/2022 7:23
19/11/2021,Roi Et,22,13969,1296246,642036,654210,29035,28998,37,,,19/1/2022 7:23
19/11/2021,Lop Buri,44,17504,739079,368209,370870,164681,164569,112,,,19/1/2022 7:23
19/11/2021,Lampang,10,2939,725197,353220,371977,91037,90339,698,67, ,19/1/2022 7:23
19/11/2021,Lamphun,61,3196,401266,192787,208479,66278,65498,780,,,19/1/2022 7:23
19/11/2021,Si Sa Ket,99,17614,1457748,725758,731990,51233,51233,0,,,19/1/2022 7:23
19/11/2021,Sakon Nakhon,5,7775,1146663,569782,576881,101215,101215,0,,,19/1/2022 7:23
19/11/2021,Songkhla,681,58099,1431562,697309,734253,24450,24434,16,49,29,19/1/2022 7:23
19/11/2021,Satun,85,6759,324802,161606,163196,53346,53307,39,17,25,19/1/2022 7:23
19/11/2021,Samut Prakarn,234,129809,1356374,645942,710432,65953,52911,13042,,,19/1/2022 7:23
19/11/2021,Samut Songkhram,9,11805,191049,91232,99817,103736,103736,0,61,23,19/1/2022 7:23
19/11/2021,Samut Sakhon,58,111207,586485,282611,303874,27110,27075,35,113,62,19/1/2022 7:23
19/11/2021,Saraburi,90,32503,643429,315725,327704,213646,213508,138,90,91,19/1/2022 7:23
19/11/2021,Sa kaeo,86,18565,561712,280407,281305,80293,79161,1132,36,26,19/1/2022 7:23
19/11/2021,Sing Buri,19,3275,204758,97261,107497,22448,22402,46,,,19/1/2022 7:23
19/11/2021,Suphan Buri,42,15725,835777,403176,432601,279513,279513,0,,,19/1/2022 7:23
19/11/2021,Surat Thani,233,22638,1072430,527357,545073,31940,27595,4345,22,12,19/1/2022 7:23
19/11/2021,Surin,70,18681,1376669,684750,691919,36906,36878,28,,,19/1/2022 7:23
19/11/2021,Sukhothai,10,6335,585572,283544,302028,59322,58638,684,,,19/1/2022 7:23
19/11/2021,Nong Khai,12,4241,516910,256357,260553,88413,88064,349,20,7,19/1/2022 7:23
19/11/2021,Nong Bua Lam Phu,52,4459,509096,253820,255276,9330,9305,25,,,19/1/2022 7:23
19/11/2021,Amnat Charoen,12,3031,376417,187215,189202,12411,12411,0,,,19/1/2022 7:23
19/11/2021,Udon Thani,71,24302,1566796,775703,791093,112923,112463,460,,,19/1/2022 7:23
19/11/2021,Uttaradit,9,4424,446358,217547,228811,51788,51679,109,,,19/1/2022 7:23
19/11/2021,Uthai Thani,11,3656,325208,158967,166241,33303,33303,0,,,19/1/2022 7:23
19/11/2021,Ubon Ratchathani,140,21231,1868052,932286,935766,119633,119591,42,42,33,19/1/2022 7:23
19/11/2021,Ang Thong,4,11399,275021,131590,143431,28564,28564,0,,,19/1/2022 7:23
19/11/2021,Chiang Rai,48,5131,1298579,631054,667525,266159,265473,686,59,19,19/1/2022 7:23
19/11/2021,Chiang Mai,277,28328,1788986,864222,924764,779417,775914,3503,84,35,19/1/2022 7:23
19/11/2021,Phetchaburi,56,23572,482577,232780,249797,479666,479543,123,,,19/1/2022 7:23
19/11/2021,Phetchabun,66,11677,978573,482421,496152,134305,133818,487,,,19/1/2022 7:23
19/11/2021,Loei,14,4088,638978,320126,318852,126076,125834,242,41,22,19/1/2022 7:23
19/11/2021,Phrae,9,1905,434895,209621,225274,51804,51653,151,63,26,19/1/2022 7:23
19/11/2021,Mae Hong Son,30,2097,285927,144863,141064,73223,71986,1237,58,12,19/1/2022 7:23
19/11/2021,,0,173,,,,,,,,,19/1/2022 7:23
20/11/2021,Krabi,88,9464,479290,238118,241172,49198,48852,346,,,19/1/2022 7:23
20/11/2021,Bangkok,842,444768,5530283,2593687,2936596,1294781,1215564,79217,79,40,19/1/2022 7:23
20/11/2021,Kanchanaburi,60,23349,893747,448009,445738,812418,812043,375,65,28,19/1/2022 7:23
20/11/2021,Kalasin,22,9690,975840,482246,493594,39828,39803,25,,,19/1/2022 7:23
20/11/2021,Kamphaeng Phet,18,8013,712340,351623,360717,40873,40710,163,,,19/1/2022 7:23
20/11/2021,Khon Kaen,130,24635,1791302,880185,911117,195487,195350,137,94,58,19/1/2022 7:23
20/11/2021,Chanthaburi,105,21469,536572,262310,274262,127398,127173,225,,,19/1/2022 7:23
20/11/2021,Chachoengsao,96,36660,724145,354876,369269,337607,337607,0,98,51,19/1/2022 7:23
20/11/2021,Chon Buri,182,108623,1583412,772344,811068,929255,920898,8357,62,37,19/1/2022 7:23
20/11/2021,Chai Nat,7,2686,320710,154147,166563,44850,44850,0,,,19/1/2022 7:23
20/11/2021,Chaiyaphum,30,12002,1122715,554712,568003,48905,48826,79,,,19/1/2022 7:23
20/11/2021,Chumphon,90,14257,509632,251576,258056,33159,33146,13,,,19/1/2022 7:23
20/11/2021,Trang,136,14845,639941,312807,327134,25842,25842,0,,,19/1/2022 7:23
20/11/2021,Trat,66,8386,228339,112907,115432,106763,104219,2544,,,19/1/2022 7:23
20/11/2021,Tak,93,24274,676105,341755,334350,65113,65113,0,,,19/1/2022 7:23
20/11/2021,Nakhon Nayok,27,11360,260391,128848,131543,170824,170788,36,,,19/1/2022 7:23
20/11/2021,Nakhon Pathom,61,35609,921946,442578,479368,116491,116387,104,72,41,19/1/2022 7:23
20/11/2021,Nakhon Phanom,2,4984,717181,357273,359908,60530,60511,19,,,19/1/2022 7:23
20/11/2021,Nakhon Ratchasima,107,33767,2634154,1293776,1340378,473887,472075,1812,71,40,19/1/2022 7:23
20/11/2021,Nakhon Si Thammarat,394,37637,1549258,764251,785007,22828,22804,24,,,19/1/2022 7:23
20/11/2021,Nakhon Sawan,41,16375,1035583,505021,530562,75335,75110,225,133,39,19/1/2022 7:23
20/11/2021,Nonthaburi,85,67520,1287480,598638,688842,91335,90985,350,65, ,19/1/2022 7:23
20/11/2021,Narathiwat,131,41240,809341,400380,408961,3051,3051,0,44,22,19/1/2022 7:23
20/11/2021,Nan,3,2593,475894,237970,237924,103582,102713,869,,,19/1/2022 7:23
20/11/2021,Bueng Kan,13,2171,422056,211601,210455,13820,13531,289,,,19/1/2022 7:23
20/11/2021,Buri Ram,10,17158,1580074,783823,796251,77399,76979,420,,,19/1/2022 7:23
20/11/2021,Pathum Thani,66,41686,1189186,563353,625833,80926,80630,296,82,51,19/1/2022 7:23
20/11/2021,Prachuap Khiri Khan,81,18086,553198,274111,279087,450266,449376,890,,,19/1/2022 7:23
20/11/2021,Prachin Buri,83,24493,494804,244188,250616,86770,86638,132,69,40,19/1/2022 7:23
20/11/2021,Pattani,224,44503,729331,360142,369189,4532,4532,0,,,19/1/2022 7:23
20/11/2021,Phra Nakhon Si Ayutthaya,93,32035,820637,394133,426504,389058,388198,860,74,59,19/1/2022 7:23
20/11/2021,Phayao,81,2443,464807,226101,238706,52329,51787,542,56,26,19/1/2022 7:23
20/11/2021,Phang-nga,53,5951,268121,133884,134237,57579,43267,14312,,,19/1/2022 7:23
20/11/2021,Phatthalung,64,11159,522562,254456,268106,19880,19880,0,,,19/1/2022 7:23
20/11/2021,Phichit,24,5187,529730,258152,271578,28128,28128,0,,,19/1/2022 7:23
20/11/2021,Phitsanulok,60,7559,847456,414644,432812,147550,147235,315,,,19/1/2022 7:23
20/11/2021,Phuket,65,16691,418939,198000,220939,158721,117533,41188,22,24,19/1/2022 7:23
20/11/2021,Maha Sarakham,3,11054,948760,465243,483517,22566,22530,36,,,19/1/2022 7:23
20/11/2021,Mukdahan,0,2407,351477,175634,175843,91851,91830,21,,,19/1/2022 7:23
20/11/2021,Yala,151,45946,542249,269916,272333,8303,8303,0,40,21,19/1/2022 7:23
20/11/2021,Yasothon,6,5929,533387,266000,267387,11956,11956,0,,,19/1/2022 7:23
20/11/2021,Ranong,9,9800,194713,98257,96456,10718,10686,32,,,19/1/2022 7:23
20/11/2021,Rayong,81,44725,750813,368748,382065,449414,446915,2499,66,25,19/1/2022 7:23
20/11/2021,Ratchaburi,133,39795,868383,421933,446450,156792,156354,438,,,19/1/2022 7:23
20/11/2021,Roi Et,14,13983,1296246,642036,654210,29035,28998,37,,,19/1/2022 7:23
20/11/2021,Lop Buri,68,17572,739079,368209,370870,164681,164569,112,,,19/1/2022 7:23
20/11/2021,Lampang,13,2952,725197,353220,371977,91037,90339,698,69, ,19/1/2022 7:23
20/11/2021,Lamphun,36,3232,401266,192787,208479,66278,65498,780,,,19/1/2022 7:23
20/11/2021,Si Sa Ket,32,17646,1457748,725758,731990,51233,51233,0,,,19/1/2022 7:23
20/11/2021,Sakon Nakhon,3,7778,1146663,569782,576881,101215,101215,0,,,19/1/2022 7:23
20/11/2021,Songkhla,562,58661,1431562,697309,734253,24450,24434,16,55,31,19/1/2022 7:23
20/11/2021,Satun,88,6847,324802,161606,163196,53346,53307,39,16,25,19/1/2022 7:23
20/11/2021,Samut Prakarn,232,130041,1356374,645942,710432,65953,52911,13042,,,19/1/2022 7:23
20/11/2021,Samut Songkhram,14,11819,191049,91232,99817,103736,103736,0,58,20,19/1/2022 7:23
20/11/2021,Samut Sakhon,50,111257,586485,282611,303874,27110,27075,35,110,53,19/1/2022 7:23
20/11/2021,Saraburi,89,32592,643429,315725,327704,213646,213508,138,110,86,19/1/2022 7:23
20/11/2021,Sa kaeo,67,18632,561712,280407,281305,80293,79161,1132,49,26,19/1/2022 7:23
20/11/2021,Sing Buri,31,3306,204758,97261,107497,22448,22402,46,,,19/1/2022 7:23
20/11/2021,Suphan Buri,46,15771,835777,403176,432601,279513,279513,0,,,19/1/2022 7:23
20/11/2021,Surat Thani,233,22871,1072430,527357,545073,31940,27595,4345,35,18,19/1/2022 7:23
20/11/2021,Surin,28,18709,1376669,684750,691919,36906,36878,28,,,19/1/2022 7:23
20/11/2021,Sukhothai,26,6361,585572,283544,302028,59322,58638,684,,,19/1/2022 7:23
20/11/2021,Nong Khai,12,4253,516910,256357,260553,88413,88064,349,19,7,19/1/2022 7:23
20/11/2021,Nong Bua Lam Phu,21,4480,509096,253820,255276,9330,9305,25,,,19/1/2022 7:23
20/11/2021,Amnat Charoen,0,3031,376417,187215,189202,12411,12411,0,,,19/1/2022 7:23
20/11/2021,Udon Thani,73,24375,1566796,775703,791093,112923,112463,460,,,19/1/2022 7:23
20/11/2021,Uttaradit,11,4435,446358,217547,228811,51788,51679,109,,,19/1/2022 7:23
20/11/2021,Uthai Thani,20,3676,325208,158967,166241,33303,33303,0,,,19/1/2022 7:23
20/11/2021,Ubon Ratchathani,114,21345,1868052,932286,935766,119633,119591,42,62,29,19/1/2022 7:23
20/11/2021,Ang Thong,13,11412,275021,131590,143431,28564,28564,0,,,19/1/2022 7:23
20/11/2021,Chiang Rai,48,5179,1298579,631054,667525,266159,265473,686,51,18,19/1/2022 7:23
20/11/2021,Chiang Mai,350,28678,1788986,864222,924764,779417,775914,3503,79,26,19/1/2022 7:23
20/11/2021,Phetchaburi,30,23602,482577,232780,249797,479666,479543,123,,,19/1/2022 7:23
20/11/2021,Phetchabun,87,11764,978573,482421,496152,134305,133818,487,,,19/1/2022 7:23
20/11/2021,Loei,13,4101,638978,320126,318852,126076,125834,242,48,26,19/1/2022 7:23
20/11/2021,Phrae,10,1915,434895,209621,225274,51804,51653,151,66,26,19/1/2022 7:23
20/11/2021,Mae Hong Son,45,2142,285927,144863,141064,73223,71986,1237,45,11,19/1/2022 7:23
20/11/2021,,0,173,,,,,,,,,19/1/2022 7:23
21/11/2021,Krabi,92,9556,479290,238118,241172,49198,48852,346,,,19/1/2022 7:23
21/11/2021,Bangkok,780,445548,5530283,2593687,2936596,1294781,1215564,79217,79,41,19/1/2022 7:23
21/11/2021,Kanchanaburi,70,23419,893747,448009,445738,812418,812043,375,59,27,19/1/2022 7:23
21/11/2021,Kalasin,25,9715,975840,482246,493594,39828,39803,25,,,19/1/2022 7:23
21/11/2021,Kamphaeng Phet,19,8032,712340,351623,360717,40873,40710,163,,,19/1/2022 7:23
21/11/2021,Khon Kaen,122,24757,1791302,880185,911117,195487,195350,137,110,48,19/1/2022 7:23
21/11/2021,Chanthaburi,87,21556,536572,262310,274262,127398,127173,225,,,19/1/2022 7:23
21/11/2021,Chachoengsao,65,36725,724145,354876,369269,337607,337607,0,103,46,19/1/2022 7:23
21/11/2021,Chon Buri,191,108814,1583412,772344,811068,929255,920898,8357,70,41,19/1/2022 7:23
21/11/2021,Chai Nat,6,2692,320710,154147,166563,44850,44850,0,,,19/1/2022 7:23
21/11/2021,Chaiyaphum,15,12017,1122715,554712,568003,48905,48826,79,,,19/1/2022 7:23
21/11/2021,Chumphon,109,14366,509632,251576,258056,33159,33146,13,,,19/1/2022 7:23
21/11/2021,Trang,139,14984,639941,312807,327134,25842,25842,0,,,19/1/2022 7:23
21/11/2021,Trat,60,8446,228339,112907,115432,106763,104219,2544,,,19/1/2022 7:23
21/11/2021,Tak,90,24364,676105,341755,334350,65113,65113,0,,,19/1/2022 7:23
21/11/2021,Nakhon Nayok,17,11377,260391,128848,131543,170824,170788,36,,,19/1/2022 7:23
21/11/2021,Nakhon Pathom,43,35652,921946,442578,479368,116491,116387,104,81,57,19/1/2022 7:23
21/11/2021,Nakhon Phanom,1,4985,717181,357273,359908,60530,60511,19,,,19/1/2022 7:23
21/11/2021,Nakhon Ratchasima,96,33863,2634154,1293776,1340378,473887,472075,1812,75,38,19/1/2022 7:23
21/11/2021,Nakhon Si Thammarat,427,38064,1549258,764251,785007,22828,22804,24,,,19/1/2022 7:23
21/11/2021,Nakhon Sawan,46,16421,1035583,505021,530562,75335,75110,225,87,35,19/1/2022 7:23
21/11/2021,Nonthaburi,108,67628,1287480,598638,688842,91335,90985,350,80, ,19/1/2022 7:23
21/11/2021,Narathiwat,108,41348,809341,400380,408961,3051,3051,0,54,18,19/1/2022 7:23
21/11/2021,Nan,9,2602,475894,237970,237924,103582,102713,869,,,19/1/2022 7:23
21/11/2021,Bueng Kan,12,2183,422056,211601,210455,13820,13531,289,,,19/1/2022 7:23
21/11/2021,Buri Ram,11,17169,1580074,783823,796251,77399,76979,420,,,19/1/2022 7:23
21/11/2021,Pathum Thani,40,41726,1189186,563353,625833,80926,80630,296,101,34,19/1/2022 7:23
21/11/2021,Prachuap Khiri Khan,74,18160,553198,274111,279087,450266,449376,890,,,19/1/2022 7:23
21/11/2021,Prachin Buri,89,24582,494804,244188,250616,86770,86638,132,71,39,19/1/2022 7:23
21/11/2021,Pattani,257,44760,729331,360142,369189,4532,4532,0,,,19/1/2022 7:23
21/11/2021,Phra Nakhon Si Ayutthaya,62,32097,820637,394133,426504,389058,388198,860,86,50,19/1/2022 7:23
21/11/2021,Phayao,8,2451,464807,226101,238706,52329,51787,542,61,31,19/1/2022 7:23
21/11/2021,Phang-nga,66,6017,268121,133884,134237,57579,43267,14312,,,19/1/2022 7:23
21/11/2021,Phatthalung,80,11239,522562,254456,268106,19880,19880,0,,,19/1/2022 7:23
21/11/2021,Phichit,14,5201,529730,258152,271578,28128,28128,0,,,19/1/2022 7:23
21/11/2021,Phitsanulok,55,7614,847456,414644,432812,147550,147235,315,,,19/1/2022 7:23
21/11/2021,Phuket,65,16756,418939,198000,220939,158721,117533,41188,37,26,19/1/2022 7:23
21/11/2021,Maha Sarakham,22,11076,948760,465243,483517,22566,22530,36,,,19/1/2022 7:23
21/11/2021,Mukdahan,1,2408,351477,175634,175843,91851,91830,21,,,19/1/2022 7:23
21/11/2021,Yala,174,46120,542249,269916,272333,8303,8303,0,47,26,19/1/2022 7:23
21/11/2021,Yasothon,1,5930,533387,266000,267387,11956,11956,0,,,19/1/2022 7:23
21/11/2021,Ranong,6,9806,194713,98257,96456,10718,10686,32,,,19/1/2022 7:23
21/11/2021,Rayong,128,44853,750813,368748,382065,449414,446915,2499,61,40,19/1/2022 7:23
21/11/2021,Ratchaburi,693,40488,868383,421933,446450,156792,156354,438,,,19/1/2022 7:23
21/11/2021,Roi Et,26,14009,1296246,642036,654210,29035,28998,37,,,19/1/2022 7:23
21/11/2021,Lop Buri,53,17625,739079,368209,370870,164681,164569,112,,,19/1/2022 7:23
21/11/2021,Lampang,16,2968,725197,353220,371977,91037,90339,698,66, ,19/1/2022 7:23
21/11/2021,Lamphun,28,3260,401266,192787,208479,66278,65498,780,,,19/1/2022 7:23
21/11/2021,Si Sa Ket,77,17723,1457748,725758,731990,51233,51233,0,,,19/1/2022 7:23
21/11/2021,Sakon Nakhon,10,7788,1146663,569782,576881,101215,101215,0,,,19/1/2022 7:23
21/11/2021,Songkhla,550,59211,1431562,697309,734253,24450,24434,16,62,24,19/1/2022 7:23
21/11/2021,Satun,83,6930,324802,161606,163196,53346,53307,39,18,31,19/1/2022 7:23
21/11/2021,Samut Prakarn,256,130297,1356374,645942,710432,65953,52911,13042,,,19/1/2022 7:23
21/11/2021,Samut Songkhram,9,11828,191049,91232,99817,103736,103736,0,52,14,19/1/2022 7:23
21/11/2021,Samut Sakhon,66,111323,586485,282611,303874,27110,27075,35,97,54,19/1/2022 7:23
21/11/2021,Saraburi,85,32677,643429,315725,327704,213646,213508,138,131,98,19/1/2022 7:23
21/11/2021,Sa kaeo,64,18696,561712,280407,281305,80293,79161,1132,51,26,19/1/2022 7:23
21/11/2021,Sing Buri,21,3327,204758,97261,107497,22448,22402,46,,,19/1/2022 7:23
21/11/2021,Suphan Buri,63,15834,835777,403176,432601,279513,279513,0,,,19/1/2022 7:23
21/11/2021,Surat Thani,283,23154,1072430,527357,545073,31940,27595,4345,50,20,19/1/2022 7:23
21/11/2021,Surin,23,18732,1376669,684750,691919,36906,36878,28,,,19/1/2022 7:23
21/11/2021,Sukhothai,11,6372,585572,283544,302028,59322,58638,684,,,19/1/2022 7:23
21/11/2021,Nong Khai,24,4277,516910,256357,260553,88413,88064,349,17,7,19/1/2022 7:23
21/11/2021,Nong Bua Lam Phu,4,4484,509096,253820,255276,9330,9305,25,,,19/1/2022 7:23
21/11/2021,Amnat Charoen,1,3032,376417,187215,189202,12411,12411,0,,,19/1/2022 7:23
21/11/2021,Udon Thani,59,24434,1566796,775703,791093,112923,112463,460,,,19/1/2022 7:23
21/11/2021,Uttaradit,3,4438,446358,217547,228811,51788,51679,109,,,19/1/2022 7:23
21/11/2021,Uthai Thani,34,3710,325208,158967,166241,33303,33303,0,,,19/1/2022 7:23
21/11/2021,Ubon Ratchathani,131,21476,1868052,932286,935766,119633,119591,42,59,26,19/1/2022 7:23
21/11/2021,Ang Thong,7,11419,275021,131590,143431,28564,28564,0,,,19/1/2022 7:23
21/11/2021,Chiang Rai,35,5214,1298579,631054,667525,266159,265473,686,51,22,19/1/2022 7:23
21/11/2021,Chiang Mai,244,28922,1788986,864222,924764,779417,775914,3503,60,33,19/1/2022 7:23
21/11/2021,Phetchaburi,30,23632,482577,232780,249797,479666,479543,123,,,19/1/2022 7:23
21/11/2021,Phetchabun,59,11823,978573,482421,496152,134305,133818,487,,,19/1/2022 7:23
21/11/2021,Loei,8,4109,638978,320126,318852,126076,125834,242,57,29,19/1/2022 7:23
21/11/2021,Phrae,10,1925,434895,209621,225274,51804,51653,151,67,33,19/1/2022 7:23
21/11/2021,Mae Hong Son,50,2192,285927,144863,141064,73223,71986,1237,44,11,19/1/2022 7:23
21/11/2021,,0,173,,,,,,,,,19/1/2022 7:23
22/11/2021,Krabi,83,9639,479290,238118,241172,49198,48852,346,,,19/1/2022 7:23
22/11/2021,Bangkok,832,446380,5530283,2593687,2936596,1294781,1215564,79217,83,30,19/1/2022 7:23
22/11/2021,Kanchanaburi,97,23516,893747,448009,445738,812418,812043,375,62,25,19/1/2022 7:23
22/11/2021,Kalasin,15,9730,975840,482246,493594,39828,39803,25,,,19/1/2022 7:23
22/11/2021,Kamphaeng Phet,9,8041,712340,351623,360717,40873,40710,163,,,19/1/2022 7:23
22/11/2021,Khon Kaen,129,24886,1791302,880185,911117,195487,195350,137,85,36,19/1/2022 7:23
22/11/2021,Chanthaburi,53,21609,536572,262310,274262,127398,127173,225,,,19/1/2022 7:23
22/11/2021,Chachoengsao,24,36749,724145,354876,369269,337607,337607,0,90,36,19/1/2022 7:23
22/11/2021,Chon Buri,151,108965,1583412,772344,811068,929255,920898,8357,75,21,19/1/2022 7:23
22/11/2021,Chai Nat,4,2696,320710,154147,166563,44850,44850,0,,,19/1/2022 7:23
22/11/2021,Chaiyaphum,18,12035,1122715,554712,568003,48905,48826,79,,,19/1/2022 7:23
22/11/2021,Chumphon,57,14423,509632,251576,258056,33159,33146,13,,,19/1/2022 7:23
22/11/2021,Trang,129,15113,639941,312807,327134,25842,25842,0,,,19/1/2022 7:23
22/11/2021,Trat,17,8463,228339,112907,115432,106763,104219,2544,,,19/1/2022 7:23
22/11/2021,Tak,51,24415,676105,341755,334350,65113,65113,0,,,19/1/2022 7:23
22/11/2021,Nakhon Nayok,21,11398,260391,128848,131543,170824,170788,36,,,19/1/2022 7:23
22/11/2021,Nakhon Pathom,55,35707,921946,442578,479368,116491,116387,104,109,28,19/1/2022 7:23
22/11/2021,Nakhon Phanom,2,4987,717181,357273,359908,60530,60511,19,,,19/1/2022 7:23
22/11/2021,Nakhon Ratchasima,110,33973,2634154,1293776,1340378,473887,472075,1812,69,25,19/1/2022 7:23
22/11/2021,Nakhon Si Thammarat,438,38502,1549258,764251,785007,22828,22804,24,,,19/1/2022 7:23
22/11/2021,Nakhon Sawan,42,16463,1035583,505021,530562,75335,75110,225,80,28,19/1/2022 7:23
22/11/2021,Nonthaburi,102,67730,1287480,598638,688842,91335,90985,350,54, ,19/1/2022 7:23
22/11/2021,Narathiwat,86,41434,809341,400380,408961,3051,3051,0,42,27,19/1/2022 7:23
22/11/2021,Nan,7,2609,475894,237970,237924,103582,102713,869,,,19/1/2022 7:23
22/11/2021,Bueng Kan,18,2201,422056,211601,210455,13820,13531,289,,,19/1/2022 7:23
22/11/2021,Buri Ram,6,17175,1580074,783823,796251,77399,76979,420,,,19/1/2022 7:23
22/11/2021,Pathum Thani,32,41758,1189186,563353,625833,80926,80630,296,59,25,19/1/2022 7:23
22/11/2021,Prachuap Khiri Khan,47,18207,553198,274111,279087,450266,449376,890,,,19/1/2022 7:23
22/11/2021,Prachin Buri,68,24650,494804,244188,250616,86770,86638,132,67,30,19/1/2022 7:23
22/11/2021,Pattani,196,44956,729331,360142,369189,4532,4532,0,,,19/1/2022 7:23
22/11/2021,Phra Nakhon Si Ayutthaya,108,32205,820637,394133,426504,389058,388198,860,65,51,19/1/2022 7:23
22/11/2021,Phayao,1,2452,464807,226101,238706,52329,51787,542,65,31,19/1/2022 7:23
22/11/2021,Phang-nga,15,6032,268121,133884,134237,57579,43267,14312,,,19/1/2022 7:23
22/11/2021,Phatthalung,80,11319,522562,254456,268106,19880,19880,0,,,19/1/2022 7:23
22/11/2021,Phichit,15,5216,529730,258152,271578,28128,28128,0,,,19/1/2022 7:23
22/11/2021,Phitsanulok,47,7661,847456,414644,432812,147550,147235,315,,,19/1/2022 7:23
22/11/2021,Phuket,84,16840,418939,198000,220939,158721,117533,41188,41,22,19/1/2022 7:23
22/11/2021,Maha Sarakham,13,11089,948760,465243,483517,22566,22530,36,,,19/1/2022 7:23
22/11/2021,Mukdahan,3,2411,351477,175634,175843,91851,91830,21,,,19/1/2022 7:23
22/11/2021,Yala,146,46266,542249,269916,272333,8303,8303,0,54,19,19/1/2022 7:23
22/11/2021,Yasothon,5,5935,533387,266000,267387,11956,11956,0,,,19/1/2022 7:23
22/11/2021,Ranong,5,9811,194713,98257,96456,10718,10686,32,,,19/1/2022 7:23
22/11/2021,Rayong,90,44943,750813,368748,382065,449414,446915,2499,62,54,19/1/2022 7:23
22/11/2021,Ratchaburi,291,40779,868383,421933,446450,156792,156354,438,,,19/1/2022 7:23
22/11/2021,Roi Et,35,14044,1296246,642036,654210,29035,28998,37,,,19/1/2022 7:23
22/11/2021,Lop Buri,64,17689,739079,368209,370870,164681,164569,112,,,19/1/2022 7:23
22/11/2021,Lampang,7,2975,725197,353220,371977,91037,90339,698,75, ,19/1/2022 7:23
22/11/2021,Lamphun,49,3309,401266,192787,208479,66278,65498,780,,,19/1/2022 7:23
22/11/2021,Si Sa Ket,548,18271,1457748,725758,731990,51233,51233,0,,,19/1/2022 7:23
22/11/2021,Sakon Nakhon,3,7791,1146663,569782,576881,101215,101215,0,,,19/1/2022 7:23
22/11/2021,Songkhla,459,59670,1431562,697309,734253,24450,24434,16,50,22,19/1/2022 7:23
22/11/2021,Satun,85,7015,324802,161606,163196,53346,53307,39,26,29,19/1/2022 7:23
22/11/2021,Samut Prakarn,165,130462,1356374,645942,710432,65953,52911,13042,,,19/1/2022 7:23
22/11/2021,Samut Songkhram,8,11836,191049,91232,99817,103736,103736,0,38,14,19/1/2022 7:23
22/11/2021,Samut Sakhon,27,111350,586485,282611,303874,27110,27075,35,94,36,19/1/2022 7:23
22/11/2021,Saraburi,79,32756,643429,315725,327704,213646,213508,138,119,72,19/1/2022 7:23
22/11/2021,Sa kaeo,67,18763,561712,280407,281305,80293,79161,1132,52,18,19/1/2022 7:23
22/11/2021,Sing Buri,27,3354,204758,97261,107497,22448,22402,46,,,19/1/2022 7:23
22/11/2021,Suphan Buri,47,15881,835777,403176,432601,279513,279513,0,,,19/1/2022 7:23
22/11/2021,Surat Thani,280,23434,1072430,527357,545073,31940,27595,4345,38,18,19/1/2022 7:23
22/11/2021,Surin,61,18793,1376669,684750,691919,36906,36878,28,,,19/1/2022 7:23
22/11/2021,Sukhothai,9,6381,585572,283544,302028,59322,58638,684,,,19/1/2022 7:23
22/11/2021,Nong Khai,9,4286,516910,256357,260553,88413,88064,349,17,16,19/1/2022 7:23
22/11/2021,Nong Bua Lam Phu,16,4500,509096,253820,255276,9330,9305,25,,,19/1/2022 7:23
22/11/2021,Amnat Charoen,1,3033,376417,187215,189202,12411,12411,0,,,19/1/2022 7:23
22/11/2021,Udon Thani,56,24490,1566796,775703,791093,112923,112463,460,,,19/1/2022 7:23
22/11/2021,Uttaradit,2,4440,446358,217547,228811,51788,51679,109,,,19/1/2022 7:23
22/11/2021,Uthai Thani,11,3721,325208,158967,166241,33303,33303,0,,,19/1/2022 7:23
22/11/2021,Ubon Ratchathani,142,21618,1868052,932286,935766,119633,119591,42,52,23,19/1/2022 7:23
22/11/2021,Ang Thong,12,11431,275021,131590,143431,28564,28564,0,,,19/1/2022 7:23
22/11/2021,Chiang Rai,34,5248,1298579,631054,667525,266159,265473,686,60,26,19/1/2022 7:23
22/11/2021,Chiang Mai,240,29162,1788986,864222,924764,779417,775914,3503,69,35,19/1/2022 7:23
22/11/2021,Phetchaburi,33,23665,482577,232780,249797,479666,479543,123,,,19/1/2022 7:23
22/11/2021,Phetchabun,26,11849,978573,482421,496152,134305,133818,487,,,19/1/2022 7:23
22/11/2021,Loei,8,4117,638978,320126,318852,126076,125834,242,60,21,19/1/2022 7:23
22/11/2021,Phrae,1,1926,434895,209621,225274,51804,51653,151,77,27,19/1/2022 7:23
22/11/2021,Mae Hong Son,15,2207,285927,144863,141064,73223,71986,1237,46,22,19/1/2022 7:23
22/11/2021,,0,173,,,,,,,,,19/1/2022 7:23
23/11/2021,Krabi,89,9728,479290,238118,241172,49198,48852,346,,,19/1/2022 7:23
23/11/2021,Bangkok,775,447155,5530283,2593687,2936596,1294781,1215564,79217,58,32,19/1/2022 7:23
23/11/2021,Kanchanaburi,45,23561,893747,448009,445738,812418,812043,375,45,20,19/1/2022 7:23
23/11/2021,Kalasin,25,9755,975840,482246,493594,39828,39803,25,,,19/1/2022 7:23
23/11/2021,Kamphaeng Phet,8,8049,712340,351623,360717,40873,40710,163,,,19/1/2022 7:23
23/11/2021,Khon Kaen,69,24955,1791302,880185,911117,195487,195350,137,52,36,19/1/2022 7:23
23/11/2021,Chanthaburi,81,21690,536572,262310,274262,127398,127173,225,,,19/1/2022 7:23
23/11/2021,Chachoengsao,52,36801,724145,354876,369269,337607,337607,0,51,31,19/1/2022 7:23
23/11/2021,Chon Buri,147,109112,1583412,772344,811068,929255,920898,8357,82,22,19/1/2022 7:23
23/11/2021,Chai Nat,7,2703,320710,154147,166563,44850,44850,0,,,19/1/2022 7:23
23/11/2021,Chaiyaphum,20,12055,1122715,554712,568003,48905,48826,79,,,19/1/2022 7:23
23/11/2021,Chumphon,67,14490,509632,251576,258056,33159,33146,13,,,19/1/2022 7:23
23/11/2021,Trang,128,15241,639941,312807,327134,25842,25842,0,,,19/1/2022 7:23
23/11/2021,Trat,28,8491,228339,112907,115432,106763,104219,2544,,,19/1/2022 7:23
23/11/2021,Tak,62,24477,676105,341755,334350,65113,65113,0,,,19/1/2022 7:23
23/11/2021,Nakhon Nayok,10,11408,260391,128848,131543,170824,170788,36,,,19/1/2022 7:23
23/11/2021,Nakhon Pathom,18,35725,921946,442578,479368,116491,116387,104,56,27,19/1/2022 7:23
23/11/2021,Nakhon Phanom,1,4988,717181,357273,359908,60530,60511,19,,,19/1/2022 7:23
23/11/2021,Nakhon Ratchasima,111,34084,2634154,1293776,1340378,473887,472075,1812,49,25,19/1/2022 7:23
23/11/2021,Nakhon Si Thammarat,330,38832,1549258,764251,785007,22828,22804,24,,,19/1/2022 7:23
23/11/2021,Nakhon Sawan,42,16505,1035583,505021,530562,75335,75110,225,56,23,19/1/2022 7:23
23/11/2021,Nonthaburi,77,67807,1287480,598638,688842,91335,90985,350,38, ,19/1/2022 7:23
23/11/2021,Narathiwat,63,41497,809341,400380,408961,3051,3051,0,57,17,19/1/2022 7:23
23/11/2021,Nan,10,2619,475894,237970,237924,103582,102713,869,,,19/1/2022 7:23
23/11/2021,Bueng Kan,8,2209,422056,211601,210455,13820,13531,289,,,19/1/2022 7:23
23/11/2021,Buri Ram,10,17185,1580074,783823,796251,77399,76979,420,,,19/1/2022 7:23
23/11/2021,Pathum Thani,25,41783,1189186,563353,625833,80926,80630,296,45,35,19/1/2022 7:23
23/11/2021,Prachuap Khiri Khan,61,18268,553198,274111,279087,450266,449376,890,,,19/1/2022 7:23
23/11/2021,Prachin Buri,74,24724,494804,244188,250616,86770,86638,132,57,31,19/1/2022 7:23
23/11/2021,Pattani,170,45126,729331,360142,369189,4532,4532,0,,,19/1/2022 7:23
23/11/2021,Phra Nakhon Si Ayutthaya,55,32260,820637,394133,426504,389058,388198,860,57,54,19/1/2022 7:23
23/11/2021,Phayao,5,2457,464807,226101,238706,52329,51787,542,65,25,19/1/2022 7:23
23/11/2021,Phang-nga,38,6070,268121,133884,134237,57579,43267,14312,,,19/1/2022 7:23
23/11/2021,Phatthalung,97,11416,522562,254456,268106,19880,19880,0,,,19/1/2022 7:23
23/11/2021,Phichit,12,5228,529730,258152,271578,28128,28128,0,,,19/1/2022 7:23
23/11/2021,Phitsanulok,43,7704,847456,414644,432812,147550,147235,315,,,19/1/2022 7:23
23/11/2021,Phuket,86,16926,418939,198000,220939,158721,117533,41188,35,21,19/1/2022 7:23
23/11/2021,Maha Sarakham,9,11098,948760,465243,483517,22566,22530,36,,,19/1/2022 7:23
23/11/2021,Mukdahan,0,2411,351477,175634,175843,91851,91830,21,,,19/1/2022 7:23
23/11/2021,Yala,82,46348,542249,269916,272333,8303,8303,0,43,16,19/1/2022 7:23
23/11/2021,Yasothon,0,5935,533387,266000,267387,11956,11956,0,,,19/1/2022 7:23
23/11/2021,Ranong,20,9831,194713,98257,96456,10718,10686,32,,,19/1/2022 7:23
23/11/2021,Rayong,74,45017,750813,368748,382065,449414,446915,2499,51,18,19/1/2022 7:23
23/11/2021,Ratchaburi,55,40834,868383,421933,446450,156792,156354,438,,,19/1/2022 7:23
23/11/2021,Roi Et,17,14061,1296246,642036,654210,29035,28998,37,,,19/1/2022 7:23
23/11/2021,Lop Buri,38,17727,739079,368209,370870,164681,164569,112,,,19/1/2022 7:23
23/11/2021,Lampang,7,2982,725197,353220,371977,91037,90339,698,76, ,19/1/2022 7:23
23/11/2021,Lamphun,64,3373,401266,192787,208479,66278,65498,780,,,19/1/2022 7:23
23/11/2021,Si Sa Ket,27,18298,1457748,725758,731990,51233,51233,0,,,19/1/2022 7:23
23/11/2021,Sakon Nakhon,7,7798,1146663,569782,576881,101215,101215,0,,,19/1/2022 7:23
23/11/2021,Songkhla,460,60130,1431562,697309,734253,24450,24434,16,44,17,19/1/2022 7:23
23/11/2021,Satun,73,7088,324802,161606,163196,53346,53307,39,26,25,19/1/2022 7:23
23/11/2021,Samut Prakarn,129,130591,1356374,645942,710432,65953,52911,13042,,,19/1/2022 7:23
23/11/2021,Samut Songkhram,5,11841,191049,91232,99817,103736,103736,0,31,15,19/1/2022 7:23
23/11/2021,Samut Sakhon,38,111388,586485,282611,303874,27110,27075,35,63,42,19/1/2022 7:23
23/11/2021,Saraburi,39,32795,643429,315725,327704,213646,213508,138,85,64,19/1/2022 7:23
23/11/2021,Sa kaeo,58,18821,561712,280407,281305,80293,79161,1132,36,19,19/1/2022 7:23
23/11/2021,Sing Buri,25,3379,204758,97261,107497,22448,22402,46,,,19/1/2022 7:23
23/11/2021,Suphan Buri,31,15912,835777,403176,432601,279513,279513,0,,,19/1/2022 7:23
23/11/2021,Surat Thani,266,23700,1072430,527357,545073,31940,27595,4345,25,13,19/1/2022 7:23
23/11/2021,Surin,45,18838,1376669,684750,691919,36906,36878,28,,,19/1/2022 7:23
23/11/2021,Sukhothai,1,6382,585572,283544,302028,59322,58638,684,,,19/1/2022 7:23
23/11/2021,Nong Khai,16,4302,516910,256357,260553,88413,88064,349,26,21,19/1/2022 7:23
23/11/2021,Nong Bua Lam Phu,3,4503,509096,253820,255276,9330,9305,25,,,19/1/2022 7:23
23/11/2021,Amnat Charoen,1,3034,376417,187215,189202,12411,12411,0,,,19/1/2022 7:23
23/11/2021,Udon Thani,51,24541,1566796,775703,791093,112923,112463,460,,,19/1/2022 7:23
23/11/2021,Uttaradit,21,4461,446358,217547,228811,51788,51679,109,,,19/1/2022 7:23
23/11/2021,Uthai Thani,4,3725,325208,158967,166241,33303,33303,0,,,19/1/2022 7:23
23/11/2021,Ubon Ratchathani,115,21733,1868052,932286,935766,119633,119591,42,24,21,19/1/2022 7:23
23/11/2021,Ang Thong,12,11443,275021,131590,143431,28564,28564,0,,,19/1/2022 7:23
23/11/2021,Chiang Rai,37,5285,1298579,631054,667525,266159,265473,686,65,23,19/1/2022 7:23
23/11/2021,Chiang Mai,261,29423,1788986,864222,924764,779417,775914,3503,71,29,19/1/2022 7:23
23/11/2021,Phetchaburi,20,23685,482577,232780,249797,479666,479543,123,,,19/1/2022 7:23
23/11/2021,Phetchabun,24,11873,978573,482421,496152,134305,133818,487,,,19/1/2022 7:23
23/11/2021,Loei,16,4133,638978,320126,318852,126076,125834,242,32,19,19/1/2022 7:23
23/11/2021,Phrae,15,1941,434895,209621,225274,51804,51653,151,67,24,19/1/2022 7:23
23/11/2021,Mae Hong Son,11,2218,285927,144863,141064,73223,71986,1237,72,16,19/1/2022 7:23
23/11/2021,,0,173,,,,,,,,,19/1/2022 7:23
24/11/2021,Krabi,87,9815,479290,238118,241172,49198,48852,346,,,19/1/2022 7:23
24/11/2021,Bangkok,760,447915,5530283,2593687,2936596,1294781,1215564,79217,59,45,19/1/2022 7:23
24/11/2021,Kanchanaburi,63,23624,893747,448009,445738,812418,812043,375,45,27,19/1/2022 7:23
24/11/2021,Kalasin,35,9790,975840,482246,493594,39828,39803,25,,,19/1/2022 7:23
24/11/2021,Kamphaeng Phet,20,8069,712340,351623,360717,40873,40710,163,,,19/1/2022 7:23
24/11/2021,Khon Kaen,113,25068,1791302,880185,911117,195487,195350,137,58,42,19/1/2022 7:23
24/11/2021,Chanthaburi,88,21778,536572,262310,274262,127398,127173,225,,,19/1/2022 7:23
24/11/2021,Chachoengsao,63,36864,724145,354876,369269,337607,337607,0,44,38,19/1/2022 7:23
24/11/2021,Chon Buri,205,109317,1583412,772344,811068,929255,920898,8357,45,29,19/1/2022 7:23
24/11/2021,Chai Nat,9,2712,320710,154147,166563,44850,44850,0,,,19/1/2022 7:23
24/11/2021,Chaiyaphum,18,12073,1122715,554712,568003,48905,48826,79,,,19/1/2022 7:23
24/11/2021,Chumphon,132,14622,509632,251576,258056,33159,33146,13,,,19/1/2022 7:23
24/11/2021,Trang,129,15370,639941,312807,327134,25842,25842,0,,,19/1/2022 7:23
24/11/2021,Trat,64,8555,228339,112907,115432,106763,104219,2544,,,19/1/2022 7:23
24/11/2021,Tak,90,24567,676105,341755,334350,65113,65113,0,,,19/1/2022 7:23
24/11/2021,Nakhon Nayok,19,11427,260391,128848,131543,170824,170788,36,,,19/1/2022 7:23
24/11/2021,Nakhon Pathom,19,35744,921946,442578,479368,116491,116387,104,48,35,19/1/2022 7:23
24/11/2021,Nakhon Phanom,4,4992,717181,357273,359908,60530,60511,19,,,19/1/2022 7:23
24/11/2021,Nakhon Ratchasima,80,34164,2634154,1293776,1340378,473887,472075,1812,50,31,19/1/2022 7:23
24/11/2021,Nakhon Si Thammarat,325,39157,1549258,764251,785007,22828,22804,24,,,19/1/2022 7:23
24/11/2021,Nakhon Sawan,56,16561,1035583,505021,530562,75335,75110,225,48,30,19/1/2022 7:23
24/11/2021,Nonthaburi,89,67896,1287480,598638,688842,91335,90985,350,50, ,19/1/2022 7:23
24/11/2021,Narathiwat,105,41602,809341,400380,408961,3051,3051,0,41,12,19/1/2022 7:23
24/11/2021,Nan,4,2623,475894,237970,237924,103582,102713,869,,,19/1/2022 7:23
24/11/2021,Bueng Kan,8,2217,422056,211601,210455,13820,13531,289,,,19/1/2022 7:23
24/11/2021,Buri Ram,14,17199,1580074,783823,796251,77399,76979,420,,,19/1/2022 7:23
24/11/2021,Pathum Thani,53,41836,1189186,563353,625833,80926,80630,296,53,39,19/1/2022 7:23
24/11/2021,Prachuap Khiri Khan,70,18338,553198,274111,279087,450266,449376,890,,,19/1/2022 7:23
24/11/2021,Prachin Buri,92,24816,494804,244188,250616,86770,86638,132,56,33,19/1/2022 7:23
24/11/2021,Pattani,178,45304,729331,360142,369189,4532,4532,0,,,19/1/2022 7:23
24/11/2021,Phra Nakhon Si Ayutthaya,39,32299,820637,394133,426504,389058,388198,860,35,55,19/1/2022 7:23
24/11/2021,Phayao,24,2481,464807,226101,238706,52329,51787,542,48,26,19/1/2022 7:23
24/11/2021,Phang-nga,72,6142,268121,133884,134237,57579,43267,14312,,,19/1/2022 7:23
24/11/2021,Phatthalung,112,11528,522562,254456,268106,19880,19880,0,,,19/1/2022 7:23
24/11/2021,Phichit,14,5242,529730,258152,271578,28128,28128,0,,,19/1/2022 7:23
24/11/2021,Phitsanulok,57,7761,847456,414644,432812,147550,147235,315,,,19/1/2022 7:23
24/11/2021,Phuket,107,17033,418939,198000,220939,158721,117533,41188,26,17,19/1/2022 7:23
24/11/2021,Maha Sarakham,19,11117,948760,465243,483517,22566,22530,36,,,19/1/2022 7:23
24/11/2021,Mukdahan,3,2414,351477,175634,175843,91851,91830,21,,,19/1/2022 7:23
24/11/2021,Yala,140,46488,542249,269916,272333,8303,8303,0,37,17,19/1/2022 7:23
24/11/2021,Yasothon,9,5944,533387,266000,267387,11956,11956,0,,,19/1/2022 7:23
24/11/2021,Ranong,13,9844,194713,98257,96456,10718,10686,32,,,19/1/2022 7:23
24/11/2021,Rayong,22,45039,750813,368748,382065,449414,446915,2499,49,23,19/1/2022 7:23
24/11/2021,Ratchaburi,153,40987,868383,421933,446450,156792,156354,438,,,19/1/2022 7:23
24/11/2021,Roi Et,11,14072,1296246,642036,654210,29035,28998,37,,,19/1/2022 7:23
24/11/2021,Lop Buri,10,17737,739079,368209,370870,164681,164569,112,,,19/1/2022 7:23
24/11/2021,Lampang,3,2985,725197,353220,371977,91037,90339,698,79, ,19/1/2022 7:23
24/11/2021,Lamphun,72,3445,401266,192787,208479,66278,65498,780,,,19/1/2022 7:23
24/11/2021,Si Sa Ket,16,18314,1457748,725758,731990,51233,51233,0,,,19/1/2022 7:23
24/11/2021,Sakon Nakhon,6,7804,1146663,569782,576881,101215,101215,0,,,19/1/2022 7:23
24/11/2021,Songkhla,478,60608,1431562,697309,734253,24450,24434,16,31,19,19/1/2022 7:23
24/11/2021,Satun,75,7163,324802,161606,163196,53346,53307,39,18,29,19/1/2022 7:23
24/11/2021,Samut Prakarn,263,130854,1356374,645942,710432,65953,52911,13042,,,19/1/2022 7:23
24/11/2021,Samut Songkhram,9,11850,191049,91232,99817,103736,103736,0,33,22,19/1/2022 7:23
24/11/2021,Samut Sakhon,44,111432,586485,282611,303874,27110,27075,35,61,47,19/1/2022 7:23
24/11/2021,Saraburi,48,32843,643429,315725,327704,213646,213508,138,71,68,19/1/2022 7:23
24/11/2021,Sa kaeo,79,18900,561712,280407,281305,80293,79161,1132,37,26,19/1/2022 7:23
24/11/2021,Sing Buri,18,3397,204758,97261,107497,22448,22402,46,,,19/1/2022 7:23
24/11/2021,Suphan Buri,31,15943,835777,403176,432601,279513,279513,0,,,19/1/2022 7:23
24/11/2021,Surat Thani,237,23937,1072430,527357,545073,31940,27595,4345,27,16,19/1/2022 7:23
24/11/2021,Surin,17,18855,1376669,684750,691919,36906,36878,28,,,19/1/2022 7:23
24/11/2021,Sukhothai,7,6389,585572,283544,302028,59322,58638,684,,,19/1/2022 7:23
24/11/2021,Nong Khai,7,4309,516910,256357,260553,88413,88064,349,33,23,19/1/2022 7:23
24/11/2021,Nong Bua Lam Phu,16,4519,509096,253820,255276,9330,9305,25,,,19/1/2022 7:23
24/11/2021,Amnat Charoen,0,3034,376417,187215,189202,12411,12411,0,,,19/1/2022 7:23
24/11/2021,Udon Thani,81,24622,1566796,775703,791093,112923,112463,460,,,19/1/2022 7:23
24/11/2021,Uttaradit,17,4478,446358,217547,228811,51788,51679,109,,,19/1/2022 7:23
24/11/2021,Uthai Thani,12,3737,325208,158967,166241,33303,33303,0,,,19/1/2022 7:23
24/11/2021,Ubon Ratchathani,111,21844,1868052,932286,935766,119633,119591,42,32,28,19/1/2022 7:23
24/11/2021,Ang Thong,3,11446,275021,131590,143431,28564,28564,0,,,19/1/2022 7:23
24/11/2021,Chiang Rai,32,5317,1298579,631054,667525,266159,265473,686,59,19,19/1/2022 7:23
24/11/2021,Chiang Mai,257,29680,1788986,864222,924764,779417,775914,3503,63,33,19/1/2022 7:23
24/11/2021,Phetchaburi,42,23727,482577,232780,249797,479666,479543,123,,,19/1/2022 7:23
24/11/2021,Phetchabun,44,11917,978573,482421,496152,134305,133818,487,,,19/1/2022 7:23
24/11/2021,Loei,12,4145,638978,320126,318852,126076,125834,242,36,29,19/1/2022 7:23
24/11/2021,Phrae,0,1941,434895,209621,225274,51804,51653,151,57,27,19/1/2022 7:23
24/11/2021,Mae Hong Son,23,2241,285927,144863,141064,73223,71986,1237,59,11,19/1/2022 7:23
24/11/2021,,0,173,,,,,,,,,19/1/2022 7:23
25/11/2021,Krabi,89,9904,479290,238118,241172,49198,48852,346,,,19/1/2022 7:23
25/11/2021,Bangkok,676,448591,5530283,2593687,2936596,1294781,1215564,79217,81,50,19/1/2022 7:23
25/11/2021,Kanchanaburi,90,23714,893747,448009,445738,812418,812043,375,52,27,19/1/2022 7:23
25/11/2021,Kalasin,11,9801,975840,482246,493594,39828,39803,25,,,19/1/2022 7:23
25/11/2021,Kamphaeng Phet,23,8092,712340,351623,360717,40873,40710,163,,,19/1/2022 7:23
25/11/2021,Khon Kaen,120,25188,1791302,880185,911117,195487,195350,137,70,46,19/1/2022 7:23
25/11/2021,Chanthaburi,76,21854,536572,262310,274262,127398,127173,225,,,19/1/2022 7:23
25/11/2021,Chachoengsao,81,36945,724145,354876,369269,337607,337607,0,57,41,19/1/2022 7:23
25/11/2021,Chon Buri,204,109521,1583412,772344,811068,929255,920898,8357,56,34,19/1/2022 7:23
25/11/2021,Chai Nat,11,2723,320710,154147,166563,44850,44850,0,,,19/1/2022 7:23
25/11/2021,Chaiyaphum,25,12098,1122715,554712,568003,48905,48826,79,,,19/1/2022 7:23
25/11/2021,Chumphon,97,14719,509632,251576,258056,33159,33146,13,,,19/1/2022 7:23
25/11/2021,Trang,118,15488,639941,312807,327134,25842,25842,0,,,19/1/2022 7:23
25/11/2021,Trat,49,8604,228339,112907,115432,106763,104219,2544,,,19/1/2022 7:23
25/11/2021,Tak,98,24665,676105,341755,334350,65113,65113,0,,,19/1/2022 7:23
25/11/2021,Nakhon Nayok,10,11437,260391,128848,131543,170824,170788,36,,,19/1/2022 7:23
25/11/2021,Nakhon Pathom,23,35767,921946,442578,479368,116491,116387,104,62,48,19/1/2022 7:23
25/11/2021,Nakhon Phanom,3,4995,717181,357273,359908,60530,60511,19,,,19/1/2022 7:23
25/11/2021,Nakhon Ratchasima,120,34284,2634154,1293776,1340378,473887,472075,1812,65,34,19/1/2022 7:23
25/11/2021,Nakhon Si Thammarat,430,39587,1549258,764251,785007,22828,22804,24,,,19/1/2022 7:23
25/11/2021,Nakhon Sawan,68,16629,1035583,505021,530562,75335,75110,225,65,39,19/1/2022 7:23
25/11/2021,Nonthaburi,96,67992,1287480,598638,688842,91335,90985,350,64, ,19/1/2022 7:23
25/11/2021,Narathiwat,69,41671,809341,400380,408961,3051,3051,0,31,16,19/1/2022 7:23
25/11/2021,Nan,9,2632,475894,237970,237924,103582,102713,869,,,19/1/2022 7:23
25/11/2021,Bueng Kan,6,2223,422056,211601,210455,13820,13531,289,,,19/1/2022 7:23
25/11/2021,Buri Ram,11,17210,1580074,783823,796251,77399,76979,420,,,19/1/2022 7:23
25/11/2021,Pathum Thani,88,41924,1189186,563353,625833,80926,80630,296,64,45,19/1/2022 7:23
25/11/2021,Prachuap Khiri Khan,154,18492,553198,274111,279087,450266,449376,890,,,19/1/2022 7:23
25/11/2021,Prachin Buri,112,24928,494804,244188,250616,86770,86638,132,63,46,19/1/2022 7:23
25/11/2021,Pattani,178,45482,729331,360142,369189,4532,4532,0,,,19/1/2022 7:23
25/11/2021,Phra Nakhon Si Ayutthaya,69,32368,820637,394133,426504,389058,388198,860,54,57,19/1/2022 7:23
25/11/2021,Phayao,15,2496,464807,226101,238706,52329,51787,542,56,27,19/1/2022 7:23
25/11/2021,Phang-nga,54,6196,268121,133884,134237,57579,43267,14312,,,19/1/2022 7:23
25/11/2021,Phatthalung,111,11639,522562,254456,268106,19880,19880,0,,,19/1/2022 7:23
25/11/2021,Phichit,12,5254,529730,258152,271578,28128,28128,0,,,19/1/2022 7:23
25/11/2021,Phitsanulok,62,7823,847456,414644,432812,147550,147235,315,,,19/1/2022 7:23
25/11/2021,Phuket,112,17145,418939,198000,220939,158721,117533,41188,26,19,19/1/2022 7:23
25/11/2021,Maha Sarakham,22,11139,948760,465243,483517,22566,22530,36,,,19/1/2022 7:23
25/11/2021,Mukdahan,2,2416,351477,175634,175843,91851,91830,21,,,19/1/2022 7:23
25/11/2021,Yala,171,46659,542249,269916,272333,8303,8303,0,40,19,19/1/2022 7:23
25/11/2021,Yasothon,8,5952,533387,266000,267387,11956,11956,0,,,19/1/2022 7:23
25/11/2021,Ranong,11,9855,194713,98257,96456,10718,10686,32,,,19/1/2022 7:23
25/11/2021,Rayong,150,45189,750813,368748,382065,449414,446915,2499,49,28,19/1/2022 7:23
25/11/2021,Ratchaburi,125,41112,868383,421933,446450,156792,156354,438,,,19/1/2022 7:23
25/11/2021,Roi Et,20,14092,1296246,642036,654210,29035,28998,37,,,19/1/2022 7:23
25/11/2021,Lop Buri,49,17786,739079,368209,370870,164681,164569,112,,,19/1/2022 7:23
25/11/2021,Lampang,7,2992,725197,353220,371977,91037,90339,698,73, ,19/1/2022 7:23
25/11/2021,Lamphun,87,3532,401266,192787,208479,66278,65498,780,,,19/1/2022 7:23
25/11/2021,Si Sa Ket,27,18341,1457748,725758,731990,51233,51233,0,,,19/1/2022 7:23
25/11/2021,Sakon Nakhon,4,7808,1146663,569782,576881,101215,101215,0,,,19/1/2022 7:23
25/11/2021,Songkhla,457,61065,1431562,697309,734253,24450,24434,16,39,19,19/1/2022 7:23
25/11/2021,Satun,70,7233,324802,161606,163196,53346,53307,39,15,28,19/1/2022 7:23
25/11/2021,Samut Prakarn,219,131073,1356374,645942,710432,65953,52911,13042,,,19/1/2022 7:23
25/11/2021,Samut Songkhram,9,11859,191049,91232,99817,103736,103736,0,42,23,19/1/2022 7:23
25/11/2021,Samut Sakhon,58,111490,586485,282611,303874,27110,27075,35,74,53,19/1/2022 7:23
25/11/2021,Saraburi,75,32918,643429,315725,327704,213646,213508,138,80,78,19/1/2022 7:23
25/11/2021,Sa kaeo,66,18966,561712,280407,281305,80293,79161,1132,55,29,19/1/2022 7:23
25/11/2021,Sing Buri,17,3414,204758,97261,107497,22448,22402,46,,,19/1/2022 7:23
25/11/2021,Suphan Buri,41,15984,835777,403176,432601,279513,279513,0,,,19/1/2022 7:23
25/11/2021,Surat Thani,263,24200,1072430,527357,545073,31940,27595,4345,28,13,19/1/2022 7:23
25/11/2021,Surin,15,18870,1376669,684750,691919,36906,36878,28,,,19/1/2022 7:23
25/11/2021,Sukhothai,6,6395,585572,283544,302028,59322,58638,684,,,19/1/2022 7:23
25/11/2021,Nong Khai,10,4319,516910,256357,260553,88413,88064,349,39,21,19/1/2022 7:23
25/11/2021,Nong Bua Lam Phu,8,4527,509096,253820,255276,9330,9305,25,,,19/1/2022 7:23
25/11/2021,Amnat Charoen,5,3039,376417,187215,189202,12411,12411,0,,,19/1/2022 7:23
25/11/2021,Udon Thani,87,24709,1566796,775703,791093,112923,112463,460,,,19/1/2022 7:23
25/11/2021,Uttaradit,12,4490,446358,217547,228811,51788,51679,109,,,19/1/2022 7:23
25/11/2021,Uthai Thani,3,3740,325208,158967,166241,33303,33303,0,,,19/1/2022 7:23
25/11/2021,Ubon Ratchathani,114,21958,1868052,932286,935766,119633,119591,42,56,35,19/1/2022 7:23
25/11/2021,Ang Thong,7,11453,275021,131590,143431,28564,28564,0,,,19/1/2022 7:23
25/11/2021,Chiang Rai,39,5356,1298579,631054,667525,266159,265473,686,46,14,19/1/2022 7:23
25/11/2021,Chiang Mai,258,29938,1788986,864222,924764,779417,775914,3503,69,36,19/1/2022 7:23
25/11/2021,Phetchaburi,31,23758,482577,232780,249797,479666,479543,123,,,19/1/2022 7:23
25/11/2021,Phetchabun,85,12002,978573,482421,496152,134305,133818,487,,,19/1/2022 7:23
25/11/2021,Loei,5,4150,638978,320126,318852,126076,125834,242,60,29,19/1/2022 7:23
25/11/2021,Phrae,4,1945,434895,209621,225274,51804,51653,151,68,29,19/1/2022 7:23
25/11/2021,Mae Hong Son,108,2349,285927,144863,141064,73223,71986,1237,49, ,19/1/2022 7:23
25/11/2021,,0,173,,,,,,,,,19/1/2022 7:23
26/11/2021,Krabi,86,9990,479290,238118,241172,49198,48852,346,,,19/1/2022 7:23
26/11/2021,Bangkok,623,449214,5530283,2593687,2936596,1294781,1215564,79217,89,43,19/1/2022 7:23
26/11/2021,Kanchanaburi,110,23824,893747,448009,445738,812418,812043,375,74,24,19/1/2022 7:23
26/11/2021,Kalasin,15,9816,975840,482246,493594,39828,39803,25,,,19/1/2022 7:23
26/11/2021,Kamphaeng Phet,24,8116,712340,351623,360717,40873,40710,163,,,19/1/2022 7:23
26/11/2021,Khon Kaen,98,25286,1791302,880185,911117,195487,195350,137,76,48,19/1/2022 7:23
26/11/2021,Chanthaburi,52,21906,536572,262310,274262,127398,127173,225,,,19/1/2022 7:23
26/11/2021,Chachoengsao,86,37031,724145,354876,369269,337607,337607,0,63,45,19/1/2022 7:23
26/11/2021,Chon Buri,202,109723,1583412,772344,811068,929255,920898,8357,66,31,19/1/2022 7:23
26/11/2021,Chai Nat,7,2730,320710,154147,166563,44850,44850,0,,,19/1/2022 7:23
26/11/2021,Chaiyaphum,12,12110,1122715,554712,568003,48905,48826,79,,,19/1/2022 7:23
26/11/2021,Chumphon,96,14815,509632,251576,258056,33159,33146,13,,,19/1/2022 7:23
26/11/2021,Trang,107,15595,639941,312807,327134,25842,25842,0,,,19/1/2022 7:23
26/11/2021,Trat,49,8653,228339,112907,115432,106763,104219,2544,,,19/1/2022 7:23
26/11/2021,Tak,98,24763,676105,341755,334350,65113,65113,0,,,19/1/2022 7:23
26/11/2021,Nakhon Nayok,7,11444,260391,128848,131543,170824,170788,36,,,19/1/2022 7:23
26/11/2021,Nakhon Pathom,40,35807,921946,442578,479368,116491,116387,104,94,47,19/1/2022 7:23
26/11/2021,Nakhon Phanom,1,4996,717181,357273,359908,60530,60511,19,,,19/1/2022 7:23
26/11/2021,Nakhon Ratchasima,116,34400,2634154,1293776,1340378,473887,472075,1812,72,41,19/1/2022 7:23
26/11/2021,Nakhon Si Thammarat,457,40044,1549258,764251,785007,22828,22804,24,,,19/1/2022 7:23
26/11/2021,Nakhon Sawan,28,16657,1035583,505021,530562,75335,75110,225,87,36,19/1/2022 7:23
26/11/2021,Nonthaburi,66,68058,1287480,598638,688842,91335,90985,350,69, ,19/1/2022 7:23
26/11/2021,Narathiwat,80,41751,809341,400380,408961,3051,3051,0,46,21,19/1/2022 7:23
26/11/2021,Nan,16,2648,475894,237970,237924,103582,102713,869,,,19/1/2022 7:23
26/11/2021,Bueng Kan,16,2239,422056,211601,210455,13820,13531,289,,,19/1/2022 7:23
26/11/2021,Buri Ram,11,17221,1580074,783823,796251,77399,76979,420,,,19/1/2022 7:23
26/11/2021,Pathum Thani,91,42015,1189186,563353,625833,80926,80630,296,72,47,19/1/2022 7:23
26/11/2021,Prachuap Khiri Khan,100,18592,553198,274111,279087,450266,449376,890,,,19/1/2022 7:23
26/11/2021,Prachin Buri,94,25022,494804,244188,250616,86770,86638,132,81,50,19/1/2022 7:23
26/11/2021,Pattani,228,45710,729331,360142,369189,4532,4532,0,,,19/1/2022 7:23
26/11/2021,Phra Nakhon Si Ayutthaya,71,32439,820637,394133,426504,389058,388198,860,65,65,19/1/2022 7:23
26/11/2021,Phayao,42,2538,464807,226101,238706,52329,51787,542,64,16,19/1/2022 7:23
26/11/2021,Phang-nga,66,6262,268121,133884,134237,57579,43267,14312,,,19/1/2022 7:23
26/11/2021,Phatthalung,115,11754,522562,254456,268106,19880,19880,0,,,19/1/2022 7:23
26/11/2021,Phichit,14,5268,529730,258152,271578,28128,28128,0,,,19/1/2022 7:23
26/11/2021,Phitsanulok,50,7873,847456,414644,432812,147550,147235,315,,,19/1/2022 7:23
26/11/2021,Phuket,129,17274,418939,198000,220939,158721,117533,41188,27,26,19/1/2022 7:23
26/11/2021,Maha Sarakham,21,11160,948760,465243,483517,22566,22530,36,,,19/1/2022 7:23
26/11/2021,Mukdahan,4,2420,351477,175634,175843,91851,91830,21,,,19/1/2022 7:23
26/11/2021,Yala,112,46771,542249,269916,272333,8303,8303,0,43,29,19/1/2022 7:23
26/11/2021,Yasothon,3,5955,533387,266000,267387,11956,11956,0,,,19/1/2022 7:23
26/11/2021,Ranong,6,9861,194713,98257,96456,10718,10686,32,,,19/1/2022 7:23
26/11/2021,Rayong,101,45290,750813,368748,382065,449414,446915,2499,61,28,19/1/2022 7:23
26/11/2021,Ratchaburi,681,41793,868383,421933,446450,156792,156354,438,,,19/1/2022 7:23
26/11/2021,Roi Et,16,14108,1296246,642036,654210,29035,28998,37,,,19/1/2022 7:23
26/11/2021,Lop Buri,46,17832,739079,368209,370870,164681,164569,112,,,19/1/2022 7:23
26/11/2021,Lampang,9,3001,725197,353220,371977,91037,90339,698,75, ,19/1/2022 7:23
26/11/2021,Lamphun,38,3570,401266,192787,208479,66278,65498,780,,,19/1/2022 7:23
26/11/2021,Si Sa Ket,38,18379,1457748,725758,731990,51233,51233,0,,,19/1/2022 7:23
26/11/2021,Sakon Nakhon,2,7810,1146663,569782,576881,101215,101215,0,,,19/1/2022 7:23
26/11/2021,Songkhla,474,61539,1431562,697309,734253,24450,24434,16,36,22,19/1/2022 7:23
26/11/2021,Satun,77,7310,324802,161606,163196,53346,53307,39,19,29,19/1/2022 7:23
26/11/2021,Samut Prakarn,218,131291,1356374,645942,710432,65953,52911,13042,,,19/1/2022 7:23
26/11/2021,Samut Songkhram,11,11870,191049,91232,99817,103736,103736,0,52,25,19/1/2022 7:23
26/11/2021,Samut Sakhon,22,111512,586485,282611,303874,27110,27075,35,79,49,19/1/2022 7:23
26/11/2021,Saraburi,67,32985,643429,315725,327704,213646,213508,138,100,71,19/1/2022 7:23
26/11/2021,Sa kaeo,91,19057,561712,280407,281305,80293,79161,1132,64,36,19/1/2022 7:23
26/11/2021,Sing Buri,7,3421,204758,97261,107497,22448,22402,46,,,19/1/2022 7:23
26/11/2021,Suphan Buri,57,16041,835777,403176,432601,279513,279513,0,,,19/1/2022 7:23
26/11/2021,Surat Thani,287,24487,1072430,527357,545073,31940,27595,4345,28,13,19/1/2022 7:23
26/11/2021,Surin,22,18892,1376669,684750,691919,36906,36878,28,,,19/1/2022 7:23
26/11/2021,Sukhothai,12,6407,585572,283544,302028,59322,58638,684,,,19/1/2022 7:23
26/11/2021,Nong Khai,16,4335,516910,256357,260553,88413,88064,349,37,22,19/1/2022 7:23
26/11/2021,Nong Bua Lam Phu,15,4542,509096,253820,255276,9330,9305,25,,,19/1/2022 7:23
26/11/2021,Amnat Charoen,10,3049,376417,187215,189202,12411,12411,0,,,19/1/2022 7:23
26/11/2021,Udon Thani,91,24800,1566796,775703,791093,112923,112463,460,,,19/1/2022 7:23
26/11/2021,Uttaradit,15,4505,446358,217547,228811,51788,51679,109,,,19/1/2022 7:23
26/11/2021,Uthai Thani,12,3752,325208,158967,166241,33303,33303,0,,,19/1/2022 7:23
26/11/2021,Ubon Ratchathani,102,22060,1868052,932286,935766,119633,119591,42,65,43,19/1/2022 7:23
26/11/2021,Ang Thong,7,11460,275021,131590,143431,28564,28564,0,,,19/1/2022 7:23
26/11/2021,Chiang Rai,33,5389,1298579,631054,667525,266159,265473,686,38,13,19/1/2022 7:23
26/11/2021,Chiang Mai,209,30147,1788986,864222,924764,779417,775914,3503,77,28,19/1/2022 7:23
26/11/2021,Phetchaburi,26,23784,482577,232780,249797,479666,479543,123,,,19/1/2022 7:23
26/11/2021,Phetchabun,29,12031,978573,482421,496152,134305,133818,487,,,19/1/2022 7:23
26/11/2021,Loei,15,4165,638978,320126,318852,126076,125834,242,64,31,19/1/2022 7:23
26/11/2021,Phrae,16,1961,434895,209621,225274,51804,51653,151,75,28,19/1/2022 7:23
26/11/2021,Mae Hong Son,38,2387,285927,144863,141064,73223,71986,1237,,,19/1/2022 7:23
26/11/2021,,0,173,,,,,,,,,19/1/2022 7:23
27/11/2021,Krabi,92,10082,479290,238118,241172,49198,48852,346,,,19/1/2022 7:23
27/11/2021,Bangkok,722,449936,5530283,2593687,2936596,1294781,1215564,79217,88,51,19/1/2022 7:23
27/11/2021,Kanchanaburi,41,23865,893747,448009,445738,812418,812043,375,71,23,19/1/2022 7:23
27/11/2021,Kalasin,29,9845,975840,482246,493594,39828,39803,25,,,19/1/2022 7:23
27/11/2021,Kamphaeng Phet,23,8139,712340,351623,360717,40873,40710,163,,,19/1/2022 7:23
27/11/2021,Khon Kaen,108,25394,1791302,880185,911117,195487,195350,137,83,59,19/1/2022 7:23
27/11/2021,Chanthaburi,52,21958,536572,262310,274262,127398,127173,225,,,19/1/2022 7:23
27/11/2021,Chachoengsao,49,37080,724145,354876,369269,337607,337607,0,74,48,19/1/2022 7:23
27/11/2021,Chon Buri,201,109924,1583412,772344,811068,929255,920898,8357,68, ,19/1/2022 7:23
27/11/2021,Chai Nat,25,2755,320710,154147,166563,44850,44850,0,,,19/1/2022 7:23
27/11/2021,Chaiyaphum,28,12138,1122715,554712,568003,48905,48826,79,,,19/1/2022 7:23
27/11/2021,Chumphon,82,14897,509632,251576,258056,33159,33146,13,,,19/1/2022 7:23
27/11/2021,Trang,106,15701,639941,312807,327134,25842,25842,0,,,19/1/2022 7:23
27/11/2021,Trat,81,8734,228339,112907,115432,106763,104219,2544,,,19/1/2022 7:23
27/11/2021,Tak,85,24848,676105,341755,334350,65113,65113,0,,,19/1/2022 7:23
27/11/2021,Nakhon Nayok,27,11471,260391,128848,131543,170824,170788,36,,,19/1/2022 7:23
27/11/2021,Nakhon Pathom,34,35841,921946,442578,479368,116491,116387,104,93,45,19/1/2022 7:23
27/11/2021,Nakhon Phanom,8,5004,717181,357273,359908,60530,60511,19,,,19/1/2022 7:23
27/11/2021,Nakhon Ratchasima,99,34499,2634154,1293776,1340378,473887,472075,1812,86,43,19/1/2022 7:23
27/11/2021,Nakhon Si Thammarat,366,40410,1549258,764251,785007,22828,22804,24,,,19/1/2022 7:23
27/11/2021,Nakhon Sawan,52,16709,1035583,505021,530562,75335,75110,225,69,42,19/1/2022 7:23
27/11/2021,Nonthaburi,100,68158,1287480,598638,688842,91335,90985,350,67, ,19/1/2022 7:23
27/11/2021,Narathiwat,74,41825,809341,400380,408961,3051,3051,0,48,17,19/1/2022 7:23
27/11/2021,Nan,19,2667,475894,237970,237924,103582,102713,869,,,19/1/2022 7:23
27/11/2021,Bueng Kan,3,2242,422056,211601,210455,13820,13531,289,,,19/1/2022 7:23
27/11/2021,Buri Ram,11,17232,1580074,783823,796251,77399,76979,420,,,19/1/2022 7:23
27/11/2021,Pathum Thani,87,42102,1189186,563353,625833,80926,80630,296,82,45,19/1/2022 7:23
27/11/2021,Prachuap Khiri Khan,73,18665,553198,274111,279087,450266,449376,890,,,19/1/2022 7:23
27/11/2021,Prachin Buri,97,25119,494804,244188,250616,86770,86638,132,91,55,19/1/2022 7:23
27/11/2021,Pattani,182,45892,729331,360142,369189,4532,4532,0,,,19/1/2022 7:23
27/11/2021,Phra Nakhon Si Ayutthaya,74,32513,820637,394133,426504,389058,388198,860,73,63,19/1/2022 7:23
27/11/2021,Phayao,16,2554,464807,226101,238706,52329,51787,542,43,23,19/1/2022 7:23
27/11/2021,Phang-nga,49,6311,268121,133884,134237,57579,43267,14312,,,19/1/2022 7:23
27/11/2021,Phatthalung,106,11860,522562,254456,268106,19880,19880,0,,,19/1/2022 7:23
27/11/2021,Phichit,12,5280,529730,258152,271578,28128,28128,0,,,19/1/2022 7:23
27/11/2021,Phitsanulok,62,7935,847456,414644,432812,147550,147235,315,,,19/1/2022 7:23
27/11/2021,Phuket,151,17425,418939,198000,220939,158721,117533,41188,49,42,19/1/2022 7:23
27/11/2021,Maha Sarakham,13,11173,948760,465243,483517,22566,22530,36,,,19/1/2022 7:23
27/11/2021,Mukdahan,4,2424,351477,175634,175843,91851,91830,21,,,19/1/2022 7:23
27/11/2021,Yala,105,46876,542249,269916,272333,8303,8303,0,51,22,19/1/2022 7:23
27/11/2021,Yasothon,7,5962,533387,266000,267387,11956,11956,0,,,19/1/2022 7:23
27/11/2021,Ranong,12,9873,194713,98257,96456,10718,10686,32,,,19/1/2022 7:23
27/11/2021,Rayong,78,45368,750813,368748,382065,449414,446915,2499,70,38,19/1/2022 7:23
27/11/2021,Ratchaburi,310,42103,868383,421933,446450,156792,156354,438,,,19/1/2022 7:23
27/11/2021,Roi Et,36,14144,1296246,642036,654210,29035,28998,37,,,19/1/2022 7:23
27/11/2021,Lop Buri,48,17880,739079,368209,370870,164681,164569,112,,,19/1/2022 7:23
27/11/2021,Lampang,9,3010,725197,353220,371977,91037,90339,698,68, ,19/1/2022 7:23
27/11/2021,Lamphun,76,3646,401266,192787,208479,66278,65498,780,,,19/1/2022 7:23
27/11/2021,Si Sa Ket,43,18422,1457748,725758,731990,51233,51233,0,,,19/1/2022 7:23
27/11/2021,Sakon Nakhon,0,7810,1146663,569782,576881,101215,101215,0,,,19/1/2022 7:23
27/11/2021,Songkhla,442,61981,1431562,697309,734253,24450,24434,16,46,19,19/1/2022 7:23
27/11/2021,Satun,76,7386,324802,161606,163196,53346,53307,39,23,29,19/1/2022 7:23
27/11/2021,Samut Prakarn,151,131442,1356374,645942,710432,65953,52911,13042,,,19/1/2022 7:23
27/11/2021,Samut Songkhram,11,11881,191049,91232,99817,103736,103736,0,63,27,19/1/2022 7:23
27/11/2021,Samut Sakhon,37,111549,586485,282611,303874,27110,27075,35,77,48,19/1/2022 7:23
27/11/2021,Saraburi,75,33060,643429,315725,327704,213646,213508,138,96,62,19/1/2022 7:23
27/11/2021,Sa kaeo,104,19161,561712,280407,281305,80293,79161,1132,73,42,19/1/2022 7:23
27/11/2021,Sing Buri,14,3435,204758,97261,107497,22448,22402,46,,,19/1/2022 7:23
27/11/2021,Suphan Buri,70,16111,835777,403176,432601,279513,279513,0,,,19/1/2022 7:23
27/11/2021,Surat Thani,280,24767,1072430,527357,545073,31940,27595,4345,49,22,19/1/2022 7:23
27/11/2021,Surin,15,18907,1376669,684750,691919,36906,36878,28,,,19/1/2022 7:23
27/11/2021,Sukhothai,2,6409,585572,283544,302028,59322,58638,684,,,19/1/2022 7:23
27/11/2021,Nong Khai,14,4349,516910,256357,260553,88413,88064,349,39,22,19/1/2022 7:23
27/11/2021,Nong Bua Lam Phu,6,4548,509096,253820,255276,9330,9305,25,,,19/1/2022 7:23
27/11/2021,Amnat Charoen,3,3052,376417,187215,189202,12411,12411,0,,,19/1/2022 7:23
27/11/2021,Udon Thani,58,24858,1566796,775703,791093,112923,112463,460,,,19/1/2022 7:23
27/11/2021,Uttaradit,10,4515,446358,217547,228811,51788,51679,109,,,19/1/2022 7:23
27/11/2021,Uthai Thani,1,3753,325208,158967,166241,33303,33303,0,,,19/1/2022 7:23
27/11/2021,Ubon Ratchathani,110,22170,1868052,932286,935766,119633,119591,42,80,39,19/1/2022 7:23
27/11/2021,Ang Thong,0,11460,275021,131590,143431,28564,28564,0,,,19/1/2022 7:23
27/11/2021,Chiang Rai,43,5432,1298579,631054,667525,266159,265473,686,34,15,19/1/2022 7:23
27/11/2021,Chiang Mai,277,30424,1788986,864222,924764,779417,775914,3503,69,23,19/1/2022 7:23
27/11/2021,Phetchaburi,29,23813,482577,232780,249797,479666,479543,123,,,19/1/2022 7:23
27/11/2021,Phetchabun,46,12077,978573,482421,496152,134305,133818,487,,,19/1/2022 7:23
27/11/2021,Loei,7,4172,638978,320126,318852,126076,125834,242,65,38,19/1/2022 7:23
27/11/2021,Phrae,2,1963,434895,209621,225274,51804,51653,151,69,25,19/1/2022 7:23
27/11/2021,Mae Hong Son,23,2410,285927,144863,141064,73223,71986,1237,,,19/1/2022 7:23
27/11/2021,,0,173,,,,,,,,,19/1/2022 7:23
28/11/2021,Krabi,89,10171,479290,238118,241172,49198,48852,346,,,19/1/2022 7:23
28/11/2021,Bangkok,667,450603,5530283,2593687,2936596,1294781,1215564,79217,96,44,19/1/2022 7:23
28/11/2021,Kanchanaburi,46,23911,893747,448009,445738,812418,812043,375,74,26,19/1/2022 7:23
28/11/2021,Kalasin,30,9875,975840,482246,493594,39828,39803,25,,,19/1/2022 7:23
28/11/2021,Kamphaeng Phet,38,8177,712340,351623,360717,40873,40710,163,,,19/1/2022 7:23
28/11/2021,Khon Kaen,100,25494,1791302,880185,911117,195487,195350,137,108,55,19/1/2022 7:23
28/11/2021,Chanthaburi,60,22018,536572,262310,274262,127398,127173,225,,,19/1/2022 7:23
28/11/2021,Chachoengsao,52,37132,724145,354876,369269,337607,337607,0,80,46,19/1/2022 7:23
28/11/2021,Chon Buri,207,110131,1583412,772344,811068,929255,920898,8357, ,40,19/1/2022 7:23
28/11/2021,Chai Nat,6,2761,320710,154147,166563,44850,44850,0,,,19/1/2022 7:23
28/11/2021,Chaiyaphum,9,12147,1122715,554712,568003,48905,48826,79,,,19/1/2022 7:23
28/11/2021,Chumphon,106,15003,509632,251576,258056,33159,33146,13,,,19/1/2022 7:23
28/11/2021,Trang,109,15810,639941,312807,327134,25842,25842,0,,,19/1/2022 7:23
28/11/2021,Trat,52,8786,228339,112907,115432,106763,104219,2544,,,19/1/2022 7:23
28/11/2021,Tak,87,24935,676105,341755,334350,65113,65113,0,,,19/1/2022 7:23
28/11/2021,Nakhon Nayok,16,11487,260391,128848,131543,170824,170788,36,,,19/1/2022 7:23
28/11/2021,Nakhon Pathom,32,35873,921946,442578,479368,116491,116387,104,101,46,19/1/2022 7:23
28/11/2021,Nakhon Phanom,1,5005,717181,357273,359908,60530,60511,19,,,19/1/2022 7:23
28/11/2021,Nakhon Ratchasima,101,34600,2634154,1293776,1340378,473887,472075,1812,90,42,19/1/2022 7:23
28/11/2021,Nakhon Si Thammarat,355,40765,1549258,764251,785007,22828,22804,24,,,19/1/2022 7:23
28/11/2021,Nakhon Sawan,78,16787,1035583,505021,530562,75335,75110,225,73,45,19/1/2022 7:23
28/11/2021,Nonthaburi,80,68238,1287480,598638,688842,91335,90985,350,76, ,19/1/2022 7:23
28/11/2021,Narathiwat,61,41886,809341,400380,408961,3051,3051,0,47,14,19/1/2022 7:23
28/11/2021,Nan,9,2676,475894,237970,237924,103582,102713,869,,,19/1/2022 7:23
28/11/2021,Bueng Kan,13,2255,422056,211601,210455,13820,13531,289,,,19/1/2022 7:23
28/11/2021,Buri Ram,23,17255,1580074,783823,796251,77399,76979,420,,,19/1/2022 7:23
28/11/2021,Pathum Thani,86,42188,1189186,563353,625833,80926,80630,296,78,44,19/1/2022 7:23
28/11/2021,Prachuap Khiri Khan,83,18748,553198,274111,279087,450266,449376,890,,,19/1/2022 7:23
28/11/2021,Prachin Buri,84,25203,494804,244188,250616,86770,86638,132,94,50,19/1/2022 7:23
28/11/2021,Pattani,162,46054,729331,360142,369189,4532,4532,0,,,19/1/2022 7:23
28/11/2021,Phra Nakhon Si Ayutthaya,58,32571,820637,394133,426504,389058,388198,860,76,65,19/1/2022 7:23
28/11/2021,Phayao,11,2565,464807,226101,238706,52329,51787,542,58,28,19/1/2022 7:23
28/11/2021,Phang-nga,68,6379,268121,133884,134237,57579,43267,14312,,,19/1/2022 7:23
28/11/2021,Phatthalung,99,11959,522562,254456,268106,19880,19880,0,,,19/1/2022 7:23
28/11/2021,Phichit,10,5290,529730,258152,271578,28128,28128,0,,,19/1/2022 7:23
28/11/2021,Phitsanulok,43,7978,847456,414644,432812,147550,147235,315,,,19/1/2022 7:23
28/11/2021,Phuket,123,17548,418939,198000,220939,158721,117533,41188,74,36,19/1/2022 7:23
28/11/2021,Maha Sarakham,15,11188,948760,465243,483517,22566,22530,36,,,19/1/2022 7:23
28/11/2021,Mukdahan,1,2425,351477,175634,175843,91851,91830,21,,,19/1/2022 7:23
28/11/2021,Yala,103,46979,542249,269916,272333,8303,8303,0,50,17,19/1/2022 7:23
28/11/2021,Yasothon,0,5962,533387,266000,267387,11956,11956,0,,,19/1/2022 7:23
28/11/2021,Ranong,10,9883,194713,98257,96456,10718,10686,32,,,19/1/2022 7:23
28/11/2021,Rayong,121,45489,750813,368748,382065,449414,446915,2499,82,37,19/1/2022 7:23
28/11/2021,Ratchaburi,440,42543,868383,421933,446450,156792,156354,438,,,19/1/2022 7:23
28/11/2021,Roi Et,35,14179,1296246,642036,654210,29035,28998,37,,,19/1/2022 7:23
28/11/2021,Lop Buri,44,17924,739079,368209,370870,164681,164569,112,,,19/1/2022 7:23
28/11/2021,Lampang,3,3013,725197,353220,371977,91037,90339,698,67, ,19/1/2022 7:23
28/11/2021,Lamphun,50,3696,401266,192787,208479,66278,65498,780,,,19/1/2022 7:23
28/11/2021,Si Sa Ket,23,18445,1457748,725758,731990,51233,51233,0,,,19/1/2022 7:23
28/11/2021,Sakon Nakhon,2,7812,1146663,569782,576881,101215,101215,0,,,19/1/2022 7:23
28/11/2021,Songkhla,418,62399,1431562,697309,734253,24450,24434,16,42,18,19/1/2022 7:23
28/11/2021,Satun,72,7458,324802,161606,163196,53346,53307,39,25,29,19/1/2022 7:23
28/11/2021,Samut Prakarn,171,131613,1356374,645942,710432,65953,52911,13042,,,19/1/2022 7:23
28/11/2021,Samut Songkhram,16,11897,191049,91232,99817,103736,103736,0,64,47,19/1/2022 7:23
28/11/2021,Samut Sakhon,28,111577,586485,282611,303874,27110,27075,35,79,50,19/1/2022 7:23
28/11/2021,Saraburi,63,33123,643429,315725,327704,213646,213508,138,88,73,19/1/2022 7:23
28/11/2021,Sa kaeo,42,19203,561712,280407,281305,80293,79161,1132,87,33,19/1/2022 7:23
28/11/2021,Sing Buri,11,3446,204758,97261,107497,22448,22402,46,,,19/1/2022 7:23
28/11/2021,Suphan Buri,31,16142,835777,403176,432601,279513,279513,0,,,19/1/2022 7:23
28/11/2021,Surat Thani,277,25044,1072430,527357,545073,31940,27595,4345,70,36,19/1/2022 7:23
28/11/2021,Surin,13,18920,1376669,684750,691919,36906,36878,28,,,19/1/2022 7:23
28/11/2021,Sukhothai,5,6414,585572,283544,302028,59322,58638,684,,,19/1/2022 7:23
28/11/2021,Nong Khai,2,4351,516910,256357,260553,88413,88064,349,42,17,19/1/2022 7:23
28/11/2021,Nong Bua Lam Phu,1,4549,509096,253820,255276,9330,9305,25,,,19/1/2022 7:23
28/11/2021,Amnat Charoen,6,3058,376417,187215,189202,12411,12411,0,,,19/1/2022 7:23
28/11/2021,Udon Thani,74,24932,1566796,775703,791093,112923,112463,460,,,19/1/2022 7:23
28/11/2021,Uttaradit,6,4521,446358,217547,228811,51788,51679,109,,,19/1/2022 7:23
28/11/2021,Uthai Thani,12,3765,325208,158967,166241,33303,33303,0,,,19/1/2022 7:23
28/11/2021,Ubon Ratchathani,74,22244,1868052,932286,935766,119633,119591,42,72,45,19/1/2022 7:23
28/11/2021,Ang Thong,2,11462,275021,131590,143431,28564,28564,0,,,19/1/2022 7:23
28/11/2021,Chiang Rai,34,5466,1298579,631054,667525,266159,265473,686,46,21,19/1/2022 7:23
28/11/2021,Chiang Mai,252,30676,1788986,864222,924764,779417,775914,3503,57,32,19/1/2022 7:23
28/11/2021,Phetchaburi,26,23839,482577,232780,249797,479666,479543,123,,,19/1/2022 7:23
28/11/2021,Phetchabun,53,12130,978573,482421,496152,134305,133818,487,,,19/1/2022 7:23
28/11/2021,Loei,1,4173,638978,320126,318852,126076,125834,242,80,39,19/1/2022 7:23
28/11/2021,Phrae,7,1970,434895,209621,225274,51804,51653,151,65,29,19/1/2022 7:23
28/11/2021,Mae Hong Son,56,2466,285927,144863,141064,73223,71986,1237,,,19/1/2022 7:23
28/11/2021,,0,173,,,,,,,,,19/1/2022 7:23
29/11/2021,Krabi,87,10258,479290,238118,241172,49198,48852,346,,,19/1/2022 7:23
29/11/2021,Bangkok,606,451209,5530283,2593687,2936596,1294781,1215564,79217,87,50,19/1/2022 7:23
29/11/2021,Kanchanaburi,31,23942,893747,448009,445738,812418,812043,375,59,25,19/1/2022 7:23
29/11/2021,Kalasin,22,9897,975840,482246,493594,39828,39803,25,,,19/1/2022 7:23
29/11/2021,Kamphaeng Phet,37,8214,712340,351623,360717,40873,40710,163,,,19/1/2022 7:23
29/11/2021,Khon Kaen,79,25573,1791302,880185,911117,195487,195350,137,96,60,19/1/2022 7:23
29/11/2021,Chanthaburi,70,22088,536572,262310,274262,127398,127173,225,,,19/1/2022 7:23
29/11/2021,Chachoengsao,21,37153,724145,354876,369269,337607,337607,0,73,47,19/1/2022 7:23
29/11/2021,Chon Buri,151,110282,1583412,772344,811068,929255,920898,8357,71,37,19/1/2022 7:23
29/11/2021,Chai Nat,3,2764,320710,154147,166563,44850,44850,0,,,19/1/2022 7:23
29/11/2021,Chaiyaphum,4,12151,1122715,554712,568003,48905,48826,79,,,19/1/2022 7:23
29/11/2021,Chumphon,64,15067,509632,251576,258056,33159,33146,13,,,19/1/2022 7:23
29/11/2021,Trang,108,15918,639941,312807,327134,25842,25842,0,,,19/1/2022 7:23
29/11/2021,Trat,25,8811,228339,112907,115432,106763,104219,2544,,,19/1/2022 7:23
29/11/2021,Tak,58,24993,676105,341755,334350,65113,65113,0,,,19/1/2022 7:23
29/11/2021,Nakhon Nayok,13,11500,260391,128848,131543,170824,170788,36,,,19/1/2022 7:23
29/11/2021,Nakhon Pathom,17,35890,921946,442578,479368,116491,116387,104,79,44,19/1/2022 7:23
29/11/2021,Nakhon Phanom,2,5007,717181,357273,359908,60530,60511,19,,,19/1/2022 7:23
29/11/2021,Nakhon Ratchasima,110,34710,2634154,1293776,1340378,473887,472075,1812,83,47,19/1/2022 7:23
29/11/2021,Nakhon Si Thammarat,381,41146,1549258,764251,785007,22828,22804,24,,,19/1/2022 7:23
29/11/2021,Nakhon Sawan,55,16842,1035583,505021,530562,75335,75110,225,80,48,19/1/2022 7:23
29/11/2021,Nonthaburi,96,68334,1287480,598638,688842,91335,90985,350,64, ,19/1/2022 7:23
29/11/2021,Narathiwat,59,41945,809341,400380,408961,3051,3051,0,38,22,19/1/2022 7:23
29/11/2021,Nan,20,2696,475894,237970,237924,103582,102713,869,,,19/1/2022 7:23
29/11/2021,Bueng Kan,11,2266,422056,211601,210455,13820,13531,289,,,19/1/2022 7:23
29/11/2021,Buri Ram,14,17269,1580074,783823,796251,77399,76979,420,,,19/1/2022 7:23
29/11/2021,Pathum Thani,37,42225,1189186,563353,625833,80926,80630,296,72,45,19/1/2022 7:23
29/11/2021,Prachuap Khiri Khan,60,18808,553198,274111,279087,450266,449376,890,,,19/1/2022 7:23
29/11/2021,Prachin Buri,72,25275,494804,244188,250616,86770,86638,132,77,55,19/1/2022 7:23
29/11/2021,Pattani,137,46191,729331,360142,369189,4532,4532,0,,,19/1/2022 7:23
29/11/2021,Phra Nakhon Si Ayutthaya,73,32644,820637,394133,426504,389058,388198,860,81,62,19/1/2022 7:23
29/11/2021,Phayao,4,2569,464807,226101,238706,52329,51787,542,67,28,19/1/2022 7:23
29/11/2021,Phang-nga,29,6408,268121,133884,134237,57579,43267,14312,,,19/1/2022 7:23
29/11/2021,Phatthalung,99,12058,522562,254456,268106,19880,19880,0,,,19/1/2022 7:23
29/11/2021,Phichit,10,5300,529730,258152,271578,28128,28128,0,,,19/1/2022 7:23
29/11/2021,Phitsanulok,49,8027,847456,414644,432812,147550,147235,315,,,19/1/2022 7:23
29/11/2021,Phuket,139,17687,418939,198000,220939,158721,117533,41188,67,19,19/1/2022 7:23
29/11/2021,Maha Sarakham,5,11193,948760,465243,483517,22566,22530,36,,,19/1/2022 7:23
29/11/2021,Mukdahan,3,2428,351477,175634,175843,91851,91830,21,,,19/1/2022 7:23
29/11/2021,Yala,69,47048,542249,269916,272333,8303,8303,0,37,22,19/1/2022 7:23
29/11/2021,Yasothon,9,5971,533387,266000,267387,11956,11956,0,,,19/1/2022 7:23
29/11/2021,Ranong,3,9886,194713,98257,96456,10718,10686,32,,,19/1/2022 7:23
29/11/2021,Rayong,81,45570,750813,368748,382065,449414,446915,2499,80,27,19/1/2022 7:23
29/11/2021,Ratchaburi,79,42622,868383,421933,446450,156792,156354,438,,,19/1/2022 7:23
29/11/2021,Roi Et,19,14198,1296246,642036,654210,29035,28998,37,,,19/1/2022 7:23
29/11/2021,Lop Buri,18,17942,739079,368209,370870,164681,164569,112,,,19/1/2022 7:23
29/11/2021,Lampang,1,3014,725197,353220,371977,91037,90339,698,72, ,19/1/2022 7:23
29/11/2021,Lamphun,56,3752,401266,192787,208479,66278,65498,780,,,19/1/2022 7:23
29/11/2021,Si Sa Ket,25,18470,1457748,725758,731990,51233,51233,0,,,19/1/2022 7:23
29/11/2021,Sakon Nakhon,2,7814,1146663,569782,576881,101215,101215,0,,,19/1/2022 7:23
29/11/2021,Songkhla,358,62757,1431562,697309,734253,24450,24434,16,48,22,19/1/2022 7:23
29/11/2021,Satun,65,7523,324802,161606,163196,53346,53307,39,21,32,19/1/2022 7:23
29/11/2021,Samut Prakarn,171,131784,1356374,645942,710432,65953,52911,13042,,,19/1/2022 7:23
29/11/2021,Samut Songkhram,17,11914,191049,91232,99817,103736,103736,0,88,51,19/1/2022 7:23
29/11/2021,Samut Sakhon,23,111600,586485,282611,303874,27110,27075,35,81,49,19/1/2022 7:23
29/11/2021,Saraburi,69,33192,643429,315725,327704,213646,213508,138,97,74,19/1/2022 7:23
29/11/2021,Sa kaeo,27,19230,561712,280407,281305,80293,79161,1132,65,41,19/1/2022 7:23
29/11/2021,Sing Buri,12,3458,204758,97261,107497,22448,22402,46,,,19/1/2022 7:23
29/11/2021,Suphan Buri,19,16161,835777,403176,432601,279513,279513,0,,,19/1/2022 7:23
29/11/2021,Surat Thani,254,25298,1072430,527357,545073,31940,27595,4345,59,27,19/1/2022 7:23
29/11/2021,Surin,35,18955,1376669,684750,691919,36906,36878,28,,,19/1/2022 7:23
29/11/2021,Sukhothai,2,6416,585572,283544,302028,59322,58638,684,,,19/1/2022 7:23
29/11/2021,Nong Khai,14,4365,516910,256357,260553,88413,88064,349,34,19,19/1/2022 7:23
29/11/2021,Nong Bua Lam Phu,4,4553,509096,253820,255276,9330,9305,25,,,19/1/2022 7:23
29/11/2021,Amnat Charoen,1,3059,376417,187215,189202,12411,12411,0,,,19/1/2022 7:23
29/11/2021,Udon Thani,58,24990,1566796,775703,791093,112923,112463,460,,,19/1/2022 7:23
29/11/2021,Uttaradit,6,4527,446358,217547,228811,51788,51679,109,,,19/1/2022 7:23
29/11/2021,Uthai Thani,2,3767,325208,158967,166241,33303,33303,0,,,19/1/2022 7:23
29/11/2021,Ubon Ratchathani,65,22309,1868052,932286,935766,119633,119591,42,80,64,19/1/2022 7:23
29/11/2021,Ang Thong,9,11471,275021,131590,143431,28564,28564,0,,,19/1/2022 7:23
29/11/2021,Chiang Rai,24,5490,1298579,631054,667525,266159,265473,686,60,20,19/1/2022 7:23
29/11/2021,Chiang Mai,187,30863,1788986,864222,924764,779417,775914,3503,69,27,19/1/2022 7:23
29/11/2021,Phetchaburi,27,23866,482577,232780,249797,479666,479543,123,,,19/1/2022 7:23
29/11/2021,Phetchabun,19,12149,978573,482421,496152,134305,133818,487,,,19/1/2022 7:23
29/11/2021,Loei,16,4189,638978,320126,318852,126076,125834,242,80,47,19/1/2022 7:23
29/11/2021,Phrae,17,1987,434895,209621,225274,51804,51653,151,75,33,19/1/2022 7:23
29/11/2021,Mae Hong Son,29,2495,285927,144863,141064,73223,71986,1237,,,19/1/2022 7:23
29/11/2021,,0,173,,,,,,,,,19/1/2022 7:23
30/11/2021,Krabi,93,10351,479290,238118,241172,49198,48852,346,,,19/1/2022 7:23
30/11/2021,Bangkok,744,451953,5530283,2593687,2936596,1294781,1215564,79217,94,54,19/1/2022 7:23
30/11/2021,Kanchanaburi,42,23984,893747,448009,445738,812418,812043,375,57,32,19/1/2022 7:23
30/11/2021,Kalasin,4,9901,975840,482246,493594,39828,39803,25,,,19/1/2022 7:23
30/11/2021,Kamphaeng Phet,8,8222,712340,351623,360717,40873,40710,163,,,19/1/2022 7:23
30/11/2021,Khon Kaen,65,25638,1791302,880185,911117,195487,195350,137,105,62,19/1/2022 7:23
30/11/2021,Chanthaburi,48,22136,536572,262310,274262,127398,127173,225,,,19/1/2022 7:23
30/11/2021,Chachoengsao,35,37188,724145,354876,369269,337607,337607,0,74,52,19/1/2022 7:23
30/11/2021,Chon Buri,173,110455,1583412,772344,811068,929255,920898,8357,74,48,19/1/2022 7:23
30/11/2021,Chai Nat,4,2768,320710,154147,166563,44850,44850,0,,,19/1/2022 7:23
30/11/2021,Chaiyaphum,4,12155,1122715,554712,568003,48905,48826,79,,,19/1/2022 7:23
30/11/2021,Chumphon,88,15155,509632,251576,258056,33159,33146,13,,,19/1/2022 7:23
30/11/2021,Trang,98,16016,639941,312807,327134,25842,25842,0,,,19/1/2022 7:23
30/11/2021,Trat,20,8831,228339,112907,115432,106763,104219,2544,,,19/1/2022 7:23
30/11/2021,Tak,49,25042,676105,341755,334350,65113,65113,0,,,19/1/2022 7:23
30/11/2021,Nakhon Nayok,6,11506,260391,128848,131543,170824,170788,36,,,19/1/2022 7:23
30/11/2021,Nakhon Pathom,16,35906,921946,442578,479368,116491,116387,104,81,53,19/1/2022 7:23
30/11/2021,Nakhon Phanom,3,5010,717181,357273,359908,60530,60511,19,,,19/1/2022 7:23
30/11/2021,Nakhon Ratchasima,52,34762,2634154,1293776,1340378,473887,472075,1812,85,48,19/1/2022 7:23
30/11/2021,Nakhon Si Thammarat,310,41456,1549258,764251,785007,22828,22804,24,,,19/1/2022 7:23
30/11/2021,Nakhon Sawan,35,16877,1035583,505021,530562,75335,75110,225,80,50,19/1/2022 7:23
30/11/2021,Nonthaburi,56,68390,1287480,598638,688842,91335,90985,350,70, ,19/1/2022 7:23
30/11/2021,Narathiwat,58,42003,809341,400380,408961,3051,3051,0,52,27,19/1/2022 7:23
30/11/2021,Nan,17,2713,475894,237970,237924,103582,102713,869,,,19/1/2022 7:23
30/11/2021,Bueng Kan,15,2281,422056,211601,210455,13820,13531,289,,,19/1/2022 7:23
30/11/2021,Buri Ram,13,17282,1580074,783823,796251,77399,76979,420,,,19/1/2022 7:23
30/11/2021,Pathum Thani,24,42249,1189186,563353,625833,80926,80630,296,77,52,19/1/2022 7:23
30/11/2021,Prachuap Khiri Khan,62,18870,553198,274111,279087,450266,449376,890,,,19/1/2022 7:23
30/11/2021,Prachin Buri,44,25319,494804,244188,250616,86770,86638,132,93,57,19/1/2022 7:23
30/11/2021,Pattani,98,46289,729331,360142,369189,4532,4532,0,,,19/1/2022 7:23
30/11/2021,Phra Nakhon Si Ayutthaya,28,32672,820637,394133,426504,389058,388198,860,72,67,19/1/2022 7:23
30/11/2021,Phayao,20,2589,464807,226101,238706,52329,51787,542,71,34,19/1/2022 7:23
30/11/2021,Phang-nga,32,6440,268121,133884,134237,57579,43267,14312,,,19/1/2022 7:23
30/11/2021,Phatthalung,84,12142,522562,254456,268106,19880,19880,0,,,19/1/2022 7:23
30/11/2021,Phichit,17,5317,529730,258152,271578,28128,28128,0,,,19/1/2022 7:23
30/11/2021,Phitsanulok,62,8089,847456,414644,432812,147550,147235,315,,,19/1/2022 7:23
30/11/2021,Phuket,93,17780,418939,198000,220939,158721,117533,41188,45,20,19/1/2022 7:23
30/11/2021,Maha Sarakham,6,11199,948760,465243,483517,22566,22530,36,,,19/1/2022 7:23
30/11/2021,Mukdahan,26,2454,351477,175634,175843,91851,91830,21,,,19/1/2022 7:23
30/11/2021,Yala,61,47109,542249,269916,272333,8303,8303,0,44,21,19/1/2022 7:23
30/11/2021,Yasothon,1,5972,533387,266000,267387,11956,11956,0,,,19/1/2022 7:23
30/11/2021,Ranong,12,9898,194713,98257,96456,10718,10686,32,,,19/1/2022 7:23
30/11/2021,Rayong,76,45646,750813,368748,382065,449414,446915,2499,71,39,19/1/2022 7:23
30/11/2021,Ratchaburi,117,42739,868383,421933,446450,156792,156354,438,,,19/1/2022 7:23
30/11/2021,Roi Et,23,14221,1296246,642036,654210,29035,28998,37,,,19/1/2022 7:23
30/11/2021,Lop Buri,78,18020,739079,368209,370870,164681,164569,112,,,19/1/2022 7:23
30/11/2021,Lampang,10,3024,725197,353220,371977,91037,90339,698,77, ,19/1/2022 7:23
30/11/2021,Lamphun,68,3820,401266,192787,208479,66278,65498,780,,,19/1/2022 7:23
30/11/2021,Si Sa Ket,23,18493,1457748,725758,731990,51233,51233,0,,,19/1/2022 7:23
30/11/2021,Sakon Nakhon,0,7814,1146663,569782,576881,101215,101215,0,,,19/1/2022 7:23
30/11/2021,Songkhla,249,63006,1431562,697309,734253,24450,24434,16,43,22,19/1/2022 7:23
30/11/2021,Satun,28,7551,324802,161606,163196,53346,53307,39,29,28,19/1/2022 7:23
30/11/2021,Samut Prakarn,150,131934,1356374,645942,710432,65953,52911,13042,,,19/1/2022 7:23
30/11/2021,Samut Songkhram,15,11929,191049,91232,99817,103736,103736,0,103,56,19/1/2022 7:23
30/11/2021,Samut Sakhon,24,111624,586485,282611,303874,27110,27075,35,74,57,19/1/2022 7:23
30/11/2021,Saraburi,61,33253,643429,315725,327704,213646,213508,138,93,72,19/1/2022 7:23
30/11/2021,Sa kaeo,12,19242,561712,280407,281305,80293,79161,1132,80,46,19/1/2022 7:23
30/11/2021,Sing Buri,7,3465,204758,97261,107497,22448,22402,46,,,19/1/2022 7:23
30/11/2021,Suphan Buri,18,16179,835777,403176,432601,279513,279513,0,,,19/1/2022 7:23
30/11/2021,Surat Thani,247,25545,1072430,527357,545073,31940,27595,4345,19,9,19/1/2022 7:23
30/11/2021,Surin,12,18967,1376669,684750,691919,36906,36878,28,,,19/1/2022 7:23
30/11/2021,Sukhothai,1,6417,585572,283544,302028,59322,58638,684,,,19/1/2022 7:23
30/11/2021,Nong Khai,3,4368,516910,256357,260553,88413,88064,349,38,28,19/1/2022 7:23
30/11/2021,Nong Bua Lam Phu,12,4565,509096,253820,255276,9330,9305,25,,,19/1/2022 7:23
30/11/2021,Amnat Charoen,3,3062,376417,187215,189202,12411,12411,0,,,19/1/2022 7:23
30/11/2021,Udon Thani,29,25019,1566796,775703,791093,112923,112463,460,,,19/1/2022 7:23
30/11/2021,Uttaradit,11,4538,446358,217547,228811,51788,51679,109,,,19/1/2022 7:23
30/11/2021,Uthai Thani,2,3769,325208,158967,166241,33303,33303,0,,,19/1/2022 7:23
30/11/2021,Ubon Ratchathani,34,22343,1868052,932286,935766,119633,119591,42,102,48,19/1/2022 7:23
30/11/2021,Ang Thong,1,11472,275021,131590,143431,28564,28564,0,,,19/1/2022 7:23
30/11/2021,Chiang Rai,29,5519,1298579,631054,667525,266159,265473,686,60,25,19/1/2022 7:23
30/11/2021,Chiang Mai,167,31030,1788986,864222,924764,779417,775914,3503,67,33,19/1/2022 7:23
30/11/2021,Phetchaburi,16,23882,482577,232780,249797,479666,479543,123,,,19/1/2022 7:23
30/11/2021,Phetchabun,13,12162,978573,482421,496152,134305,133818,487,,,19/1/2022 7:23
30/11/2021,Loei,17,4206,638978,320126,318852,126076,125834,242,93,49,19/1/2022 7:23
30/11/2021,Phrae,5,1992,434895,209621,225274,51804,51653,151,83,38,19/1/2022 7:23
30/11/2021,Mae Hong Son,19,2514,285927,144863,141064,73223,71986,1237,,,19/1/2022 7:23
30/11/2021,,0,173,,,,,,,,,19/1/2022 7:23
1/12/2021,Krabi,83,10434,479351,238092,241259,81255,79570,1685,,,19/1/2022 7:23
1/12/2021,Bangkok,797,452750,5527994,2592292,2935702,2543615,2383978,159637,105,55,19/1/2022 7:23
1/12/2021,Kanchanaburi,65,24049,894054,448312,445742,908851,907622,1229,57,34,19/1/2022 7:23
1/12/2021,Kalasin,14,9915,975570,481988,493582,44112,43792,320,,,19/1/2022 7:23
1/12/2021,Kamphaeng Phet,11,8233,712143,351539,360604,60392,60106,286,,,19/1/2022 7:23
1/12/2021,Khon Kaen,88,25726,1790863,879849,911014,356626,354735,1891,118,55,19/1/2022 7:23
1/12/2021,Chanthaburi,57,22193,536557,262257,274300,132403,132126,277,,,19/1/2022 7:23
1/12/2021,Chachoengsao,82,37270,724178,354834,369344,350064,349850,214,80,49,19/1/2022 7:23
1/12/2021,Chon Buri,199,110654,1583672,772463,811209,975534,964356,11178,86,45,19/1/2022 7:23
1/12/2021,Chai Nat,8,2776,320432,153962,166470,51161,51147,14,,,19/1/2022 7:23
1/12/2021,Chaiyaphum,22,12177,1122265,554299,567966,99618,99364,254,,,19/1/2022 7:23
1/12/2021,Chumphon,100,15255,509479,251405,258074,70890,70798,92,,,19/1/2022 7:23
1/12/2021,Trang,97,16113,639788,312693,327095,91461,91339,122,,,19/1/2022 7:23
1/12/2021,Trat,49,8880,228376,112941,115435,133130,130498,2632,,,19/1/2022 7:23
1/12/2021,Tak,75,25117,676583,341966,334617,109369,109331,38,,,19/1/2022 7:23
1/12/2021,Nakhon Nayok,27,11533,260433,128854,131579,170360,170245,115,,,19/1/2022 7:23
1/12/2021,Nakhon Pathom,6,35912,922171,442800,479371,216272,216000,272,97,52,19/1/2022 7:23
1/12/2021,Nakhon Phanom,0,5010,717040,357096,359944,101214,101189,25,,,19/1/2022 7:23
1/12/2021,Nakhon Ratchasima,53,34815,2634154,1293783,1340371,571339,566844,4495,96,45,19/1/2022 7:23
1/12/2021,Nakhon Si Thammarat,206,41662,1549344,764471,784873,138859,138776,83,,,19/1/2022 7:23
1/12/2021,Nakhon Sawan,47,16924,1035028,504657,530371,112947,112567,380,94,51,19/1/2022 7:23
1/12/2021,Nonthaburi,49,68439,1288637,599167,689470,160119,158826,1293,85, ,19/1/2022 7:23
1/12/2021,Narathiwat,57,42060,809660,400501,409159,5393,5393,0,58,15,19/1/2022 7:23
1/12/2021,Nan,16,2729,475875,237959,237916,132711,131256,1455,,,19/1/2022 7:23
1/12/2021,Bueng Kan,19,2300,421995,211494,210501,49966,49403,563,,,19/1/2022 7:23
1/12/2021,Buri Ram,22,17304,1579805,783531,796274,127140,126290,850,,,19/1/2022 7:23
1/12/2021,Pathum Thani,46,42295,1190060,563851,626209,105228,104299,929,93,54,19/1/2022 7:23
1/12/2021,Prachuap Khiri Khan,118,18988,553171,274049,279122,595142,593435,1707,,,19/1/2022 7:23
1/12/2021,Prachin Buri,83,25402,495325,244642,250683,101944,101780,164,102,54,19/1/2022 7:23
1/12/2021,Pattani,119,46408,729581,360348,369233,7237,7237,0,,,19/1/2022 7:23
1/12/2021,Phra Nakhon Si Ayutthaya,44,32716,820512,394024,426488,506314,497703,8611,88,64,19/1/2022 7:23
1/12/2021,Phayao,24,2613,464505,225943,238562,78112,77046,1066,79,37,19/1/2022 7:23
1/12/2021,Phang-nga,48,6488,268016,133785,134231,174747,140351,34396,,,19/1/2022 7:23
1/12/2021,Phatthalung,63,12205,522541,254425,268116,39244,39244,0,,,19/1/2022 7:23
1/12/2021,Phichit,10,5327,529395,258012,271383,47217,47125,92,,,19/1/2022 7:23
1/12/2021,Phitsanulok,54,8143,847384,414577,432807,202694,202078,616,,,19/1/2022 7:23
1/12/2021,Phuket,94,17874,418785,197874,220911,261943,167948,93995,31,22,19/1/2022 7:23
1/12/2021,Maha Sarakham,17,11216,948310,464976,483334,33099,33059,40,,,19/1/2022 7:23
1/12/2021,Mukdahan,39,2493,351484,175633,175851,96965,96923,42,,,19/1/2022 7:23
1/12/2021,Yala,87,47196,542314,269907,272407,48470,48470,0,47,14,19/1/2022 7:23
1/12/2021,Yasothon,3,5975,533394,265945,267449,38817,38817,0,,,19/1/2022 7:23
1/12/2021,Ranong,24,9922,194573,98136,96437,21868,21760,108,,,19/1/2022 7:23
1/12/2021,Rayong,43,45689,751343,368992,382351,442667,440059,2608,104,35,19/1/2022 7:23
1/12/2021,Ratchaburi,68,42807,868281,421921,446360,187297,186671,626,,,19/1/2022 7:23
1/12/2021,Roi Et,11,14232,1296013,641883,654130,44247,44214,33,,,19/1/2022 7:23
1/12/2021,Lop Buri,30,18050,739473,368733,370740,265330,265144,186,,,19/1/2022 7:23
1/12/2021,Lampang,10,3034,724678,352894,371784,147515,146727,788,73, ,19/1/2022 7:23
1/12/2021,Lamphun,73,3893,401139,192712,208427,95420,94339,1081,,,19/1/2022 7:23
1/12/2021,Si Sa Ket,93,18586,1457556,725426,732130,69970,69958,12,,,19/1/2022 7:23
1/12/2021,Sakon Nakhon,1,7815,1146286,569364,576922,123784,123753,31,,,19/1/2022 7:23
1/12/2021,Songkhla,328,63334,1431536,697256,734280,111186,110907,279,43,20,19/1/2022 7:23
1/12/2021,Satun,52,7603,324835,161640,163195,118953,118571,382,20,26,19/1/2022 7:23
1/12/2021,Samut Prakarn,148,132082,1356449,645884,710565,148306,128665,19641,,,19/1/2022 7:23
1/12/2021,Samut Songkhram,10,11939,190842,91101,99741,186767,186640,127,115,57,19/1/2022 7:23
1/12/2021,Samut Sakhon,30,111654,586789,282683,304106,49065,48960,105,91,61,19/1/2022 7:23
1/12/2021,Saraburi,62,33315,643963,316201,327762,308153,307750,403,104,73,19/1/2022 7:23
1/12/2021,Sa kaeo,54,19296,561992,280673,281319,68672,68321,351,87,41,19/1/2022 7:23
1/12/2021,Sing Buri,8,3473,204526,97144,107382,38697,38585,112,,,19/1/2022 7:23
1/12/2021,Suphan Buri,21,16200,835360,402883,432477,346794,346794,0,,,19/1/2022 7:23
1/12/2021,Surat Thani,240,25785,1072464,527349,545115,132624,124431,8193,26,12,19/1/2022 7:23
1/12/2021,Surin,15,18982,1376230,684354,691876,76048,75971,77,,,19/1/2022 7:23
1/12/2021,Sukhothai,2,6419,585352,283429,301923,77889,76248,1641,,,19/1/2022 7:23
1/12/2021,Nong Khai,12,4380,516843,256268,260575,176894,176022,872,43,39,19/1/2022 7:23
1/12/2021,Nong Bua Lam Phu,17,4582,509001,253757,255244,23866,23805,61,,,19/1/2022 7:23
1/12/2021,Amnat Charoen,0,3062,376350,187122,189228,26300,26300,0,,,19/1/2022 7:23
1/12/2021,Udon Thani,42,25061,1566510,775357,791153,215933,215261,672,,,19/1/2022 7:23
1/12/2021,Uttaradit,3,4541,446148,217413,228735,74305,74146,159,,,19/1/2022 7:23
1/12/2021,Uthai Thani,10,3779,325116,158926,166190,46752,46752,0,,,19/1/2022 7:23
1/12/2021,Ubon Ratchathani,46,22389,1868519,932466,936053,211200,211160,40,87,39,19/1/2022 7:23
1/12/2021,Ang Thong,2,11474,274763,131399,143364,42587,42587,0,,,19/1/2022 7:23
1/12/2021,Chiang Rai,39,5558,1298425,630868,667557,362358,360119,2239,71,31,19/1/2022 7:23
1/12/2021,Chiang Mai,171,31201,1789385,864364,925021,817474,810928,6546,68,35,19/1/2022 7:23
1/12/2021,Phetchaburi,42,23924,482875,232927,249948,596099,595951,148,,,19/1/2022 7:23
1/12/2021,Phetchabun,35,12197,978372,482234,496138,196178,195552,626,,,19/1/2022 7:23
1/12/2021,Loei,10,4216,638732,319949,318783,143151,142378,773,106,48,19/1/2022 7:23
1/12/2021,Phrae,8,2000,434580,209403,225177,91286,90937,349,84,39,19/1/2022 7:23
1/12/2021,Mae Hong Son,28,2542,285916,144811,141105,114751,112339,2412,,,19/1/2022 7:23
1/12/2021,,0,173,,,,,,,,,19/1/2022 7:23
2/12/2021,Krabi,76,10510,479351,238092,241259,81255,79570,1685,,,19/1/2022 7:23
2/12/2021,Bangkok,786,453536,5527994,2592292,2935702,2543615,2383978,159637,105,56,19/1/2022 7:23
2/12/2021,Kanchanaburi,41,24090,894054,448312,445742,908851,907622,1229,60,33,19/1/2022 7:23
2/12/2021,Kalasin,5,9920,975570,481988,493582,44112,43792,320,,,19/1/2022 7:23
2/12/2021,Kamphaeng Phet,22,8255,712143,351539,360604,60392,60106,286,,,19/1/2022 7:23
2/12/2021,Khon Kaen,103,25829,1790863,879849,911014,356626,354735,1891,93,56,19/1/2022 7:23
2/12/2021,Chanthaburi,48,22241,536557,262257,274300,132403,132126,277,,,19/1/2022 7:23
2/12/2021,Chachoengsao,50,37320,724178,354834,369344,350064,349850,214,78,48,19/1/2022 7:23
2/12/2021,Chon Buri,139,110793,1583672,772463,811209,975534,964356,11178,79,41,19/1/2022 7:23
2/12/2021,Chai Nat,9,2785,320432,153962,166470,51161,51147,14,,,19/1/2022 7:23
2/12/2021,Chaiyaphum,8,12185,1122265,554299,567966,99618,99364,254,,,19/1/2022 7:23
2/12/2021,Chumphon,46,15301,509479,251405,258074,70890,70798,92,,,19/1/2022 7:23
2/12/2021,Trang,88,16201,639788,312693,327095,91461,91339,122,,,19/1/2022 7:23
2/12/2021,Trat,23,8903,228376,112941,115435,133130,130498,2632,,,19/1/2022 7:23
2/12/2021,Tak,87,25204,676583,341966,334617,109369,109331,38,,,19/1/2022 7:23
2/12/2021,Nakhon Nayok,21,11554,260433,128854,131579,170360,170245,115,,,19/1/2022 7:23
2/12/2021,Nakhon Pathom,10,35922,922171,442800,479371,216272,216000,272,93,54,19/1/2022 7:23
2/12/2021,Nakhon Phanom,0,5010,717040,357096,359944,101214,101189,25,,,19/1/2022 7:23
2/12/2021,Nakhon Ratchasima,46,34861,2634154,1293783,1340371,571339,566844,4495,86,43,19/1/2022 7:23
2/12/2021,Nakhon Si Thammarat,329,41991,1549344,764471,784873,138859,138776,83,,,19/1/2022 7:23
2/12/2021,Nakhon Sawan,57,16981,1035028,504657,530371,112947,112567,380,88,53,19/1/2022 7:23
2/12/2021,Nonthaburi,34,68473,1288637,599167,689470,160119,158826,1293,80, ,19/1/2022 7:23
2/12/2021,Narathiwat,26,42086,809660,400501,409159,5393,5393,0,42,20,19/1/2022 7:23
2/12/2021,Nan,1,2730,475875,237959,237916,132711,131256,1455,,,19/1/2022 7:23
2/12/2021,Bueng Kan,23,2323,421995,211494,210501,49966,49403,563,,,19/1/2022 7:23
2/12/2021,Buri Ram,29,17333,1579805,783531,796274,127140,126290,850,,,19/1/2022 7:23
2/12/2021,Pathum Thani,46,42341,1190060,563851,626209,105228,104299,929,94,53,19/1/2022 7:23
2/12/2021,Prachuap Khiri Khan,133,19121,553171,274049,279122,595142,593435,1707,,,19/1/2022 7:23
2/12/2021,Prachin Buri,62,25464,495325,244642,250683,101944,101780,164,100,52,19/1/2022 7:23
2/12/2021,Pattani,139,46547,729581,360348,369233,7237,7237,0,,,19/1/2022 7:23
2/12/2021,Phra Nakhon Si Ayutthaya,37,32753,820512,394024,426488,506314,497703,8611,75,65,19/1/2022 7:23
2/12/2021,Phayao,24,2637,464505,225943,238562,78112,77046,1066,91,39,19/1/2022 7:23
2/12/2021,Phang-nga,65,6553,268016,133785,134231,174747,140351,34396,,,19/1/2022 7:23
2/12/2021,Phatthalung,89,12294,522541,254425,268116,39244,39244,0,,,19/1/2022 7:23
2/12/2021,Phichit,6,5333,529395,258012,271383,47217,47125,92,,,19/1/2022 7:23
2/12/2021,Phitsanulok,61,8204,847384,414577,432807,202694,202078,616,,,19/1/2022 7:23
2/12/2021,Phuket,102,17976,418785,197874,220911,261943,167948,93995,33,31,19/1/2022 7:23
2/12/2021,Maha Sarakham,13,11229,948310,464976,483334,33099,33059,40,,,19/1/2022 7:23
2/12/2021,Mukdahan,14,2507,351484,175633,175851,96965,96923,42,,,19/1/2022 7:23
2/12/2021,Yala,109,47305,542314,269907,272407,48470,48470,0,39,24,19/1/2022 7:23
2/12/2021,Yasothon,13,5988,533394,265945,267449,38817,38817,0,,,19/1/2022 7:23
2/12/2021,Ranong,16,9938,194573,98136,96437,21868,21760,108,,,19/1/2022 7:23
2/12/2021,Rayong,79,45768,751343,368992,382351,442667,440059,2608,79,30,19/1/2022 7:23
2/12/2021,Ratchaburi,79,42886,868281,421921,446360,187297,186671,626,,,19/1/2022 7:23
2/12/2021,Roi Et,18,14250,1296013,641883,654130,44247,44214,33,,,19/1/2022 7:23
2/12/2021,Lop Buri,52,18102,739473,368733,370740,265330,265144,186,,,19/1/2022 7:23
2/12/2021,Lampang,10,3044,724678,352894,371784,147515,146727,788,89, ,19/1/2022 7:23
2/12/2021,Lamphun,98,3991,401139,192712,208427,95420,94339,1081,,,19/1/2022 7:23
2/12/2021,Si Sa Ket,92,18678,1457556,725426,732130,69970,69958,12,,,19/1/2022 7:23
2/12/2021,Sakon Nakhon,3,7818,1146286,569364,576922,123784,123753,31,,,19/1/2022 7:23
2/12/2021,Songkhla,397,63731,1431536,697256,734280,111186,110907,279,40,28,19/1/2022 7:23
2/12/2021,Satun,68,7671,324835,161640,163195,118953,118571,382,22,35,19/1/2022 7:23
2/12/2021,Samut Prakarn,141,132223,1356449,645884,710565,148306,128665,19641,,,19/1/2022 7:23
2/12/2021,Samut Songkhram,14,11953,190842,91101,99741,186767,186640,127,116,56,19/1/2022 7:23
2/12/2021,Samut Sakhon,23,111677,586789,282683,304106,49065,48960,105,104,62,19/1/2022 7:23
2/12/2021,Saraburi,58,33373,643963,316201,327762,308153,307750,403,101,77,19/1/2022 7:23
2/12/2021,Sa kaeo,26,19322,561992,280673,281319,68672,68321,351,78,42,19/1/2022 7:23
2/12/2021,Sing Buri,13,3486,204526,97144,107382,38697,38585,112,,,19/1/2022 7:23
2/12/2021,Suphan Buri,41,16241,835360,402883,432477,346794,346794,0,,,19/1/2022 7:23
2/12/2021,Surat Thani,196,25981,1072464,527349,545115,132624,124431,8193,24,14,19/1/2022 7:23
2/12/2021,Surin,9,18991,1376230,684354,691876,76048,75971,77,,,19/1/2022 7:23
2/12/2021,Sukhothai,3,6422,585352,283429,301923,77889,76248,1641,,,19/1/2022 7:23
2/12/2021,Nong Khai,4,4384,516843,256268,260575,176894,176022,872,53,44,19/1/2022 7:23
2/12/2021,Nong Bua Lam Phu,11,4593,509001,253757,255244,23866,23805,61,,,19/1/2022 7:23
2/12/2021,Amnat Charoen,4,3066,376350,187122,189228,26300,26300,0,,,19/1/2022 7:23
2/12/2021,Udon Thani,53,25114,1566510,775357,791153,215933,215261,672,,,19/1/2022 7:23
2/12/2021,Uttaradit,7,4548,446148,217413,228735,74305,74146,159,,,19/1/2022 7:23
2/12/2021,Uthai Thani,10,3789,325116,158926,166190,46752,46752,0,,,19/1/2022 7:23
2/12/2021,Ubon Ratchathani,50,22439,1868519,932466,936053,211200,211160,40,66,45,19/1/2022 7:23
2/12/2021,Ang Thong,4,11478,274763,131399,143364,42587,42587,0,,,19/1/2022 7:23
2/12/2021,Chiang Rai,31,5589,1298425,630868,667557,362358,360119,2239,84,36,19/1/2022 7:23
2/12/2021,Chiang Mai,208,31409,1789385,864364,925021,817474,810928,6546,79,34,19/1/2022 7:23
2/12/2021,Phetchaburi,28,23952,482875,232927,249948,596099,595951,148,,,19/1/2022 7:23
2/12/2021,Phetchabun,11,12208,978372,482234,496138,196178,195552,626,,,19/1/2022 7:23
2/12/2021,Loei,8,4224,638732,319949,318783,143151,142378,773,100,47,19/1/2022 7:23
2/12/2021,Phrae,8,2008,434580,209403,225177,91286,90937,349,88,39,19/1/2022 7:23
2/12/2021,Mae Hong Son,78,2620,285916,144811,141105,114751,112339,2412,,,19/1/2022 7:23
2/12/2021,,0,173,,,,,,,,,19/1/2022 7:23
3/12/2021,Krabi,73,10583,479351,238092,241259,81255,79570,1685,,,19/1/2022 7:23
3/12/2021,Bangkok,699,454235,5527994,2592292,2935702,2543615,2383978,159637,102,56,19/1/2022 7:23
3/12/2021,Kanchanaburi,84,24174,894054,448312,445742,908851,907622,1229,61,31,19/1/2022 7:23
3/12/2021,Kalasin,12,9932,975570,481988,493582,44112,43792,320,,,19/1/2022 7:23
3/12/2021,Kamphaeng Phet,23,8278,712143,351539,360604,60392,60106,286,,,19/1/2022 7:23
3/12/2021,Khon Kaen,103,25932,1790863,879849,911014,356626,354735,1891,99,63,19/1/2022 7:23
3/12/2021,Chanthaburi,49,22290,536557,262257,274300,132403,132126,277,,,19/1/2022 7:23
3/12/2021,Chachoengsao,50,37370,724178,354834,369344,350064,349850,214,73,51,19/1/2022 7:23
3/12/2021,Chon Buri,178,110971,1583672,772463,811209,975534,964356,11178,73,46,19/1/2022 7:23
3/12/2021,Chai Nat,9,2794,320432,153962,166470,51161,51147,14,,,19/1/2022 7:23
3/12/2021,Chaiyaphum,17,12202,1122265,554299,567966,99618,99364,254,,,19/1/2022 7:23
3/12/2021,Chumphon,40,15341,509479,251405,258074,70890,70798,92,,,19/1/2022 7:23
3/12/2021,Trang,87,16288,639788,312693,327095,91461,91339,122,,,19/1/2022 7:23
3/12/2021,Trat,36,8939,228376,112941,115435,133130,130498,2632,,,19/1/2022 7:23
3/12/2021,Tak,70,25274,676583,341966,334617,109369,109331,38,,,19/1/2022 7:23
3/12/2021,Nakhon Nayok,12,11566,260433,128854,131579,170360,170245,115,,,19/1/2022 7:23
3/12/2021,Nakhon Pathom,23,35945,922171,442800,479371,216272,216000,272,93,62,19/1/2022 7:23
3/12/2021,Nakhon Phanom,0,5010,717040,357096,359944,101214,101189,25,,,19/1/2022 7:23
3/12/2021,Nakhon Ratchasima,77,34938,2634154,1293783,1340371,571339,566844,4495,85,51,19/1/2022 7:23
3/12/2021,Nakhon Si Thammarat,414,42405,1549344,764471,784873,138859,138776,83,,,19/1/2022 7:23
3/12/2021,Nakhon Sawan,30,17011,1035028,504657,530371,112947,112567,380,95,52,19/1/2022 7:23
3/12/2021,Nonthaburi,63,68536,1288637,599167,689470,160119,158826,1293,80, ,19/1/2022 7:23
3/12/2021,Narathiwat,25,42111,809660,400501,409159,5393,5393,0,53,26,19/1/2022 7:23
3/12/2021,Nan,20,2750,475875,237959,237916,132711,131256,1455,,,19/1/2022 7:23
3/12/2021,Bueng Kan,18,2341,421995,211494,210501,49966,49403,563,,,19/1/2022 7:23
3/12/2021,Buri Ram,17,17350,1579805,783531,796274,127140,126290,850,,,19/1/2022 7:23
3/12/2021,Pathum Thani,80,42421,1190060,563851,626209,105228,104299,929,87,55,19/1/2022 7:23
3/12/2021,Prachuap Khiri Khan,82,19203,553171,274049,279122,595142,593435,1707,,,19/1/2022 7:23
3/12/2021,Prachin Buri,50,25514,495325,244642,250683,101944,101780,164,87,55,19/1/2022 7:23
3/12/2021,Pattani,209,46756,729581,360348,369233,7237,7237,0,,,19/1/2022 7:23
3/12/2021,Phra Nakhon Si Ayutthaya,66,32819,820512,394024,426488,506314,497703,8611,75,70,19/1/2022 7:23
3/12/2021,Phayao,11,2648,464505,225943,238562,78112,77046,1066,90,33,19/1/2022 7:23
3/12/2021,Phang-nga,74,6627,268016,133785,134231,174747,140351,34396,,,19/1/2022 7:23
3/12/2021,Phatthalung,88,12382,522541,254425,268116,39244,39244,0,,,19/1/2022 7:23
3/12/2021,Phichit,6,5339,529395,258012,271383,47217,47125,92,,,19/1/2022 7:23
3/12/2021,Phitsanulok,59,8263,847384,414577,432807,202694,202078,616,,,19/1/2022 7:23
3/12/2021,Phuket,87,18063,418785,197874,220911,261943,167948,93995,61,32,19/1/2022 7:23
3/12/2021,Maha Sarakham,4,11233,948310,464976,483334,33099,33059,40,,,19/1/2022 7:23
3/12/2021,Mukdahan,0,2507,351484,175633,175851,96965,96923,42,,,19/1/2022 7:23
3/12/2021,Yala,103,47408,542314,269907,272407,48470,48470,0,48,27,19/1/2022 7:23
3/12/2021,Yasothon,18,6006,533394,265945,267449,38817,38817,0,,,19/1/2022 7:23
3/12/2021,Ranong,2,9940,194573,98136,96437,21868,21760,108,,,19/1/2022 7:23
3/12/2021,Rayong,61,45829,751343,368992,382351,442667,440059,2608,65,41,19/1/2022 7:23
3/12/2021,Ratchaburi,113,42999,868281,421921,446360,187297,186671,626,,,19/1/2022 7:23
3/12/2021,Roi Et,18,14268,1296013,641883,654130,44247,44214,33,,,19/1/2022 7:23
3/12/2021,Lop Buri,52,18154,739473,368733,370740,265330,265144,186,,,19/1/2022 7:23
3/12/2021,Lampang,14,3058,724678,352894,371784,147515,146727,788,95, ,19/1/2022 7:23
3/12/2021,Lamphun,30,4021,401139,192712,208427,95420,94339,1081,,,19/1/2022 7:23
3/12/2021,Si Sa Ket,117,18795,1457556,725426,732130,69970,69958,12,,,19/1/2022 7:23
3/12/2021,Sakon Nakhon,5,7823,1146286,569364,576922,123784,123753,31,,,19/1/2022 7:23
3/12/2021,Songkhla,339,64070,1431536,697256,734280,111186,110907,279,56,30,19/1/2022 7:23
3/12/2021,Satun,82,7753,324835,161640,163195,118953,118571,382,48,34,19/1/2022 7:23
3/12/2021,Samut Prakarn,119,132342,1356449,645884,710565,148306,128665,19641,,,19/1/2022 7:23
3/12/2021,Samut Songkhram,5,11958,190842,91101,99741,186767,186640,127,116,64,19/1/2022 7:23
3/12/2021,Samut Sakhon,23,111700,586789,282683,304106,49065,48960,105,98,63,19/1/2022 7:23
3/12/2021,Saraburi,46,33419,643963,316201,327762,308153,307750,403,102,86,19/1/2022 7:23
3/12/2021,Sa kaeo,41,19363,561992,280673,281319,68672,68321,351,85,43,19/1/2022 7:23
3/12/2021,Sing Buri,7,3493,204526,97144,107382,38697,38585,112,,,19/1/2022 7:23
3/12/2021,Suphan Buri,17,16258,835360,402883,432477,346794,346794,0,,,19/1/2022 7:23
3/12/2021,Surat Thani,181,26162,1072464,527349,545115,132624,124431,8193,57,25,19/1/2022 7:23
3/12/2021,Surin,7,18998,1376230,684354,691876,76048,75971,77,,,19/1/2022 7:23
3/12/2021,Sukhothai,1,6423,585352,283429,301923,77889,76248,1641,,,19/1/2022 7:23
3/12/2021,Nong Khai,17,4401,516843,256268,260575,176894,176022,872,61,51,19/1/2022 7:23
3/12/2021,Nong Bua Lam Phu,10,4603,509001,253757,255244,23866,23805,61,,,19/1/2022 7:23
3/12/2021,Amnat Charoen,3,3069,376350,187122,189228,26300,26300,0,,,19/1/2022 7:23
3/12/2021,Udon Thani,45,25159,1566510,775357,791153,215933,215261,672,,,19/1/2022 7:23
3/12/2021,Uttaradit,7,4555,446148,217413,228735,74305,74146,159,,,19/1/2022 7:23
3/12/2021,Uthai Thani,3,3792,325116,158926,166190,46752,46752,0,,,19/1/2022 7:23
3/12/2021,Ubon Ratchathani,62,22501,1868519,932466,936053,211200,211160,40,76,50,19/1/2022 7:23
3/12/2021,Ang Thong,7,11485,274763,131399,143364,42587,42587,0,,,19/1/2022 7:23
3/12/2021,Chiang Rai,20,5609,1298425,630868,667557,362358,360119,2239,93,36,19/1/2022 7:23
3/12/2021,Chiang Mai,179,31588,1789385,864364,925021,817474,810928,6546,76,36,19/1/2022 7:23
3/12/2021,Phetchaburi,38,23990,482875,232927,249948,596099,595951,148,,,19/1/2022 7:23
3/12/2021,Phetchabun,19,12227,978372,482234,496138,196178,195552,626,,,19/1/2022 7:23
3/12/2021,Loei,8,4232,638732,319949,318783,143151,142378,773,99,47,19/1/2022 7:23
3/12/2021,Phrae,7,2015,434580,209403,225177,91286,90937,349,90,42,19/1/2022 7:23
3/12/2021,Mae Hong Son,41,2661,285916,144811,141105,114751,112339,2412,,,19/1/2022 7:23
3/12/2021,,0,173,,,,,,,,,19/1/2022 7:23
4/12/2021,Krabi,69,10652,479351,238092,241259,81255,79570,1685,,,19/1/2022 7:23
4/12/2021,Bangkok,943,455178,5527994,2592292,2935702,2543615,2383978,159637,103,59,19/1/2022 7:23
4/12/2021,Kanchanaburi,27,24201,894054,448312,445742,908851,907622,1229,61,34,19/1/2022 7:23
4/12/2021,Kalasin,16,9948,975570,481988,493582,44112,43792,320,,,19/1/2022 7:23
4/12/2021,Kamphaeng Phet,8,8286,712143,351539,360604,60392,60106,286,,,19/1/2022 7:23
4/12/2021,Khon Kaen,62,25994,1790863,879849,911014,356626,354735,1891,113,60,19/1/2022 7:23
4/12/2021,Chanthaburi,39,22329,536557,262257,274300,132403,132126,277,,,19/1/2022 7:23
4/12/2021,Chachoengsao,44,37414,724178,354834,369344,350064,349850,214,79,56,19/1/2022 7:23
4/12/2021,Chon Buri,169,111140,1583672,772463,811209,975534,964356,11178,77,52,19/1/2022 7:23
4/12/2021,Chai Nat,10,2804,320432,153962,166470,51161,51147,14,,,19/1/2022 7:23
4/12/2021,Chaiyaphum,14,12216,1122265,554299,567966,99618,99364,254,,,19/1/2022 7:23
4/12/2021,Chumphon,60,15401,509479,251405,258074,70890,70798,92,,,19/1/2022 7:23
4/12/2021,Trang,89,16377,639788,312693,327095,91461,91339,122,,,19/1/2022 7:23
4/12/2021,Trat,25,8964,228376,112941,115435,133130,130498,2632,,,19/1/2022 7:23
4/12/2021,Tak,80,25354,676583,341966,334617,109369,109331,38,,,19/1/2022 7:23
4/12/2021,Nakhon Nayok,15,11581,260433,128854,131579,170360,170245,115,,,19/1/2022 7:23
4/12/2021,Nakhon Pathom,37,35982,922171,442800,479371,216272,216000,272,116,65,19/1/2022 7:23
4/12/2021,Nakhon Phanom,3,5013,717040,357096,359944,101214,101189,25,,,19/1/2022 7:23
4/12/2021,Nakhon Ratchasima,61,34999,2634154,1293783,1340371,571339,566844,4495,98,53,19/1/2022 7:23
4/12/2021,Nakhon Si Thammarat,397,42802,1549344,764471,784873,138859,138776,83,,,19/1/2022 7:23
4/12/2021,Nakhon Sawan,26,17037,1035028,504657,530371,112947,112567,380,93,56,19/1/2022 7:23
4/12/2021,Nonthaburi,59,68595,1288637,599167,689470,160119,158826,1293,81, ,19/1/2022 7:23
4/12/2021,Narathiwat,37,42148,809660,400501,409159,5393,5393,0,58,31,19/1/2022 7:23
4/12/2021,Nan,6,2756,475875,237959,237916,132711,131256,1455,,,19/1/2022 7:23
4/12/2021,Bueng Kan,18,2359,421995,211494,210501,49966,49403,563,,,19/1/2022 7:23
4/12/2021,Buri Ram,12,17362,1579805,783531,796274,127140,126290,850,,,19/1/2022 7:23
4/12/2021,Pathum Thani,57,42478,1190060,563851,626209,105228,104299,929,90,55,19/1/2022 7:23
4/12/2021,Prachuap Khiri Khan,75,19278,553171,274049,279122,595142,593435,1707,,,19/1/2022 7:23
4/12/2021,Prachin Buri,94,25608,495325,244642,250683,101944,101780,164,96,56,19/1/2022 7:23
4/12/2021,Pattani,160,46916,729581,360348,369233,7237,7237,0,,,19/1/2022 7:23
4/12/2021,Phra Nakhon Si Ayutthaya,45,32864,820512,394024,426488,506314,497703,8611,78,69,19/1/2022 7:23
4/12/2021,Phayao,4,2652,464505,225943,238562,78112,77046,1066,85,36,19/1/2022 7:23
4/12/2021,Phang-nga,61,6688,268016,133785,134231,174747,140351,34396,,,19/1/2022 7:23
4/12/2021,Phatthalung,81,12463,522541,254425,268116,39244,39244,0,,,19/1/2022 7:23
4/12/2021,Phichit,12,5351,529395,258012,271383,47217,47125,92,,,19/1/2022 7:23
4/12/2021,Phitsanulok,63,8326,847384,414577,432807,202694,202078,616,,,19/1/2022 7:23
4/12/2021,Phuket,79,18142,418785,197874,220911,261943,167948,93995,59,41,19/1/2022 7:23
4/12/2021,Maha Sarakham,2,11235,948310,464976,483334,33099,33059,40,,,19/1/2022 7:23
4/12/2021,Mukdahan,12,2519,351484,175633,175851,96965,96923,42,,,19/1/2022 7:23
4/12/2021,Yala,120,47528,542314,269907,272407,48470,48470,0,55,36,19/1/2022 7:23
4/12/2021,Yasothon,17,6023,533394,265945,267449,38817,38817,0,,,19/1/2022 7:23
4/12/2021,Ranong,14,9954,194573,98136,96437,21868,21760,108,,,19/1/2022 7:23
4/12/2021,Rayong,51,45880,751343,368992,382351,442667,440059,2608,83,43,19/1/2022 7:23
4/12/2021,Ratchaburi,1047,44046,868281,421921,446360,187297,186671,626,,,19/1/2022 7:23
4/12/2021,Roi Et,11,14279,1296013,641883,654130,44247,44214,33,,,19/1/2022 7:23
4/12/2021,Lop Buri,30,18184,739473,368733,370740,265330,265144,186,,,19/1/2022 7:23
4/12/2021,Lampang,22,3080,724678,352894,371784,147515,146727,788,101, ,19/1/2022 7:23
4/12/2021,Lamphun,70,4091,401139,192712,208427,95420,94339,1081,,,19/1/2022 7:23
4/12/2021,Si Sa Ket,122,18917,1457556,725426,732130,69970,69958,12,,,19/1/2022 7:23
4/12/2021,Sakon Nakhon,2,7825,1146286,569364,576922,123784,123753,31,,,19/1/2022 7:23
4/12/2021,Songkhla,327,64397,1431536,697256,734280,111186,110907,279,86,30,19/1/2022 7:23
4/12/2021,Satun,79,7832,324835,161640,163195,118953,118571,382,38,31,19/1/2022 7:23
4/12/2021,Samut Prakarn,130,132472,1356449,645884,710565,148306,128665,19641,,,19/1/2022 7:23
4/12/2021,Samut Songkhram,5,11963,190842,91101,99741,186767,186640,127,134,66,19/1/2022 7:23
4/12/2021,Samut Sakhon,25,111725,586789,282683,304106,49065,48960,105,103,60,19/1/2022 7:23
4/12/2021,Saraburi,49,33468,643963,316201,327762,308153,307750,403,112,70,19/1/2022 7:23
4/12/2021,Sa kaeo,30,19393,561992,280673,281319,68672,68321,351,82,47,19/1/2022 7:23
4/12/2021,Sing Buri,7,3500,204526,97144,107382,38697,38585,112,,,19/1/2022 7:23
4/12/2021,Suphan Buri,16,16274,835360,402883,432477,346794,346794,0,,,19/1/2022 7:23
4/12/2021,Surat Thani,169,26331,1072464,527349,545115,132624,124431,8193,58,31,19/1/2022 7:23
4/12/2021,Surin,11,19009,1376230,684354,691876,76048,75971,77,,,19/1/2022 7:23
4/12/2021,Sukhothai,0,6423,585352,283429,301923,77889,76248,1641,,,19/1/2022 7:23
4/12/2021,Nong Khai,9,4410,516843,256268,260575,176894,176022,872,73,52,19/1/2022 7:23
4/12/2021,Nong Bua Lam Phu,5,4608,509001,253757,255244,23866,23805,61,,,19/1/2022 7:23
4/12/2021,Amnat Charoen,5,3074,376350,187122,189228,26300,26300,0,,,19/1/2022 7:23
4/12/2021,Udon Thani,38,25197,1566510,775357,791153,215933,215261,672,,,19/1/2022 7:23
4/12/2021,Uttaradit,8,4563,446148,217413,228735,74305,74146,159,,,19/1/2022 7:23
4/12/2021,Uthai Thani,3,3795,325116,158926,166190,46752,46752,0,,,19/1/2022 7:23
4/12/2021,Ubon Ratchathani,65,22566,1868519,932466,936053,211200,211160,40,84,45,19/1/2022 7:23
4/12/2021,Ang Thong,11,11496,274763,131399,143364,42587,42587,0,,,19/1/2022 7:23
4/12/2021,Chiang Rai,29,5638,1298425,630868,667557,362358,360119,2239,93,35,19/1/2022 7:23
4/12/2021,Chiang Mai,153,31741,1789385,864364,925021,817474,810928,6546,80,37,19/1/2022 7:23
4/12/2021,Phetchaburi,37,24027,482875,232927,249948,596099,595951,148,,,19/1/2022 7:23
4/12/2021,Phetchabun,18,12245,978372,482234,496138,196178,195552,626,,,19/1/2022 7:23
4/12/2021,Loei,48,4280,638732,319949,318783,143151,142378,773,96,53,19/1/2022 7:23
4/12/2021,Phrae,1,2016,434580,209403,225177,91286,90937,349,98,39,19/1/2022 7:23
4/12/2021,Mae Hong Son,41,2702,285916,144811,141105,114751,112339,2412,,,19/1/2022 7:23
4/12/2021,,0,173,,,,,,,,,19/1/2022 7:23
5/12/2021,Krabi,66,10718,479351,238092,241259,81255,79570,1685,,,19/1/2022 7:23
5/12/2021,Bangkok,795,455973,5527994,2592292,2935702,2543615,2383978,159637,109,58,19/1/2022 7:23
5/12/2021,Kanchanaburi,25,24226,894054,448312,445742,908851,907622,1229,66,34,19/1/2022 7:23
5/12/2021,Kalasin,8,9956,975570,481988,493582,44112,43792,320,,,19/1/2022 7:23
5/12/2021,Kamphaeng Phet,10,8296,712143,351539,360604,60392,60106,286,,,19/1/2022 7:23
5/12/2021,Khon Kaen,127,26121,1790863,879849,911014,356626,354735,1891,112,64,19/1/2022 7:23
5/12/2021,Chanthaburi,29,22358,536557,262257,274300,132403,132126,277,,,19/1/2022 7:23
5/12/2021,Chachoengsao,63,37477,724178,354834,369344,350064,349850,214,97,51,19/1/2022 7:23
5/12/2021,Chon Buri,174,111314,1583672,772463,811209,975534,964356,11178,87,46,19/1/2022 7:23
5/12/2021,Chai Nat,12,2816,320432,153962,166470,51161,51147,14,,,19/1/2022 7:23
5/12/2021,Chaiyaphum,7,12223,1122265,554299,567966,99618,99364,254,,,19/1/2022 7:23
5/12/2021,Chumphon,91,15492,509479,251405,258074,70890,70798,92,,,19/1/2022 7:23
5/12/2021,Trang,85,16462,639788,312693,327095,91461,91339,122,,,19/1/2022 7:23
5/12/2021,Trat,24,8988,228376,112941,115435,133130,130498,2632,,,19/1/2022 7:23
5/12/2021,Tak,42,25396,676583,341966,334617,109369,109331,38,,,19/1/2022 7:23
5/12/2021,Nakhon Nayok,15,11596,260433,128854,131579,170360,170245,115,,,19/1/2022 7:23
5/12/2021,Nakhon Pathom,33,36015,922171,442800,479371,216272,216000,272,119,64,19/1/2022 7:23
5/12/2021,Nakhon Phanom,7,5020,717040,357096,359944,101214,101189,25,,,19/1/2022 7:23
5/12/2021,Nakhon Ratchasima,76,35075,2634154,1293783,1340371,571339,566844,4495,106,53,19/1/2022 7:23
5/12/2021,Nakhon Si Thammarat,420,43222,1549344,764471,784873,138859,138776,83,,,19/1/2022 7:23
5/12/2021,Nakhon Sawan,37,17074,1035028,504657,530371,112947,112567,380,102,61,19/1/2022 7:23
5/12/2021,Nonthaburi,45,68640,1288637,599167,689470,160119,158826,1293,84, ,19/1/2022 7:23
5/12/2021,Narathiwat,28,42176,809660,400501,409159,5393,5393,0,60,31,19/1/2022 7:23
5/12/2021,Nan,29,2785,475875,237959,237916,132711,131256,1455,,,19/1/2022 7:23
5/12/2021,Bueng Kan,39,2398,421995,211494,210501,49966,49403,563,,,19/1/2022 7:23
5/12/2021,Buri Ram,23,17385,1579805,783531,796274,127140,126290,850,,,19/1/2022 7:23
5/12/2021,Pathum Thani,46,42524,1190060,563851,626209,105228,104299,929,92,58,19/1/2022 7:23
5/12/2021,Prachuap Khiri Khan,77,19355,553171,274049,279122,595142,593435,1707,,,19/1/2022 7:23
5/12/2021,Prachin Buri,64,25672,495325,244642,250683,101944,101780,164,103,54,19/1/2022 7:23
5/12/2021,Pattani,182,47098,729581,360348,369233,7237,7237,0,,,19/1/2022 7:23
5/12/2021,Phra Nakhon Si Ayutthaya,46,32910,820512,394024,426488,506314,497703,8611,86,72,19/1/2022 7:23
5/12/2021,Phayao,5,2657,464505,225943,238562,78112,77046,1066,90,42,19/1/2022 7:23
5/12/2021,Phang-nga,68,6756,268016,133785,134231,174747,140351,34396,,,19/1/2022 7:23
5/12/2021,Phatthalung,76,12539,522541,254425,268116,39244,39244,0,,,19/1/2022 7:23
5/12/2021,Phichit,6,5357,529395,258012,271383,47217,47125,92,,,19/1/2022 7:23
5/12/2021,Phitsanulok,50,8376,847384,414577,432807,202694,202078,616,,,19/1/2022 7:23
5/12/2021,Phuket,70,18212,418785,197874,220911,261943,167948,93995,69,41,19/1/2022 7:23
5/12/2021,Maha Sarakham,4,11239,948310,464976,483334,33099,33059,40,,,19/1/2022 7:23
5/12/2021,Mukdahan,8,2527,351484,175633,175851,96965,96923,42,,,19/1/2022 7:23
5/12/2021,Yala,97,47625,542314,269907,272407,48470,48470,0,64,31,19/1/2022 7:23
5/12/2021,Yasothon,1,6024,533394,265945,267449,38817,38817,0,,,19/1/2022 7:23
5/12/2021,Ranong,8,9962,194573,98136,96437,21868,21760,108,,,19/1/2022 7:23
5/12/2021,Rayong,66,45946,751343,368992,382351,442667,440059,2608,90,37,19/1/2022 7:23
5/12/2021,Ratchaburi,68,44114,868281,421921,446360,187297,186671,626,,,19/1/2022 7:23
5/12/2021,Roi Et,17,14296,1296013,641883,654130,44247,44214,33,,,19/1/2022 7:23
5/12/2021,Lop Buri,47,18231,739473,368733,370740,265330,265144,186,,,19/1/2022 7:23
5/12/2021,Lampang,39,3119,724678,352894,371784,147515,146727,788,100, ,19/1/2022 7:23
5/12/2021,Lamphun,39,4130,401139,192712,208427,95420,94339,1081,,,19/1/2022 7:23
5/12/2021,Si Sa Ket,64,18981,1457556,725426,732130,69970,69958,12,,,19/1/2022 7:23
5/12/2021,Sakon Nakhon,6,7831,1146286,569364,576922,123784,123753,31,,,19/1/2022 7:23
5/12/2021,Songkhla,328,64725,1431536,697256,734280,111186,110907,279,60,33,19/1/2022 7:23
5/12/2021,Satun,75,7907,324835,161640,163195,118953,118571,382,33,34,19/1/2022 7:23
5/12/2021,Samut Prakarn,143,132615,1356449,645884,710565,148306,128665,19641,,,19/1/2022 7:23
5/12/2021,Samut Songkhram,3,11966,190842,91101,99741,186767,186640,127,143,67,19/1/2022 7:23
5/12/2021,Samut Sakhon,20,111745,586789,282683,304106,49065,48960,105,99,67,19/1/2022 7:23
5/12/2021,Saraburi,34,33502,643963,316201,327762,308153,307750,403,106,74,19/1/2022 7:23
5/12/2021,Sa kaeo,51,19444,561992,280673,281319,68672,68321,351,86,43,19/1/2022 7:23
5/12/2021,Sing Buri,2,3502,204526,97144,107382,38697,38585,112,,,19/1/2022 7:23
5/12/2021,Suphan Buri,29,16303,835360,402883,432477,346794,346794,0,,,19/1/2022 7:23
5/12/2021,Surat Thani,136,26467,1072464,527349,545115,132624,124431,8193,68,38,19/1/2022 7:23
5/12/2021,Surin,11,19020,1376230,684354,691876,76048,75971,77,,,19/1/2022 7:23
5/12/2021,Sukhothai,0,6423,585352,283429,301923,77889,76248,1641,,,19/1/2022 7:23
5/12/2021,Nong Khai,17,4427,516843,256268,260575,176894,176022,872,77,52,19/1/2022 7:23
5/12/2021,Nong Bua Lam Phu,7,4615,509001,253757,255244,23866,23805,61,,,19/1/2022 7:23
5/12/2021,Amnat Charoen,8,3082,376350,187122,189228,26300,26300,0,,,19/1/2022 7:23
5/12/2021,Udon Thani,53,25250,1566510,775357,791153,215933,215261,672,,,19/1/2022 7:23
5/12/2021,Uttaradit,2,4565,446148,217413,228735,74305,74146,159,,,19/1/2022 7:23
5/12/2021,Uthai Thani,1,3796,325116,158926,166190,46752,46752,0,,,19/1/2022 7:23
5/12/2021,Ubon Ratchathani,32,22598,1868519,932466,936053,211200,211160,40,73,45,19/1/2022 7:23
5/12/2021,Ang Thong,5,11501,274763,131399,143364,42587,42587,0,,,19/1/2022 7:23
5/12/2021,Chiang Rai,16,5654,1298425,630868,667557,362358,360119,2239,89,42,19/1/2022 7:23
5/12/2021,Chiang Mai,134,31875,1789385,864364,925021,817474,810928,6546,83,39,19/1/2022 7:23
5/12/2021,Phetchaburi,52,24079,482875,232927,249948,596099,595951,148,,,19/1/2022 7:23
5/12/2021,Phetchabun,16,12261,978372,482234,496138,196178,195552,626,,,19/1/2022 7:23
5/12/2021,Loei,26,4306,638732,319949,318783,143151,142378,773,112,54,19/1/2022 7:23
5/12/2021,Phrae,3,2019,434580,209403,225177,91286,90937,349,94,42,19/1/2022 7:23
5/12/2021,Mae Hong Son,36,2738,285916,144811,141105,114751,112339,2412,,,19/1/2022 7:23
5/12/2021,,0,173,,,,,,,,,19/1/2022 7:23
6/12/2021,Krabi,71,10789,479351,238092,241259,81255,79570,1685,,,19/1/2022 7:23
6/12/2021,Bangkok,784,456757,5527994,2592292,2935702,2543615,2383978,159637,111,64,19/1/2022 7:23
6/12/2021,Kanchanaburi,29,24255,894054,448312,445742,908851,907622,1229,66,37,19/1/2022 7:23
6/12/2021,Kalasin,9,9965,975570,481988,493582,44112,43792,320,,,19/1/2022 7:23
6/12/2021,Kamphaeng Phet,7,8303,712143,351539,360604,60392,60106,286,,,19/1/2022 7:23
6/12/2021,Khon Kaen,55,26176,1790863,879849,911014,356626,354735,1891,123,61,19/1/2022 7:23
6/12/2021,Chanthaburi,12,22370,536557,262257,274300,132403,132126,277,,,19/1/2022 7:23
6/12/2021,Chachoengsao,19,37496,724178,354834,369344,350064,349850,214,86,52,19/1/2022 7:23
6/12/2021,Chon Buri,150,111464,1583672,772463,811209,975534,964356,11178,79,48,19/1/2022 7:23
6/12/2021,Chai Nat,11,2827,320432,153962,166470,51161,51147,14,,,19/1/2022 7:23
6/12/2021,Chaiyaphum,3,12226,1122265,554299,567966,99618,99364,254,,,19/1/2022 7:23
6/12/2021,Chumphon,63,15555,509479,251405,258074,70890,70798,92,,,19/1/2022 7:23
6/12/2021,Trang,86,16548,639788,312693,327095,91461,91339,122,,,19/1/2022 7:23
6/12/2021,Trat,13,9001,228376,112941,115435,133130,130498,2632,,,19/1/2022 7:23
6/12/2021,Tak,28,25424,676583,341966,334617,109369,109331,38,,,19/1/2022 7:23
6/12/2021,Nakhon Nayok,4,11600,260433,128854,131579,170360,170245,115,,,19/1/2022 7:23
6/12/2021,Nakhon Pathom,17,36032,922171,442800,479371,216272,216000,272,111,65,19/1/2022 7:23
6/12/2021,Nakhon Phanom,10,5030,717040,357096,359944,101214,101189,25,,,19/1/2022 7:23
6/12/2021,Nakhon Ratchasima,63,35138,2634154,1293783,1340371,571339,566844,4495,112,56,19/1/2022 7:23
6/12/2021,Nakhon Si Thammarat,333,43555,1549344,764471,784873,138859,138776,83,,,19/1/2022 7:23
6/12/2021,Nakhon Sawan,59,17133,1035028,504657,530371,112947,112567,380,120,63,19/1/2022 7:23
6/12/2021,Nonthaburi,44,68684,1288637,599167,689470,160119,158826,1293,91, ,19/1/2022 7:23
6/12/2021,Narathiwat,33,42209,809660,400501,409159,5393,5393,0,70,27,19/1/2022 7:23
6/12/2021,Nan,8,2793,475875,237959,237916,132711,131256,1455,,,19/1/2022 7:23
6/12/2021,Bueng Kan,22,2420,421995,211494,210501,49966,49403,563,,,19/1/2022 7:23
6/12/2021,Buri Ram,2,17387,1579805,783531,796274,127140,126290,850,,,19/1/2022 7:23
6/12/2021,Pathum Thani,8,42532,1190060,563851,626209,105228,104299,929,98,61,19/1/2022 7:23
6/12/2021,Prachuap Khiri Khan,95,19450,553171,274049,279122,595142,593435,1707,,,19/1/2022 7:23
6/12/2021,Prachin Buri,59,25731,495325,244642,250683,101944,101780,164,97,56,19/1/2022 7:23
6/12/2021,Pattani,129,47227,729581,360348,369233,7237,7237,0,,,19/1/2022 7:23
6/12/2021,Phra Nakhon Si Ayutthaya,59,32969,820512,394024,426488,506314,497703,8611,82,75,19/1/2022 7:23
6/12/2021,Phayao,1,2658,464505,225943,238562,78112,77046,1066,98,46,19/1/2022 7:23
6/12/2021,Phang-nga,36,6792,268016,133785,134231,174747,140351,34396,,,19/1/2022 7:23
6/12/2021,Phatthalung,89,12628,522541,254425,268116,39244,39244,0,,,19/1/2022 7:23
6/12/2021,Phichit,5,5362,529395,258012,271383,47217,47125,92,,,19/1/2022 7:23
6/12/2021,Phitsanulok,40,8416,847384,414577,432807,202694,202078,616,,,19/1/2022 7:23
6/12/2021,Phuket,89,18301,418785,197874,220911,261943,167948,93995,66,30,19/1/2022 7:23
6/12/2021,Maha Sarakham,1,11240,948310,464976,483334,33099,33059,40,,,19/1/2022 7:23
6/12/2021,Mukdahan,1,2528,351484,175633,175851,96965,96923,42,,,19/1/2022 7:23
6/12/2021,Yala,84,47709,542314,269907,272407,48470,48470,0,62,30,19/1/2022 7:23
6/12/2021,Yasothon,12,6036,533394,265945,267449,38817,38817,0,,,19/1/2022 7:23
6/12/2021,Ranong,8,9970,194573,98136,96437,21868,21760,108,,,19/1/2022 7:23
6/12/2021,Rayong,39,45985,751343,368992,382351,442667,440059,2608,82,45,19/1/2022 7:23
6/12/2021,Ratchaburi,56,44170,868281,421921,446360,187297,186671,626,,,19/1/2022 7:23
6/12/2021,Roi Et,19,14315,1296013,641883,654130,44247,44214,33,,,19/1/2022 7:23
6/12/2021,Lop Buri,34,18265,739473,368733,370740,265330,265144,186,,,19/1/2022 7:23
6/12/2021,Lampang,43,3162,724678,352894,371784,147515,146727,788,101, ,19/1/2022 7:23
6/12/2021,Lamphun,68,4198,401139,192712,208427,95420,94339,1081,,,19/1/2022 7:23
6/12/2021,Si Sa Ket,78,19059,1457556,725426,732130,69970,69958,12,,,19/1/2022 7:23
6/12/2021,Sakon Nakhon,9,7840,1146286,569364,576922,123784,123753,31,,,19/1/2022 7:23
6/12/2021,Songkhla,221,64946,1431536,697256,734280,111186,110907,279,61,30,19/1/2022 7:23
6/12/2021,Satun,77,7984,324835,161640,163195,118953,118571,382,37,31,19/1/2022 7:23
6/12/2021,Samut Prakarn,91,132706,1356449,645884,710565,148306,128665,19641,,,19/1/2022 7:23
6/12/2021,Samut Songkhram,1,11967,190842,91101,99741,186767,186640,127,141,70,19/1/2022 7:23
6/12/2021,Samut Sakhon,11,111756,586789,282683,304106,49065,48960,105,110,71,19/1/2022 7:23
6/12/2021,Saraburi,59,33561,643963,316201,327762,308153,307750,403,109,85,19/1/2022 7:23
6/12/2021,Sa kaeo,31,19475,561992,280673,281319,68672,68321,351,85,45,19/1/2022 7:23
6/12/2021,Sing Buri,4,3506,204526,97144,107382,38697,38585,112,,,19/1/2022 7:23
6/12/2021,Suphan Buri,27,16330,835360,402883,432477,346794,346794,0,,,19/1/2022 7:23
6/12/2021,Surat Thani,144,26611,1072464,527349,545115,132624,124431,8193,71,35,19/1/2022 7:23
6/12/2021,Surin,12,19032,1376230,684354,691876,76048,75971,77,,,19/1/2022 7:23
6/12/2021,Sukhothai,3,6426,585352,283429,301923,77889,76248,1641,,,19/1/2022 7:23
6/12/2021,Nong Khai,5,4432,516843,256268,260575,176894,176022,872,75,50,19/1/2022 7:23
6/12/2021,Nong Bua Lam Phu,9,4624,509001,253757,255244,23866,23805,61,,,19/1/2022 7:23
6/12/2021,Amnat Charoen,0,3082,376350,187122,189228,26300,26300,0,,,19/1/2022 7:23
6/12/2021,Udon Thani,18,25268,1566510,775357,791153,215933,215261,672,,,19/1/2022 7:23
6/12/2021,Uttaradit,1,4566,446148,217413,228735,74305,74146,159,,,19/1/2022 7:23
6/12/2021,Uthai Thani,35,3831,325116,158926,166190,46752,46752,0,,,19/1/2022 7:23
6/12/2021,Ubon Ratchathani,22,22620,1868519,932466,936053,211200,211160,40,81,47,19/1/2022 7:23
6/12/2021,Ang Thong,10,11511,274763,131399,143364,42587,42587,0,,,19/1/2022 7:23
6/12/2021,Chiang Rai,11,5665,1298425,630868,667557,362358,360119,2239,104,47,19/1/2022 7:23
6/12/2021,Chiang Mai,96,31971,1789385,864364,925021,817474,810928,6546,88,48,19/1/2022 7:23
6/12/2021,Phetchaburi,35,24114,482875,232927,249948,596099,595951,148,,,19/1/2022 7:23
6/12/2021,Phetchabun,12,12273,978372,482234,496138,196178,195552,626,,,19/1/2022 7:23
6/12/2021,Loei,34,4340,638732,319949,318783,143151,142378,773,117,55,19/1/2022 7:23
6/12/2021,Phrae,3,2022,434580,209403,225177,91286,90937,349,103,48,19/1/2022 7:23
6/12/2021,Mae Hong Son,31,2769,285916,144811,141105,114751,112339,2412,,,19/1/2022 7:23
6/12/2021,,0,173,,,,,,,,,19/1/2022 7:23
7/12/2021,Krabi,76,10865,479351,238092,241259,81255,79570,1685,,,19/1/2022 7:23
7/12/2021,Bangkok,818,457575,5527994,2592292,2935702,2543615,2383978,159637,126,61,19/1/2022 7:23
7/12/2021,Kanchanaburi,24,24279,894054,448312,445742,908851,907622,1229,67,33,19/1/2022 7:23
7/12/2021,Kalasin,9,9974,975570,481988,493582,44112,43792,320,,,19/1/2022 7:23
7/12/2021,Kamphaeng Phet,1,8304,712143,351539,360604,60392,60106,286,,,19/1/2022 7:23
7/12/2021,Khon Kaen,12,26188,1790863,879849,911014,356626,354735,1891,117,61,19/1/2022 7:23
7/12/2021,Chanthaburi,20,22390,536557,262257,274300,132403,132126,277,,,19/1/2022 7:23
7/12/2021,Chachoengsao,16,37512,724178,354834,369344,350064,349850,214,88,49,19/1/2022 7:23
7/12/2021,Chon Buri,163,111627,1583672,772463,811209,975534,964356,11178,82,47,19/1/2022 7:23
7/12/2021,Chai Nat,2,2829,320432,153962,166470,51161,51147,14,,,19/1/2022 7:23
7/12/2021,Chaiyaphum,3,12229,1122265,554299,567966,99618,99364,254,,,19/1/2022 7:23
7/12/2021,Chumphon,39,15594,509479,251405,258074,70890,70798,92,,,19/1/2022 7:23
7/12/2021,Trang,80,16628,639788,312693,327095,91461,91339,122,,,19/1/2022 7:23
7/12/2021,Trat,21,9022,228376,112941,115435,133130,130498,2632,,,19/1/2022 7:23
7/12/2021,Tak,30,25454,676583,341966,334617,109369,109331,38,,,19/1/2022 7:23
7/12/2021,Nakhon Nayok,7,11607,260433,128854,131579,170360,170245,115,,,19/1/2022 7:23
7/12/2021,Nakhon Pathom,34,36066,922171,442800,479371,216272,216000,272,128,67,19/1/2022 7:23
7/12/2021,Nakhon Phanom,13,5043,717040,357096,359944,101214,101189,25,,,19/1/2022 7:23
7/12/2021,Nakhon Ratchasima,54,35192,2634154,1293783,1340371,571339,566844,4495,122,55,19/1/2022 7:23
7/12/2021,Nakhon Si Thammarat,272,43827,1549344,764471,784873,138859,138776,83,,,19/1/2022 7:23
7/12/2021,Nakhon Sawan,95,17228,1035028,504657,530371,112947,112567,380,127,60,19/1/2022 7:23
7/12/2021,Nonthaburi,43,68727,1288637,599167,689470,160119,158826,1293,100, ,19/1/2022 7:23
7/12/2021,Narathiwat,45,42254,809660,400501,409159,5393,5393,0,62,26,19/1/2022 7:23
7/12/2021,Nan,0,2793,475875,237959,237916,132711,131256,1455,,,19/1/2022 7:23
7/12/2021,Bueng Kan,20,2440,421995,211494,210501,49966,49403,563,,,19/1/2022 7:23
7/12/2021,Buri Ram,15,17402,1579805,783531,796274,127140,126290,850,,,19/1/2022 7:23
7/12/2021,Pathum Thani,14,42546,1190060,563851,626209,105228,104299,929,111,58,19/1/2022 7:23
7/12/2021,Prachuap Khiri Khan,72,19522,553171,274049,279122,595142,593435,1707,,,19/1/2022 7:23
7/12/2021,Prachin Buri,66,25797,495325,244642,250683,101944,101780,164,106,55,19/1/2022 7:23
7/12/2021,Pattani,110,47337,729581,360348,369233,7237,7237,0,,,19/1/2022 7:23
7/12/2021,Phra Nakhon Si Ayutthaya,38,33007,820512,394024,426488,506314,497703,8611,94,71,19/1/2022 7:23
7/12/2021,Phayao,3,2661,464505,225943,238562,78112,77046,1066,108,46,19/1/2022 7:23
7/12/2021,Phang-nga,38,6830,268016,133785,134231,174747,140351,34396,,,19/1/2022 7:23
7/12/2021,Phatthalung,30,12658,522541,254425,268116,39244,39244,0,,,19/1/2022 7:23
7/12/2021,Phichit,7,5369,529395,258012,271383,47217,47125,92,,,19/1/2022 7:23
7/12/2021,Phitsanulok,17,8433,847384,414577,432807,202694,202078,616,,,19/1/2022 7:23
7/12/2021,Phuket,70,18371,418785,197874,220911,261943,167948,93995,52,30,19/1/2022 7:23
7/12/2021,Maha Sarakham,2,11242,948310,464976,483334,33099,33059,40,,,19/1/2022 7:23
7/12/2021,Mukdahan,2,2530,351484,175633,175851,96965,96923,42,,,19/1/2022 7:23
7/12/2021,Yala,74,47783,542314,269907,272407,48470,48470,0,60,29,19/1/2022 7:23
7/12/2021,Yasothon,14,6050,533394,265945,267449,38817,38817,0,,,19/1/2022 7:23
7/12/2021,Ranong,2,9972,194573,98136,96437,21868,21760,108,,,19/1/2022 7:23
7/12/2021,Rayong,27,46012,751343,368992,382351,442667,440059,2608,110,43,19/1/2022 7:23
7/12/2021,Ratchaburi,42,44212,868281,421921,446360,187297,186671,626,,,19/1/2022 7:23
7/12/2021,Roi Et,9,14324,1296013,641883,654130,44247,44214,33,,,19/1/2022 7:23
7/12/2021,Lop Buri,41,18306,739473,368733,370740,265330,265144,186,,,19/1/2022 7:23
7/12/2021,Lampang,30,3192,724678,352894,371784,147515,146727,788,128, ,19/1/2022 7:23
7/12/2021,Lamphun,15,4213,401139,192712,208427,95420,94339,1081,,,19/1/2022 7:23
7/12/2021,Si Sa Ket,16,19075,1457556,725426,732130,69970,69958,12,,,19/1/2022 7:23
7/12/2021,Sakon Nakhon,5,7845,1146286,569364,576922,123784,123753,31,,,19/1/2022 7:23
7/12/2021,Songkhla,160,65106,1431536,697256,734280,111186,110907,279,56,29,19/1/2022 7:23
7/12/2021,Satun,70,8054,324835,161640,163195,118953,118571,382,28,32,19/1/2022 7:23
7/12/2021,Samut Prakarn,95,132801,1356449,645884,710565,148306,128665,19641,,,19/1/2022 7:23
7/12/2021,Samut Songkhram,4,11971,190842,91101,99741,186767,186640,127,152,68,19/1/2022 7:23
7/12/2021,Samut Sakhon,18,111774,586789,282683,304106,49065,48960,105,125,70,19/1/2022 7:23
7/12/2021,Saraburi,38,33599,643963,316201,327762,308153,307750,403,127,78,19/1/2022 7:23
7/12/2021,Sa kaeo,30,19505,561992,280673,281319,68672,68321,351,89,44,19/1/2022 7:23
7/12/2021,Sing Buri,4,3510,204526,97144,107382,38697,38585,112,,,19/1/2022 7:23
7/12/2021,Suphan Buri,22,16352,835360,402883,432477,346794,346794,0,,,19/1/2022 7:23
7/12/2021,Surat Thani,153,26764,1072464,527349,545115,132624,124431,8193,54,26,19/1/2022 7:23
7/12/2021,Surin,13,19045,1376230,684354,691876,76048,75971,77,,,19/1/2022 7:23
7/12/2021,Sukhothai,5,6431,585352,283429,301923,77889,76248,1641,,,19/1/2022 7:23
7/12/2021,Nong Khai,5,4437,516843,256268,260575,176894,176022,872,71,52,19/1/2022 7:23
7/12/2021,Nong Bua Lam Phu,6,4630,509001,253757,255244,23866,23805,61,,,19/1/2022 7:23
7/12/2021,Amnat Charoen,3,3085,376350,187122,189228,26300,26300,0,,,19/1/2022 7:23
7/12/2021,Udon Thani,24,25292,1566510,775357,791153,215933,215261,672,,,19/1/2022 7:23
7/12/2021,Uttaradit,4,4570,446148,217413,228735,74305,74146,159,,,19/1/2022 7:23
7/12/2021,Uthai Thani,10,3841,325116,158926,166190,46752,46752,0,,,19/1/2022 7:23
7/12/2021,Ubon Ratchathani,23,22643,1868519,932466,936053,211200,211160,40,85,37,19/1/2022 7:23
7/12/2021,Ang Thong,6,11517,274763,131399,143364,42587,42587,0,,,19/1/2022 7:23
7/12/2021,Chiang Rai,18,5683,1298425,630868,667557,362358,360119,2239,110,46,19/1/2022 7:23
7/12/2021,Chiang Mai,95,32066,1789385,864364,925021,817474,810928,6546,110,49,19/1/2022 7:23
7/12/2021,Phetchaburi,17,24131,482875,232927,249948,596099,595951,148,,,19/1/2022 7:23
7/12/2021,Phetchabun,13,12286,978372,482234,496138,196178,195552,626,,,19/1/2022 7:23
7/12/2021,Loei,12,4352,638732,319949,318783,143151,142378,773,118,53,19/1/2022 7:23
7/12/2021,Phrae,3,2025,434580,209403,225177,91286,90937,349,109,52,19/1/2022 7:23
7/12/2021,Mae Hong Son,18,2787,285916,144811,141105,114751,112339,2412,,,19/1/2022 7:23
7/12/2021,,0,173,,,,,,,,,19/1/2022 7:23
8/12/2021,Krabi,71,10936,479351,238092,241259,81255,79570,1685,,,19/1/2022 7:23
8/12/2021,Bangkok,853,458428,5527994,2592292,2935702,2543615,2383978,159637,122,55,19/1/2022 7:23
8/12/2021,Kanchanaburi,22,24301,894054,448312,445742,908851,907622,1229,66,28,19/1/2022 7:23
8/12/2021,Kalasin,11,9985,975570,481988,493582,44112,43792,320,,,19/1/2022 7:23
8/12/2021,Kamphaeng Phet,1,8305,712143,351539,360604,60392,60106,286,,,19/1/2022 7:23
8/12/2021,Khon Kaen,59,26247,1790863,879849,911014,356626,354735,1891,112,51,19/1/2022 7:23
8/12/2021,Chanthaburi,13,22403,536557,262257,274300,132403,132126,277,,,19/1/2022 7:23
8/12/2021,Chachoengsao,42,37554,724178,354834,369344,350064,349850,214,86,46,19/1/2022 7:23
8/12/2021,Chon Buri,114,111741,1583672,772463,811209,975534,964356,11178,79,44,19/1/2022 7:23
8/12/2021,Chai Nat,15,2844,320432,153962,166470,51161,51147,14,,,19/1/2022 7:23
8/12/2021,Chaiyaphum,2,12231,1122265,554299,567966,99618,99364,254,,,19/1/2022 7:23
8/12/2021,Chumphon,62,15656,509479,251405,258074,70890,70798,92,,,19/1/2022 7:23
8/12/2021,Trang,82,16710,639788,312693,327095,91461,91339,122,,,19/1/2022 7:23
8/12/2021,Trat,18,9040,228376,112941,115435,133130,130498,2632,,,19/1/2022 7:23
8/12/2021,Tak,18,25472,676583,341966,334617,109369,109331,38,,,19/1/2022 7:23
8/12/2021,Nakhon Nayok,11,11618,260433,128854,131579,170360,170245,115,,,19/1/2022 7:23
8/12/2021,Nakhon Pathom,17,36083,922171,442800,479371,216272,216000,272,123,55,19/1/2022 7:23
8/12/2021,Nakhon Phanom,8,5051,717040,357096,359944,101214,101189,25,,,19/1/2022 7:23
8/12/2021,Nakhon Ratchasima,40,35232,2634154,1293783,1340371,571339,566844,4495,114,44,19/1/2022 7:23
8/12/2021,Nakhon Si Thammarat,241,44068,1549344,764471,784873,138859,138776,83,,,19/1/2022 7:23
8/12/2021,Nakhon Sawan,44,17272,1035028,504657,530371,112947,112567,380,119,57,19/1/2022 7:23
8/12/2021,Nonthaburi,47,68774,1288637,599167,689470,160119,158826,1293,102, ,19/1/2022 7:23
8/12/2021,Narathiwat,40,42294,809660,400501,409159,5393,5393,0,59,27,19/1/2022 7:23
8/12/2021,Nan,3,2796,475875,237959,237916,132711,131256,1455,,,19/1/2022 7:23
8/12/2021,Bueng Kan,14,2454,421995,211494,210501,49966,49403,563,,,19/1/2022 7:23
8/12/2021,Buri Ram,3,17405,1579805,783531,796274,127140,126290,850,,,19/1/2022 7:23
8/12/2021,Pathum Thani,19,42565,1190060,563851,626209,105228,104299,929,99,50,19/1/2022 7:23
8/12/2021,Prachuap Khiri Khan,67,19589,553171,274049,279122,595142,593435,1707,,,19/1/2022 7:23
8/12/2021,Prachin Buri,57,25854,495325,244642,250683,101944,101780,164,99,45,19/1/2022 7:23
8/12/2021,Pattani,104,47441,729581,360348,369233,7237,7237,0,,,19/1/2022 7:23
8/12/2021,Phra Nakhon Si Ayutthaya,33,33040,820512,394024,426488,506314,497703,8611,85,62,19/1/2022 7:23
8/12/2021,Phayao,5,2666,464505,225943,238562,78112,77046,1066,106,45,19/1/2022 7:23
8/12/2021,Phang-nga,26,6856,268016,133785,134231,174747,140351,34396,,,19/1/2022 7:23
8/12/2021,Phatthalung,86,12744,522541,254425,268116,39244,39244,0,,,19/1/2022 7:23
8/12/2021,Phichit,4,5373,529395,258012,271383,47217,47125,92,,,19/1/2022 7:23
8/12/2021,Phitsanulok,79,8512,847384,414577,432807,202694,202078,616,,,19/1/2022 7:23
8/12/2021,Phuket,79,18450,418785,197874,220911,261943,167948,93995,54,32,19/1/2022 7:23
8/12/2021,Maha Sarakham,3,11245,948310,464976,483334,33099,33059,40,,,19/1/2022 7:23
8/12/2021,Mukdahan,3,2533,351484,175633,175851,96965,96923,42,,,19/1/2022 7:23
8/12/2021,Yala,52,47835,542314,269907,272407,48470,48470,0,59,34,19/1/2022 7:23
8/12/2021,Yasothon,2,6052,533394,265945,267449,38817,38817,0,,,19/1/2022 7:23
8/12/2021,Ranong,3,9975,194573,98136,96437,21868,21760,108,,,19/1/2022 7:23
8/12/2021,Rayong,46,46058,751343,368992,382351,442667,440059,2608,95,36,19/1/2022 7:23
8/12/2021,Ratchaburi,99,44311,868281,421921,446360,187297,186671,626,,,19/1/2022 7:23
8/12/2021,Roi Et,7,14331,1296013,641883,654130,44247,44214,33,,,19/1/2022 7:23
8/12/2021,Lop Buri,17,18323,739473,368733,370740,265330,265144,186,,,19/1/2022 7:23
8/12/2021,Lampang,20,3212,724678,352894,371784,147515,146727,788,127, ,19/1/2022 7:23
8/12/2021,Lamphun,53,4266,401139,192712,208427,95420,94339,1081,,,19/1/2022 7:23
8/12/2021,Si Sa Ket,8,19083,1457556,725426,732130,69970,69958,12,,,19/1/2022 7:23
8/12/2021,Sakon Nakhon,10,7855,1146286,569364,576922,123784,123753,31,,,19/1/2022 7:23
8/12/2021,Songkhla,182,65288,1431536,697256,734280,111186,110907,279,52,35,19/1/2022 7:23
8/12/2021,Satun,67,8121,324835,161640,163195,118953,118571,382,31,24,19/1/2022 7:23
8/12/2021,Samut Prakarn,84,132885,1356449,645884,710565,148306,128665,19641,,,19/1/2022 7:23
8/12/2021,Samut Songkhram,5,11976,190842,91101,99741,186767,186640,127,143,56,19/1/2022 7:23
8/12/2021,Samut Sakhon,43,111817,586789,282683,304106,49065,48960,105,120,55,19/1/2022 7:23
8/12/2021,Saraburi,29,33628,643963,316201,327762,308153,307750,403,112,72,19/1/2022 7:23
8/12/2021,Sa kaeo,24,19529,561992,280673,281319,68672,68321,351,87,32,19/1/2022 7:23
8/12/2021,Sing Buri,9,3519,204526,97144,107382,38697,38585,112,,,19/1/2022 7:23
8/12/2021,Suphan Buri,6,16358,835360,402883,432477,346794,346794,0,,,19/1/2022 7:23
8/12/2021,Surat Thani,134,26898,1072464,527349,545115,132624,124431,8193,59,27,19/1/2022 7:23
8/12/2021,Surin,4,19049,1376230,684354,691876,76048,75971,77,,,19/1/2022 7:23
8/12/2021,Sukhothai,2,6433,585352,283429,301923,77889,76248,1641,,,19/1/2022 7:23
8/12/2021,Nong Khai,17,4454,516843,256268,260575,176894,176022,872,79,46,19/1/2022 7:23
8/12/2021,Nong Bua Lam Phu,5,4635,509001,253757,255244,23866,23805,61,,,19/1/2022 7:23
8/12/2021,Amnat Charoen,0,3085,376350,187122,189228,26300,26300,0,,,19/1/2022 7:23
8/12/2021,Udon Thani,14,25306,1566510,775357,791153,215933,215261,672,,,19/1/2022 7:23
8/12/2021,Uttaradit,5,4575,446148,217413,228735,74305,74146,159,,,19/1/2022 7:23
8/12/2021,Uthai Thani,6,3847,325116,158926,166190,46752,46752,0,,,19/1/2022 7:23
8/12/2021,Ubon Ratchathani,17,22660,1868519,932466,936053,211200,211160,40,68,25,19/1/2022 7:23
8/12/2021,Ang Thong,15,11532,274763,131399,143364,42587,42587,0,,,19/1/2022 7:23
8/12/2021,Chiang Rai,15,5698,1298425,630868,667557,362358,360119,2239,109,40,19/1/2022 7:23
8/12/2021,Chiang Mai,134,32200,1789385,864364,925021,817474,810928,6546,109,44,19/1/2022 7:23
8/12/2021,Phetchaburi,12,24143,482875,232927,249948,596099,595951,148,,,19/1/2022 7:23
8/12/2021,Phetchabun,3,12289,978372,482234,496138,196178,195552,626,,,19/1/2022 7:23
8/12/2021,Loei,32,4384,638732,319949,318783,143151,142378,773,115,43,19/1/2022 7:23
8/12/2021,Phrae,0,2025,434580,209403,225177,91286,90937,349,120,45,19/1/2022 7:23
8/12/2021,Mae Hong Son,21,2808,285916,144811,141105,114751,112339,2412,,,19/1/2022 7:23
8/12/2021,,0,173,,,,,,,,,19/1/2022 7:23
9/12/2021,Krabi,68,11004,479351,238092,241259,81255,79570,1685,,,19/1/2022 7:23
9/12/2021,Bangkok,861,459289,5527994,2592292,2935702,2543615,2383978,159637,100,54,19/1/2022 7:23
9/12/2021,Kanchanaburi,25,24326,894054,448312,445742,908851,907622,1229,53,23,19/1/2022 7:23
9/12/2021,Kalasin,7,9992,975570,481988,493582,44112,43792,320,,,19/1/2022 7:23
9/12/2021,Kamphaeng Phet,8,8313,712143,351539,360604,60392,60106,286,,,19/1/2022 7:23
9/12/2021,Khon Kaen,61,26308,1790863,879849,911014,356626,354735,1891,85,44,19/1/2022 7:23
9/12/2021,Chanthaburi,25,22428,536557,262257,274300,132403,132126,277,,,19/1/2022 7:23
9/12/2021,Chachoengsao,55,37609,724178,354834,369344,350064,349850,214,87,47,19/1/2022 7:23
9/12/2021,Chon Buri,170,111911,1583672,772463,811209,975534,964356,11178,69,37,19/1/2022 7:23
9/12/2021,Chai Nat,7,2851,320432,153962,166470,51161,51147,14,,,19/1/2022 7:23
9/12/2021,Chaiyaphum,4,12235,1122265,554299,567966,99618,99364,254,,,19/1/2022 7:23
9/12/2021,Chumphon,79,15735,509479,251405,258074,70890,70798,92,,,19/1/2022 7:23
9/12/2021,Trang,79,16789,639788,312693,327095,91461,91339,122,,,19/1/2022 7:23
9/12/2021,Trat,29,9069,228376,112941,115435,133130,130498,2632,,,19/1/2022 7:23
9/12/2021,Tak,58,25530,676583,341966,334617,109369,109331,38,,,19/1/2022 7:23
9/12/2021,Nakhon Nayok,19,11637,260433,128854,131579,170360,170245,115,,,19/1/2022 7:23
9/12/2021,Nakhon Pathom,11,36094,922171,442800,479371,216272,216000,272,104,48,19/1/2022 7:23
9/12/2021,Nakhon Phanom,6,5057,717040,357096,359944,101214,101189,25,,,19/1/2022 7:23
9/12/2021,Nakhon Ratchasima,36,35268,2634154,1293783,1340371,571339,566844,4495,93,33,19/1/2022 7:23
9/12/2021,Nakhon Si Thammarat,299,44367,1549344,764471,784873,138859,138776,83,,,19/1/2022 7:23
9/12/2021,Nakhon Sawan,49,17321,1035028,504657,530371,112947,112567,380,117,46,19/1/2022 7:23
9/12/2021,Nonthaburi,40,68814,1288637,599167,689470,160119,158826,1293,74, ,19/1/2022 7:23
9/12/2021,Narathiwat,33,42327,809660,400501,409159,5393,5393,0,62,31,19/1/2022 7:23
9/12/2021,Nan,18,2814,475875,237959,237916,132711,131256,1455,,,19/1/2022 7:23
9/12/2021,Bueng Kan,22,2476,421995,211494,210501,49966,49403,563,,,19/1/2022 7:23
9/12/2021,Buri Ram,30,17435,1579805,783531,796274,127140,126290,850,,,19/1/2022 7:23
9/12/2021,Pathum Thani,25,42590,1190060,563851,626209,105228,104299,929,80,47,19/1/2022 7:23
9/12/2021,Prachuap Khiri Khan,92,19681,553171,274049,279122,595142,593435,1707,,,19/1/2022 7:23
9/12/2021,Prachin Buri,96,25950,495325,244642,250683,101944,101780,164,75,42,19/1/2022 7:23
9/12/2021,Pattani,155,47596,729581,360348,369233,7237,7237,0,,,19/1/2022 7:23
9/12/2021,Phra Nakhon Si Ayutthaya,59,33099,820512,394024,426488,506314,497703,8611,70,58,19/1/2022 7:23
9/12/2021,Phayao,9,2675,464505,225943,238562,78112,77046,1066,107,39,19/1/2022 7:23
9/12/2021,Phang-nga,49,6905,268016,133785,134231,174747,140351,34396,,,19/1/2022 7:23
9/12/2021,Phatthalung,55,12799,522541,254425,268116,39244,39244,0,,,19/1/2022 7:23
9/12/2021,Phichit,4,5377,529395,258012,271383,47217,47125,92,,,19/1/2022 7:23
9/12/2021,Phitsanulok,73,8585,847384,414577,432807,202694,202078,616,,,19/1/2022 7:23
9/12/2021,Phuket,70,18520,418785,197874,220911,261943,167948,93995,58,29,19/1/2022 7:23
9/12/2021,Maha Sarakham,3,11248,948310,464976,483334,33099,33059,40,,,19/1/2022 7:23
9/12/2021,Mukdahan,11,2544,351484,175633,175851,96965,96923,42,,,19/1/2022 7:23
9/12/2021,Yala,90,47925,542314,269907,272407,48470,48470,0,68,30,19/1/2022 7:23
9/12/2021,Yasothon,0,6052,533394,265945,267449,38817,38817,0,,,19/1/2022 7:23
9/12/2021,Ranong,15,9990,194573,98136,96437,21868,21760,108,,,19/1/2022 7:23
9/12/2021,Rayong,58,46116,751343,368992,382351,442667,440059,2608,79,30,19/1/2022 7:23
9/12/2021,Ratchaburi,59,44370,868281,421921,446360,187297,186671,626,,,19/1/2022 7:23
9/12/2021,Roi Et,10,14341,1296013,641883,654130,44247,44214,33,,,19/1/2022 7:23
9/12/2021,Lop Buri,46,18369,739473,368733,370740,265330,265144,186,,,19/1/2022 7:23
9/12/2021,Lampang,17,3229,724678,352894,371784,147515,146727,788,124, ,19/1/2022 7:23
9/12/2021,Lamphun,47,4313,401139,192712,208427,95420,94339,1081,,,19/1/2022 7:23
9/12/2021,Si Sa Ket,43,19126,1457556,725426,732130,69970,69958,12,,,19/1/2022 7:23
9/12/2021,Sakon Nakhon,8,7863,1146286,569364,576922,123784,123753,31,,,19/1/2022 7:23
9/12/2021,Songkhla,196,65484,1431536,697256,734280,111186,110907,279,67,30,19/1/2022 7:23
9/12/2021,Satun,66,8187,324835,161640,163195,118953,118571,382,34,26,19/1/2022 7:23
9/12/2021,Samut Prakarn,155,133040,1356449,645884,710565,148306,128665,19641,,,19/1/2022 7:23
9/12/2021,Samut Songkhram,9,11985,190842,91101,99741,186767,186640,127,114,44,19/1/2022 7:23
9/12/2021,Samut Sakhon,30,111847,586789,282683,304106,49065,48960,105,87,57,19/1/2022 7:23
9/12/2021,Saraburi,42,33670,643963,316201,327762,308153,307750,403,88,84,19/1/2022 7:23
9/12/2021,Sa kaeo,45,19574,561992,280673,281319,68672,68321,351,64,34,19/1/2022 7:23
9/12/2021,Sing Buri,4,3523,204526,97144,107382,38697,38585,112,,,19/1/2022 7:23
9/12/2021,Suphan Buri,13,16371,835360,402883,432477,346794,346794,0,,,19/1/2022 7:23
9/12/2021,Surat Thani,98,26996,1072464,527349,545115,132624,124431,8193,60,30,19/1/2022 7:23
9/12/2021,Surin,4,19053,1376230,684354,691876,76048,75971,77,,,19/1/2022 7:23
9/12/2021,Sukhothai,0,6433,585352,283429,301923,77889,76248,1641,,,19/1/2022 7:23
9/12/2021,Nong Khai,6,4460,516843,256268,260575,176894,176022,872,61,40,19/1/2022 7:23
9/12/2021,Nong Bua Lam Phu,7,4642,509001,253757,255244,23866,23805,61,,,19/1/2022 7:23
9/12/2021,Amnat Charoen,2,3087,376350,187122,189228,26300,26300,0,,,19/1/2022 7:23
9/12/2021,Udon Thani,36,25342,1566510,775357,791153,215933,215261,672,,,19/1/2022 7:23
9/12/2021,Uttaradit,1,4576,446148,217413,228735,74305,74146,159,,,19/1/2022 7:23
9/12/2021,Uthai Thani,10,3857,325116,158926,166190,46752,46752,0,,,19/1/2022 7:23
9/12/2021,Ubon Ratchathani,14,22674,1868519,932466,936053,211200,211160,40,43,30,19/1/2022 7:23
9/12/2021,Ang Thong,8,11540,274763,131399,143364,42587,42587,0,,,19/1/2022 7:23
9/12/2021,Chiang Rai,22,5720,1298425,630868,667557,362358,360119,2239,100,38,19/1/2022 7:23
9/12/2021,Chiang Mai,143,32343,1789385,864364,925021,817474,810928,6546,93,34,19/1/2022 7:23
9/12/2021,Phetchaburi,31,24174,482875,232927,249948,596099,595951,148,,,19/1/2022 7:23
9/12/2021,Phetchabun,17,12306,978372,482234,496138,196178,195552,626,,,19/1/2022 7:23
9/12/2021,Loei,19,4403,638732,319949,318783,143151,142378,773,88,34,19/1/2022 7:23
9/12/2021,Phrae,2,2027,434580,209403,225177,91286,90937,349,104,35,19/1/2022 7:23
9/12/2021,Mae Hong Son,30,2838,285916,144811,141105,114751,112339,2412,,,19/1/2022 7:23
9/12/2021,,0,173,,,,,,,,,19/1/2022 7:23
10/12/2021,Krabi,72,11076,479351,238092,241259,81255,79570,1685,,,19/1/2022 7:23
10/12/2021,Bangkok,647,459936,5527994,2592292,2935702,2543615,2383978,159637,96,54,19/1/2022 7:23
10/12/2021,Kanchanaburi,19,24345,894054,448312,445742,908851,907622,1229,49,22,19/1/2022 7:23
10/12/2021,Kalasin,9,10001,975570,481988,493582,44112,43792,320,,,19/1/2022 7:23
10/12/2021,Kamphaeng Phet,20,8333,712143,351539,360604,60392,60106,286,,,19/1/2022 7:23
10/12/2021,Khon Kaen,79,26387,1790863,879849,911014,356626,354735,1891,70,52,19/1/2022 7:23
10/12/2021,Chanthaburi,22,22450,536557,262257,274300,132403,132126,277,,,19/1/2022 7:23
10/12/2021,Chachoengsao,41,37650,724178,354834,369344,350064,349850,214,63,45,19/1/2022 7:23
10/12/2021,Chon Buri,176,112087,1583672,772463,811209,975534,964356,11178,62,37,19/1/2022 7:23
10/12/2021,Chai Nat,6,2857,320432,153962,166470,51161,51147,14,,,19/1/2022 7:23
10/12/2021,Chaiyaphum,2,12237,1122265,554299,567966,99618,99364,254,,,19/1/2022 7:23
10/12/2021,Chumphon,65,15800,509479,251405,258074,70890,70798,92,,,19/1/2022 7:23
10/12/2021,Trang,75,16864,639788,312693,327095,91461,91339,122,,,19/1/2022 7:23
10/12/2021,Trat,23,9092,228376,112941,115435,133130,130498,2632,,,19/1/2022 7:23
10/12/2021,Tak,53,25583,676583,341966,334617,109369,109331,38,,,19/1/2022 7:23
10/12/2021,Nakhon Nayok,17,11654,260433,128854,131579,170360,170245,115,,,19/1/2022 7:23
10/12/2021,Nakhon Pathom,28,36122,922171,442800,479371,216272,216000,272,85,54,19/1/2022 7:23
10/12/2021,Nakhon Phanom,6,5063,717040,357096,359944,101214,101189,25,,,19/1/2022 7:23
10/12/2021,Nakhon Ratchasima,60,35328,2634154,1293783,1340371,571339,566844,4495,65,38,19/1/2022 7:23
10/12/2021,Nakhon Si Thammarat,460,44827,1549344,764471,784873,138859,138776,83,,,19/1/2022 7:23
10/12/2021,Nakhon Sawan,50,17371,1035028,504657,530371,112947,112567,380,88,44,19/1/2022 7:23
10/12/2021,Nonthaburi,42,68856,1288637,599167,689470,160119,158826,1293,71, ,19/1/2022 7:23
10/12/2021,Narathiwat,26,42353,809660,400501,409159,5393,5393,0,63,30,19/1/2022 7:23
10/12/2021,Nan,0,2814,475875,237959,237916,132711,131256,1455,,,19/1/2022 7:23
10/12/2021,Bueng Kan,19,2495,421995,211494,210501,49966,49403,563,,,19/1/2022 7:23
10/12/2021,Buri Ram,19,17454,1579805,783531,796274,127140,126290,850,,,19/1/2022 7:23
10/12/2021,Pathum Thani,54,42644,1190060,563851,626209,105228,104299,929,69,52,19/1/2022 7:23
10/12/2021,Prachuap Khiri Khan,77,19758,553171,274049,279122,595142,593435,1707,,,19/1/2022 7:23
10/12/2021,Prachin Buri,80,26030,495325,244642,250683,101944,101780,164,74,48,19/1/2022 7:23
10/12/2021,Pattani,145,47741,729581,360348,369233,7237,7237,0,,,19/1/2022 7:23
10/12/2021,Phra Nakhon Si Ayutthaya,31,33130,820512,394024,426488,506314,497703,8611,58,63,19/1/2022 7:23
10/12/2021,Phayao,4,2679,464505,225943,238562,78112,77046,1066,93,40,19/1/2022 7:23
10/12/2021,Phang-nga,50,6955,268016,133785,134231,174747,140351,34396,,,19/1/2022 7:23
10/12/2021,Phatthalung,85,12884,522541,254425,268116,39244,39244,0,,,19/1/2022 7:23
10/12/2021,Phichit,3,5380,529395,258012,271383,47217,47125,92,,,19/1/2022 7:23
10/12/2021,Phitsanulok,47,8632,847384,414577,432807,202694,202078,616,,,19/1/2022 7:23
10/12/2021,Phuket,72,18592,418785,197874,220911,261943,167948,93995,52,30,19/1/2022 7:23
10/12/2021,Maha Sarakham,2,11250,948310,464976,483334,33099,33059,40,,,19/1/2022 7:23
10/12/2021,Mukdahan,2,2546,351484,175633,175851,96965,96923,42,,,19/1/2022 7:23
10/12/2021,Yala,102,48027,542314,269907,272407,48470,48470,0,58,29,19/1/2022 7:23
10/12/2021,Yasothon,0,6052,533394,265945,267449,38817,38817,0,,,19/1/2022 7:23
10/12/2021,Ranong,6,9996,194573,98136,96437,21868,21760,108,,,19/1/2022 7:23
10/12/2021,Rayong,54,46170,751343,368992,382351,442667,440059,2608,70,34,19/1/2022 7:23
10/12/2021,Ratchaburi,69,44439,868281,421921,446360,187297,186671,626,,,19/1/2022 7:23
10/12/2021,Roi Et,20,14361,1296013,641883,654130,44247,44214,33,,,19/1/2022 7:23
10/12/2021,Lop Buri,57,18426,739473,368733,370740,265330,265144,186,,,19/1/2022 7:23
10/12/2021,Lampang,19,3248,724678,352894,371784,147515,146727,788,110,144,19/1/2022 7:23
10/12/2021,Lamphun,102,4415,401139,192712,208427,95420,94339,1081,,,19/1/2022 7:23
10/12/2021,Si Sa Ket,21,19147,1457556,725426,732130,69970,69958,12,,,19/1/2022 7:23
10/12/2021,Sakon Nakhon,7,7870,1146286,569364,576922,123784,123753,31,,,19/1/2022 7:23
10/12/2021,Songkhla,216,65700,1431536,697256,734280,111186,110907,279,54,31,19/1/2022 7:23
10/12/2021,Satun,67,8254,324835,161640,163195,118953,118571,382,28,22,19/1/2022 7:23
10/12/2021,Samut Prakarn,166,133206,1356449,645884,710565,148306,128665,19641,,,19/1/2022 7:23
10/12/2021,Samut Songkhram,12,11997,190842,91101,99741,186767,186640,127,90,43,19/1/2022 7:23
10/12/2021,Samut Sakhon,41,111888,586789,282683,304106,49065,48960,105,91,61,19/1/2022 7:23
10/12/2021,Saraburi,46,33716,643963,316201,327762,308153,307750,403,98,88,19/1/2022 7:23
10/12/2021,Sa kaeo,39,19613,561992,280673,281319,68672,68321,351,62,36,19/1/2022 7:23
10/12/2021,Sing Buri,5,3528,204526,97144,107382,38697,38585,112,,,19/1/2022 7:23
10/12/2021,Suphan Buri,6,16377,835360,402883,432477,346794,346794,0,,,19/1/2022 7:23
10/12/2021,Surat Thani,125,27121,1072464,527349,545115,132624,124431,8193,63,30,19/1/2022 7:23
10/12/2021,Surin,7,19060,1376230,684354,691876,76048,75971,77,,,19/1/2022 7:23
10/12/2021,Sukhothai,4,6437,585352,283429,301923,77889,76248,1641,,,19/1/2022 7:23
10/12/2021,Nong Khai,8,4468,516843,256268,260575,176894,176022,872,36,42,19/1/2022 7:23
10/12/2021,Nong Bua Lam Phu,16,4658,509001,253757,255244,23866,23805,61,,,19/1/2022 7:23
10/12/2021,Amnat Charoen,3,3090,376350,187122,189228,26300,26300,0,,,19/1/2022 7:23
10/12/2021,Udon Thani,30,25372,1566510,775357,791153,215933,215261,672,,,19/1/2022 7:23
10/12/2021,Uttaradit,1,4577,446148,217413,228735,74305,74146,159,,,19/1/2022 7:23
10/12/2021,Uthai Thani,3,3860,325116,158926,166190,46752,46752,0,,,19/1/2022 7:23
10/12/2021,Ubon Ratchathani,15,22689,1868519,932466,936053,211200,211160,40,54,31,19/1/2022 7:23
10/12/2021,Ang Thong,29,11569,274763,131399,143364,42587,42587,0,,,19/1/2022 7:23
10/12/2021,Chiang Rai,18,5738,1298425,630868,667557,362358,360119,2239,95,44,19/1/2022 7:23
10/12/2021,Chiang Mai,91,32434,1789385,864364,925021,817474,810928,6546,76,35,19/1/2022 7:23
10/12/2021,Phetchaburi,25,24199,482875,232927,249948,596099,595951,148,,,19/1/2022 7:23
10/12/2021,Phetchabun,30,12336,978372,482234,496138,196178,195552,626,,,19/1/2022 7:23
10/12/2021,Loei,15,4418,638732,319949,318783,143151,142378,773,75,39,19/1/2022 7:23
10/12/2021,Phrae,1,2028,434580,209403,225177,91286,90937,349,84,30,19/1/2022 7:23
10/12/2021,Mae Hong Son,29,2867,285916,144811,141105,114751,112339,2412,,,19/1/2022 7:23
10/12/2021,,0,173,,,,,,,,,19/1/2022 7:23
11/12/2021,Krabi,70,11146,479351,238092,241259,81255,79570,1685,,,19/1/2022 7:23
11/12/2021,Bangkok,672,460608,5527994,2592292,2935702,2543615,2383978,159637,98,47,19/1/2022 7:23
11/12/2021,Kanchanaburi,15,24360,894054,448312,445742,908851,907622,1229,43,40,19/1/2022 7:23
11/12/2021,Kalasin,18,10019,975570,481988,493582,44112,43792,320,,,19/1/2022 7:23
11/12/2021,Kamphaeng Phet,9,8342,712143,351539,360604,60392,60106,286,,,19/1/2022 7:23
11/12/2021,Khon Kaen,62,26449,1790863,879849,911014,356626,354735,1891,92,48,19/1/2022 7:23
11/12/2021,Chanthaburi,15,22465,536557,262257,274300,132403,132126,277,,,19/1/2022 7:23
11/12/2021,Chachoengsao,46,37696,724178,354834,369344,350064,349850,214,75,44,19/1/2022 7:23
11/12/2021,Chon Buri,141,112228,1583672,772463,811209,975534,964356,11178,62,40,19/1/2022 7:23
11/12/2021,Chai Nat,13,2870,320432,153962,166470,51161,51147,14,,,19/1/2022 7:23
11/12/2021,Chaiyaphum,14,12251,1122265,554299,567966,99618,99364,254,,,19/1/2022 7:23
11/12/2021,Chumphon,82,15882,509479,251405,258074,70890,70798,92,,,19/1/2022 7:23
11/12/2021,Trang,78,16942,639788,312693,327095,91461,91339,122,,,19/1/2022 7:23
11/12/2021,Trat,21,9113,228376,112941,115435,133130,130498,2632,,,19/1/2022 7:23
11/12/2021,Tak,44,25627,676583,341966,334617,109369,109331,38,,,19/1/2022 7:23
11/12/2021,Nakhon Nayok,14,11668,260433,128854,131579,170360,170245,115,,,19/1/2022 7:23
11/12/2021,Nakhon Pathom,30,36152,922171,442800,479371,216272,216000,272,108,51,19/1/2022 7:23
11/12/2021,Nakhon Phanom,12,5075,717040,357096,359944,101214,101189,25,,,19/1/2022 7:23
11/12/2021,Nakhon Ratchasima,65,35393,2634154,1293783,1340371,571339,566844,4495,73,36,19/1/2022 7:23
11/12/2021,Nakhon Si Thammarat,371,45198,1549344,764471,784873,138859,138776,83,,,19/1/2022 7:23
11/12/2021,Nakhon Sawan,73,17444,1035028,504657,530371,112947,112567,380,75,39,19/1/2022 7:23
11/12/2021,Nonthaburi,40,68896,1288637,599167,689470,160119,158826,1293,79, ,19/1/2022 7:23
11/12/2021,Narathiwat,26,42379,809660,400501,409159,5393,5393,0,59,26,19/1/2022 7:23
11/12/2021,Nan,1,2815,475875,237959,237916,132711,131256,1455,,,19/1/2022 7:23
11/12/2021,Bueng Kan,31,2526,421995,211494,210501,49966,49403,563,,,19/1/2022 7:23
11/12/2021,Buri Ram,14,17468,1579805,783531,796274,127140,126290,850,,,19/1/2022 7:23
11/12/2021,Pathum Thani,61,42705,1190060,563851,626209,105228,104299,929,82,45,19/1/2022 7:23
11/12/2021,Prachuap Khiri Khan,66,19824,553171,274049,279122,595142,593435,1707,,,19/1/2022 7:23
11/12/2021,Prachin Buri,60,26090,495325,244642,250683,101944,101780,164,86,50,19/1/2022 7:23
11/12/2021,Pattani,107,47848,729581,360348,369233,7237,7237,0,,,19/1/2022 7:23
11/12/2021,Phra Nakhon Si Ayutthaya,76,33206,820512,394024,426488,506314,497703,8611,69,62,19/1/2022 7:23
11/12/2021,Phayao,5,2684,464505,225943,238562,78112,77046,1066,92,40,19/1/2022 7:23
11/12/2021,Phang-nga,62,7017,268016,133785,134231,174747,140351,34396,,,19/1/2022 7:23
11/12/2021,Phatthalung,70,12954,522541,254425,268116,39244,39244,0,,,19/1/2022 7:23
11/12/2021,Phichit,4,5384,529395,258012,271383,47217,47125,92,,,19/1/2022 7:23
11/12/2021,Phitsanulok,44,8676,847384,414577,432807,202694,202078,616,,,19/1/2022 7:23
11/12/2021,Phuket,64,18656,418785,197874,220911,261943,167948,93995,64,34,19/1/2022 7:23
11/12/2021,Maha Sarakham,6,11256,948310,464976,483334,33099,33059,40,,,19/1/2022 7:23
11/12/2021,Mukdahan,2,2548,351484,175633,175851,96965,96923,42,,,19/1/2022 7:23
11/12/2021,Yala,73,48100,542314,269907,272407,48470,48470,0,58,34,19/1/2022 7:23
11/12/2021,Yasothon,2,6054,533394,265945,267449,38817,38817,0,,,19/1/2022 7:23
11/12/2021,Ranong,9,10005,194573,98136,96437,21868,21760,108,,,19/1/2022 7:23
11/12/2021,Rayong,59,46229,751343,368992,382351,442667,440059,2608,70,38,19/1/2022 7:23
11/12/2021,Ratchaburi,54,44493,868281,421921,446360,187297,186671,626,,,19/1/2022 7:23
11/12/2021,Roi Et,12,14373,1296013,641883,654130,44247,44214,33,,,19/1/2022 7:23
11/12/2021,Lop Buri,69,18495,739473,368733,370740,265330,265144,186,,,19/1/2022 7:23
11/12/2021,Lampang,17,3265,724678,352894,371784,147515,146727,788,106,28,19/1/2022 7:23
11/12/2021,Lamphun,65,4480,401139,192712,208427,95420,94339,1081,,,19/1/2022 7:23
11/12/2021,Si Sa Ket,45,19192,1457556,725426,732130,69970,69958,12,,,19/1/2022 7:23
11/12/2021,Sakon Nakhon,4,7874,1146286,569364,576922,123784,123753,31,,,19/1/2022 7:23
11/12/2021,Songkhla,238,65938,1431536,697256,734280,111186,110907,279,55,34,19/1/2022 7:23
11/12/2021,Satun,63,8317,324835,161640,163195,118953,118571,382,36,30,19/1/2022 7:23
11/12/2021,Samut Prakarn,133,133339,1356449,645884,710565,148306,128665,19641,,,19/1/2022 7:23
11/12/2021,Samut Songkhram,8,12005,190842,91101,99741,186767,186640,127,78,48,19/1/2022 7:23
11/12/2021,Samut Sakhon,45,111933,586789,282683,304106,49065,48960,105,92,59,19/1/2022 7:23
11/12/2021,Saraburi,48,33764,643963,316201,327762,308153,307750,403,94,77,19/1/2022 7:23
11/12/2021,Sa kaeo,19,19632,561992,280673,281319,68672,68321,351,69,35,19/1/2022 7:23
11/12/2021,Sing Buri,7,3535,204526,97144,107382,38697,38585,112,,,19/1/2022 7:23
11/12/2021,Suphan Buri,20,16397,835360,402883,432477,346794,346794,0,,,19/1/2022 7:23
11/12/2021,Surat Thani,146,27267,1072464,527349,545115,132624,124431,8193,60,30,19/1/2022 7:23
11/12/2021,Surin,8,19068,1376230,684354,691876,76048,75971,77,,,19/1/2022 7:23
11/12/2021,Sukhothai,3,6440,585352,283429,301923,77889,76248,1641,,,19/1/2022 7:23
11/12/2021,Nong Khai,4,4472,516843,256268,260575,176894,176022,872,53,38,19/1/2022 7:23
11/12/2021,Nong Bua Lam Phu,10,4668,509001,253757,255244,23866,23805,61,,,19/1/2022 7:23
11/12/2021,Amnat Charoen,0,3090,376350,187122,189228,26300,26300,0,,,19/1/2022 7:23
11/12/2021,Udon Thani,37,25409,1566510,775357,791153,215933,215261,672,,,19/1/2022 7:23
11/12/2021,Uttaradit,1,4578,446148,217413,228735,74305,74146,159,,,19/1/2022 7:23
11/12/2021,Uthai Thani,4,3864,325116,158926,166190,46752,46752,0,,,19/1/2022 7:23
11/12/2021,Ubon Ratchathani,18,22707,1868519,932466,936053,211200,211160,40,65,27,19/1/2022 7:23
11/12/2021,Ang Thong,12,11581,274763,131399,143364,42587,42587,0,,,19/1/2022 7:23
11/12/2021,Chiang Rai,23,5761,1298425,630868,667557,362358,360119,2239,106,41,19/1/2022 7:23
11/12/2021,Chiang Mai,88,32522,1789385,864364,925021,817474,810928,6546,77,36,19/1/2022 7:23
11/12/2021,Phetchaburi,22,24221,482875,232927,249948,596099,595951,148,,,19/1/2022 7:23
11/12/2021,Phetchabun,59,12395,978372,482234,496138,196178,195552,626,,,19/1/2022 7:23
11/12/2021,Loei,22,4440,638732,319949,318783,143151,142378,773,81,37,19/1/2022 7:23
11/12/2021,Phrae,4,2032,434580,209403,225177,91286,90937,349,73,34,19/1/2022 7:23
11/12/2021,Mae Hong Son,24,2891,285916,144811,141105,114751,112339,2412,,,19/1/2022 7:23
11/12/2021,,0,173,,,,,,,,,19/1/2022 7:23
12/12/2021,Krabi,66,11212,479351,238092,241259,81255,79570,1685,,,19/1/2022 7:23
12/12/2021,Bangkok,641,461249,5527994,2592292,2935702,2543615,2383978,159637,81,43,19/1/2022 7:23
12/12/2021,Kanchanaburi,17,24377,894054,448312,445742,908851,907622,1229,54,25,19/1/2022 7:23
12/12/2021,Kalasin,15,10034,975570,481988,493582,44112,43792,320,,,19/1/2022 7:23
12/12/2021,Kamphaeng Phet,11,8353,712143,351539,360604,60392,60106,286,,,19/1/2022 7:23
12/12/2021,Khon Kaen,42,26491,1790863,879849,911014,356626,354735,1891,88,53,19/1/2022 7:23
12/12/2021,Chanthaburi,10,22475,536557,262257,274300,132403,132126,277,,,19/1/2022 7:23
12/12/2021,Chachoengsao,34,37730,724178,354834,369344,350064,349850,214,71,43,19/1/2022 7:23
12/12/2021,Chon Buri,174,112402,1583672,772463,811209,975534,964356,11178,71,40,19/1/2022 7:23
12/12/2021,Chai Nat,3,2873,320432,153962,166470,51161,51147,14,,,19/1/2022 7:23
12/12/2021,Chaiyaphum,9,12260,1122265,554299,567966,99618,99364,254,,,19/1/2022 7:23
12/12/2021,Chumphon,51,15933,509479,251405,258074,70890,70798,92,,,19/1/2022 7:23
12/12/2021,Trang,87,17029,639788,312693,327095,91461,91339,122,,,19/1/2022 7:23
12/12/2021,Trat,25,9138,228376,112941,115435,133130,130498,2632,,,19/1/2022 7:23
12/12/2021,Tak,42,25669,676583,341966,334617,109369,109331,38,,,19/1/2022 7:23
12/12/2021,Nakhon Nayok,2,11670,260433,128854,131579,170360,170245,115,,,19/1/2022 7:23
12/12/2021,Nakhon Pathom,57,36209,922171,442800,479371,216272,216000,272,102,49,19/1/2022 7:23
12/12/2021,Nakhon Phanom,11,5086,717040,357096,359944,101214,101189,25,,,19/1/2022 7:23
12/12/2021,Nakhon Ratchasima,65,35458,2634154,1293783,1340371,571339,566844,4495,75,37,19/1/2022 7:23
12/12/2021,Nakhon Si Thammarat,349,45547,1549344,764471,784873,138859,138776,83,,,19/1/2022 7:23
12/12/2021,Nakhon Sawan,73,17517,1035028,504657,530371,112947,112567,380,71,46,19/1/2022 7:23
12/12/2021,Nonthaburi,46,68942,1288637,599167,689470,160119,158826,1293,72, ,19/1/2022 7:23
12/12/2021,Narathiwat,29,42408,809660,400501,409159,5393,5393,0,60,26,19/1/2022 7:23
12/12/2021,Nan,22,2837,475875,237959,237916,132711,131256,1455,,,19/1/2022 7:23
12/12/2021,Bueng Kan,27,2553,421995,211494,210501,49966,49403,563,,,19/1/2022 7:23
12/12/2021,Buri Ram,10,17478,1579805,783531,796274,127140,126290,850,,,19/1/2022 7:23
12/12/2021,Pathum Thani,35,42740,1190060,563851,626209,105228,104299,929,78,39,19/1/2022 7:23
12/12/2021,Prachuap Khiri Khan,34,19858,553171,274049,279122,595142,593435,1707,,,19/1/2022 7:23
12/12/2021,Prachin Buri,70,26160,495325,244642,250683,101944,101780,164,83,47,19/1/2022 7:23
12/12/2021,Pattani,88,47936,729581,360348,369233,7237,7237,0,,,19/1/2022 7:23
12/12/2021,Phra Nakhon Si Ayutthaya,61,33267,820512,394024,426488,506314,497703,8611,63,61,19/1/2022 7:23
12/12/2021,Phayao,0,2684,464505,225943,238562,78112,77046,1066,90,36,19/1/2022 7:23
12/12/2021,Phang-nga,61,7078,268016,133785,134231,174747,140351,34396,,,19/1/2022 7:23
12/12/2021,Phatthalung,78,13032,522541,254425,268116,39244,39244,0,,,19/1/2022 7:23
12/12/2021,Phichit,9,5393,529395,258012,271383,47217,47125,92,,,19/1/2022 7:23
12/12/2021,Phitsanulok,51,8727,847384,414577,432807,202694,202078,616,,,19/1/2022 7:23
12/12/2021,Phuket,56,18712,418785,197874,220911,261943,167948,93995,54,30,19/1/2022 7:23
12/12/2021,Maha Sarakham,2,11258,948310,464976,483334,33099,33059,40,,,19/1/2022 7:23
12/12/2021,Mukdahan,1,2549,351484,175633,175851,96965,96923,42,,,19/1/2022 7:23
12/12/2021,Yala,71,48171,542314,269907,272407,48470,48470,0,68,31,19/1/2022 7:23
12/12/2021,Yasothon,10,6064,533394,265945,267449,38817,38817,0,,,19/1/2022 7:23
12/12/2021,Ranong,7,10012,194573,98136,96437,21868,21760,108,,,19/1/2022 7:23
12/12/2021,Rayong,24,46253,751343,368992,382351,442667,440059,2608,75,30,19/1/2022 7:23
12/12/2021,Ratchaburi,61,44554,868281,421921,446360,187297,186671,626,,,19/1/2022 7:23
12/12/2021,Roi Et,18,14391,1296013,641883,654130,44247,44214,33,,,19/1/2022 7:23
12/12/2021,Lop Buri,73,18568,739473,368733,370740,265330,265144,186,,,19/1/2022 7:23
12/12/2021,Lampang,14,3279,724678,352894,371784,147515,146727,788,87,29,19/1/2022 7:23
12/12/2021,Lamphun,45,4525,401139,192712,208427,95420,94339,1081,,,19/1/2022 7:23
12/12/2021,Si Sa Ket,63,19255,1457556,725426,732130,69970,69958,12,,,19/1/2022 7:23
12/12/2021,Sakon Nakhon,19,7893,1146286,569364,576922,123784,123753,31,,,19/1/2022 7:23
12/12/2021,Songkhla,146,66084,1431536,697256,734280,111186,110907,279,58,32,19/1/2022 7:23
12/12/2021,Satun,60,8377,324835,161640,163195,118953,118571,382,35,24,19/1/2022 7:23
12/12/2021,Samut Prakarn,160,133499,1356449,645884,710565,148306,128665,19641,,,19/1/2022 7:23
12/12/2021,Samut Songkhram,4,12009,190842,91101,99741,186767,186640,127,96,49,19/1/2022 7:23
12/12/2021,Samut Sakhon,36,111969,586789,282683,304106,49065,48960,105,97,51,19/1/2022 7:23
12/12/2021,Saraburi,45,33809,643963,316201,327762,308153,307750,403,97,71,19/1/2022 7:23
12/12/2021,Sa kaeo,30,19662,561992,280673,281319,68672,68321,351,71,34,19/1/2022 7:23
12/12/2021,Sing Buri,7,3542,204526,97144,107382,38697,38585,112,,,19/1/2022 7:23
12/12/2021,Suphan Buri,26,16423,835360,402883,432477,346794,346794,0,,,19/1/2022 7:23
12/12/2021,Surat Thani,125,27392,1072464,527349,545115,132624,124431,8193,56,28,19/1/2022 7:23
12/12/2021,Surin,5,19073,1376230,684354,691876,76048,75971,77,,,19/1/2022 7:23
12/12/2021,Sukhothai,7,6447,585352,283429,301923,77889,76248,1641,,,19/1/2022 7:23
12/12/2021,Nong Khai,8,4480,516843,256268,260575,176894,176022,872,38,41,19/1/2022 7:23
12/12/2021,Nong Bua Lam Phu,5,4673,509001,253757,255244,23866,23805,61,,,19/1/2022 7:23
12/12/2021,Amnat Charoen,6,3096,376350,187122,189228,26300,26300,0,,,19/1/2022 7:23
12/12/2021,Udon Thani,29,25438,1566510,775357,791153,215933,215261,672,,,19/1/2022 7:23
12/12/2021,Uttaradit,3,4581,446148,217413,228735,74305,74146,159,,,19/1/2022 7:23
12/12/2021,Uthai Thani,5,3869,325116,158926,166190,46752,46752,0,,,19/1/2022 7:23
12/12/2021,Ubon Ratchathani,12,22719,1868519,932466,936053,211200,211160,40,51,38,19/1/2022 7:23
12/12/2021,Ang Thong,24,11605,274763,131399,143364,42587,42587,0,,,19/1/2022 7:23
12/12/2021,Chiang Rai,16,5777,1298425,630868,667557,362358,360119,2239,101,36,19/1/2022 7:23
12/12/2021,Chiang Mai,87,32609,1789385,864364,925021,817474,810928,6546,80,41,19/1/2022 7:23
12/12/2021,Phetchaburi,7,24228,482875,232927,249948,596099,595951,148,,,19/1/2022 7:23
12/12/2021,Phetchabun,10,12405,978372,482234,496138,196178,195552,626,,,19/1/2022 7:23
12/12/2021,Loei,31,4471,638732,319949,318783,143151,142378,773,81,35,19/1/2022 7:23
12/12/2021,Phrae,1,2033,434580,209403,225177,91286,90937,349,78,32,19/1/2022 7:23
12/12/2021,Mae Hong Son,23,2914,285916,144811,141105,114751,112339,2412,,,19/1/2022 7:23
12/12/2021,,0,173,,,,,,,,,19/1/2022 7:23
13/12/2021,Krabi,69,11281,479351,238092,241259,81255,79570,1685,,,19/1/2022 7:23
13/12/2021,Bangkok,608,461857,5527994,2592292,2935702,2543615,2383978,159637,79,65,19/1/2022 7:23
13/12/2021,Kanchanaburi,19,24396,894054,448312,445742,908851,907622,1229,48,31,19/1/2022 7:23
13/12/2021,Kalasin,11,10045,975570,481988,493582,44112,43792,320,,,19/1/2022 7:23
13/12/2021,Kamphaeng Phet,9,8362,712143,351539,360604,60392,60106,286,,,19/1/2022 7:23
13/12/2021,Khon Kaen,39,26530,1790863,879849,911014,356626,354735,1891,96,54,19/1/2022 7:23
13/12/2021,Chanthaburi,14,22489,536557,262257,274300,132403,132126,277,,,19/1/2022 7:23
13/12/2021,Chachoengsao,31,37761,724178,354834,369344,350064,349850,214,64,51,19/1/2022 7:23
13/12/2021,Chon Buri,134,112536,1583672,772463,811209,975534,964356,11178,62,51,19/1/2022 7:23
13/12/2021,Chai Nat,0,2873,320432,153962,166470,51161,51147,14,,,19/1/2022 7:23
13/12/2021,Chaiyaphum,3,12263,1122265,554299,567966,99618,99364,254,,,19/1/2022 7:23
13/12/2021,Chumphon,46,15979,509479,251405,258074,70890,70798,92,,,19/1/2022 7:23
13/12/2021,Trang,72,17101,639788,312693,327095,91461,91339,122,,,19/1/2022 7:23
13/12/2021,Trat,7,9145,228376,112941,115435,133130,130498,2632,,,19/1/2022 7:23
13/12/2021,Tak,16,25685,676583,341966,334617,109369,109331,38,,,19/1/2022 7:23
13/12/2021,Nakhon Nayok,3,11673,260433,128854,131579,170360,170245,115,,,19/1/2022 7:23
13/12/2021,Nakhon Pathom,30,36239,922171,442800,479371,216272,216000,272,82,54,19/1/2022 7:23
13/12/2021,Nakhon Phanom,1,5087,717040,357096,359944,101214,101189,25,,,19/1/2022 7:23
13/12/2021,Nakhon Ratchasima,53,35511,2634154,1293783,1340371,571339,566844,4495,77,44,19/1/2022 7:23
13/12/2021,Nakhon Si Thammarat,200,45747,1549344,764471,784873,138859,138776,83,,,19/1/2022 7:23
13/12/2021,Nakhon Sawan,66,17583,1035028,504657,530371,112947,112567,380,78,55,19/1/2022 7:23
13/12/2021,Nonthaburi,46,68988,1288637,599167,689470,160119,158826,1293,60, ,19/1/2022 7:23
13/12/2021,Narathiwat,17,42425,809660,400501,409159,5393,5393,0,63,24,19/1/2022 7:23
13/12/2021,Nan,0,2837,475875,237959,237916,132711,131256,1455,,,19/1/2022 7:23
13/12/2021,Bueng Kan,12,2565,421995,211494,210501,49966,49403,563,,,19/1/2022 7:23
13/12/2021,Buri Ram,27,17505,1579805,783531,796274,127140,126290,850,,,19/1/2022 7:23
13/12/2021,Pathum Thani,54,42794,1190060,563851,626209,105228,104299,929,68,57,19/1/2022 7:23
13/12/2021,Prachuap Khiri Khan,106,19964,553171,274049,279122,595142,593435,1707,,,19/1/2022 7:23
13/12/2021,Prachin Buri,57,26217,495325,244642,250683,101944,101780,164,81,51,19/1/2022 7:23
13/12/2021,Pattani,72,48008,729581,360348,369233,7237,7237,0,,,19/1/2022 7:23
13/12/2021,Phra Nakhon Si Ayutthaya,94,33361,820512,394024,426488,506314,497703,8611,60,68,19/1/2022 7:23
13/12/2021,Phayao,1,2685,464505,225943,238562,78112,77046,1066,86,36,19/1/2022 7:23
13/12/2021,Phang-nga,59,7137,268016,133785,134231,174747,140351,34396,,,19/1/2022 7:23
13/12/2021,Phatthalung,62,13094,522541,254425,268116,39244,39244,0,,,19/1/2022 7:23
13/12/2021,Phichit,8,5401,529395,258012,271383,47217,47125,92,,,19/1/2022 7:23
13/12/2021,Phitsanulok,43,8770,847384,414577,432807,202694,202078,616,,,19/1/2022 7:23
13/12/2021,Phuket,70,18782,418785,197874,220911,261943,167948,93995,54,31,19/1/2022 7:23
13/12/2021,Maha Sarakham,5,11263,948310,464976,483334,33099,33059,40,,,19/1/2022 7:23
13/12/2021,Mukdahan,5,2554,351484,175633,175851,96965,96923,42,,,19/1/2022 7:23
13/12/2021,Yala,62,48233,542314,269907,272407,48470,48470,0,67,33,19/1/2022 7:23
13/12/2021,Yasothon,9,6073,533394,265945,267449,38817,38817,0,,,19/1/2022 7:23
13/12/2021,Ranong,4,10016,194573,98136,96437,21868,21760,108,,,19/1/2022 7:23
13/12/2021,Rayong,38,46291,751343,368992,382351,442667,440059,2608,67,47,19/1/2022 7:23
13/12/2021,Ratchaburi,57,44611,868281,421921,446360,187297,186671,626,,,19/1/2022 7:23
13/12/2021,Roi Et,7,14398,1296013,641883,654130,44247,44214,33,,,19/1/2022 7:23
13/12/2021,Lop Buri,24,18592,739473,368733,370740,265330,265144,186,,,19/1/2022 7:23
13/12/2021,Lampang,38,3317,724678,352894,371784,147515,146727,788,74,30,19/1/2022 7:23
13/12/2021,Lamphun,30,4555,401139,192712,208427,95420,94339,1081,,,19/1/2022 7:23
13/12/2021,Si Sa Ket,63,19318,1457556,725426,732130,69970,69958,12,,,19/1/2022 7:23
13/12/2021,Sakon Nakhon,12,7905,1146286,569364,576922,123784,123753,31,,,19/1/2022 7:23
13/12/2021,Songkhla,150,66234,1431536,697256,734280,111186,110907,279,55,33,19/1/2022 7:23
13/12/2021,Satun,59,8436,324835,161640,163195,118953,118571,382,35,26,19/1/2022 7:23
13/12/2021,Samut Prakarn,137,133636,1356449,645884,710565,148306,128665,19641,,,19/1/2022 7:23
13/12/2021,Samut Songkhram,9,12018,190842,91101,99741,186767,186640,127,82,53,19/1/2022 7:23
13/12/2021,Samut Sakhon,38,112007,586789,282683,304106,49065,48960,105,75,62,19/1/2022 7:23
13/12/2021,Saraburi,38,33847,643963,316201,327762,308153,307750,403,82,82,19/1/2022 7:23
13/12/2021,Sa kaeo,16,19678,561992,280673,281319,68672,68321,351,64,39,19/1/2022 7:23
13/12/2021,Sing Buri,2,3544,204526,97144,107382,38697,38585,112,,,19/1/2022 7:23
13/12/2021,Suphan Buri,50,16473,835360,402883,432477,346794,346794,0,,,19/1/2022 7:23
13/12/2021,Surat Thani,118,27510,1072464,527349,545115,132624,124431,8193,55,26,19/1/2022 7:23
13/12/2021,Surin,12,19085,1376230,684354,691876,76048,75971,77,,,19/1/2022 7:23
13/12/2021,Sukhothai,7,6454,585352,283429,301923,77889,76248,1641,,,19/1/2022 7:23
13/12/2021,Nong Khai,3,4483,516843,256268,260575,176894,176022,872,48,39,19/1/2022 7:23
13/12/2021,Nong Bua Lam Phu,8,4681,509001,253757,255244,23866,23805,61,,,19/1/2022 7:23
13/12/2021,Amnat Charoen,0,3096,376350,187122,189228,26300,26300,0,,,19/1/2022 7:23
13/12/2021,Udon Thani,37,25475,1566510,775357,791153,215933,215261,672,,,19/1/2022 7:23
13/12/2021,Uttaradit,2,4583,446148,217413,228735,74305,74146,159,,,19/1/2022 7:23
13/12/2021,Uthai Thani,6,3875,325116,158926,166190,46752,46752,0,,,19/1/2022 7:23
13/12/2021,Ubon Ratchathani,14,22733,1868519,932466,936053,211200,211160,40,64,36,19/1/2022 7:23
13/12/2021,Ang Thong,11,11616,274763,131399,143364,42587,42587,0,,,19/1/2022 7:23
13/12/2021,Chiang Rai,11,5788,1298425,630868,667557,362358,360119,2239,91,32,19/1/2022 7:23
13/12/2021,Chiang Mai,85,32694,1789385,864364,925021,817474,810928,6546,82,39,19/1/2022 7:23
13/12/2021,Phetchaburi,10,24238,482875,232927,249948,596099,595951,148,,,19/1/2022 7:23
13/12/2021,Phetchabun,14,12419,978372,482234,496138,196178,195552,626,,,19/1/2022 7:23
13/12/2021,Loei,23,4494,638732,319949,318783,143151,142378,773,73,46,19/1/2022 7:23
13/12/2021,Phrae,3,2036,434580,209403,225177,91286,90937,349,78,36,19/1/2022 7:23
13/12/2021,Mae Hong Son,22,2936,285916,144811,141105,114751,112339,2412,,,19/1/2022 7:23
13/12/2021,,0,173,,,,,,,,,19/1/2022 7:23
14/12/2021,Krabi,61,11342,479351,238092,241259,81255,79570,1685,,,19/1/2022 7:23
14/12/2021,Bangkok,589,462446,5527994,2592292,2935702,2543615,2383978,159637,123,63,19/1/2022 7:23
14/12/2021,Kanchanaburi,21,24417,894054,448312,445742,908851,907622,1229,62,27,19/1/2022 7:23
14/12/2021,Kalasin,11,10056,975570,481988,493582,44112,43792,320,,,19/1/2022 7:23
14/12/2021,Kamphaeng Phet,7,8369,712143,351539,360604,60392,60106,286,,,19/1/2022 7:23
14/12/2021,Khon Kaen,46,26576,1790863,879849,911014,356626,354735,1891,102,59,19/1/2022 7:23
14/12/2021,Chanthaburi,10,22499,536557,262257,274300,132403,132126,277,,,19/1/2022 7:23
14/12/2021,Chachoengsao,20,37781,724178,354834,369344,350064,349850,214,85,64,19/1/2022 7:23
14/12/2021,Chon Buri,140,112676,1583672,772463,811209,975534,964356,11178,85,57,19/1/2022 7:23
14/12/2021,Chai Nat,11,2884,320432,153962,166470,51161,51147,14,,,19/1/2022 7:23
14/12/2021,Chaiyaphum,1,12264,1122265,554299,567966,99618,99364,254,,,19/1/2022 7:23
14/12/2021,Chumphon,42,16021,509479,251405,258074,70890,70798,92,,,19/1/2022 7:23
14/12/2021,Trang,70,17171,639788,312693,327095,91461,91339,122,,,19/1/2022 7:23
14/12/2021,Trat,10,9155,228376,112941,115435,133130,130498,2632,,,19/1/2022 7:23
14/12/2021,Tak,41,25726,676583,341966,334617,109369,109331,38,,,19/1/2022 7:23
14/12/2021,Nakhon Nayok,7,11680,260433,128854,131579,170360,170245,115,,,19/1/2022 7:23
14/12/2021,Nakhon Pathom,16,36255,922171,442800,479371,216272,216000,272,108,61,19/1/2022 7:23
14/12/2021,Nakhon Phanom,1,5088,717040,357096,359944,101214,101189,25,,,19/1/2022 7:23
14/12/2021,Nakhon Ratchasima,62,35573,2634154,1293783,1340371,571339,566844,4495,95,54,19/1/2022 7:23
14/12/2021,Nakhon Si Thammarat,225,45972,1549344,764471,784873,138859,138776,83,,,19/1/2022 7:23
14/12/2021,Nakhon Sawan,61,17644,1035028,504657,530371,112947,112567,380,99,60,19/1/2022 7:23
14/12/2021,Nonthaburi,35,69023,1288637,599167,689470,160119,158826,1293,92, ,19/1/2022 7:23
14/12/2021,Narathiwat,9,42434,809660,400501,409159,5393,5393,0,55,20,19/1/2022 7:23
14/12/2021,Nan,6,2843,475875,237959,237916,132711,131256,1455,,,19/1/2022 7:23
14/12/2021,Bueng Kan,9,2574,421995,211494,210501,49966,49403,563,,,19/1/2022 7:23
14/12/2021,Buri Ram,13,17518,1579805,783531,796274,127140,126290,850,,,19/1/2022 7:23
14/12/2021,Pathum Thani,23,42817,1190060,563851,626209,105228,104299,929,94,56,19/1/2022 7:23
14/12/2021,Prachuap Khiri Khan,31,19995,553171,274049,279122,595142,593435,1707,,,19/1/2022 7:23
14/12/2021,Prachin Buri,40,26257,495325,244642,250683,101944,101780,164,95,53,19/1/2022 7:23
14/12/2021,Pattani,35,48043,729581,360348,369233,7237,7237,0,,,19/1/2022 7:23
14/12/2021,Phra Nakhon Si Ayutthaya,29,33390,820512,394024,426488,506314,497703,8611,80,69,19/1/2022 7:23
14/12/2021,Phayao,1,2686,464505,225943,238562,78112,77046,1066,85,41,19/1/2022 7:23
14/12/2021,Phang-nga,45,7182,268016,133785,134231,174747,140351,34396,,,19/1/2022 7:23
14/12/2021,Phatthalung,44,13138,522541,254425,268116,39244,39244,0,,,19/1/2022 7:23
14/12/2021,Phichit,8,5409,529395,258012,271383,47217,47125,92,,,19/1/2022 7:23
14/12/2021,Phitsanulok,46,8816,847384,414577,432807,202694,202078,616,,,19/1/2022 7:23
14/12/2021,Phuket,52,18834,418785,197874,220911,261943,167948,93995,48,42,19/1/2022 7:23
14/12/2021,Maha Sarakham,1,11264,948310,464976,483334,33099,33059,40,,,19/1/2022 7:23
14/12/2021,Mukdahan,0,2554,351484,175633,175851,96965,96923,42,,,19/1/2022 7:23
14/12/2021,Yala,40,48273,542314,269907,272407,48470,48470,0,58,31,19/1/2022 7:23
14/12/2021,Yasothon,7,6080,533394,265945,267449,38817,38817,0,,,19/1/2022 7:23
14/12/2021,Ranong,5,10021,194573,98136,96437,21868,21760,108,,,19/1/2022 7:23
14/12/2021,Rayong,25,46316,751343,368992,382351,442667,440059,2608,92,46,19/1/2022 7:23
14/12/2021,Ratchaburi,40,44651,868281,421921,446360,187297,186671,626,,,19/1/2022 7:23
14/12/2021,Roi Et,13,14411,1296013,641883,654130,44247,44214,33,,,19/1/2022 7:23
14/12/2021,Lop Buri,29,18621,739473,368733,370740,265330,265144,186,,,19/1/2022 7:23
14/12/2021,Lampang,19,3336,724678,352894,371784,147515,146727,788,77,36,19/1/2022 7:23
14/12/2021,Lamphun,30,4585,401139,192712,208427,95420,94339,1081,,,19/1/2022 7:23
14/12/2021,Si Sa Ket,8,19326,1457556,725426,732130,69970,69958,12,,,19/1/2022 7:23
14/12/2021,Sakon Nakhon,7,7912,1146286,569364,576922,123784,123753,31,,,19/1/2022 7:23
14/12/2021,Songkhla,121,66355,1431536,697256,734280,111186,110907,279,56,34,19/1/2022 7:23
14/12/2021,Satun,43,8479,324835,161640,163195,118953,118571,382,31,23,19/1/2022 7:23
14/12/2021,Samut Prakarn,106,133742,1356449,645884,710565,148306,128665,19641,,,19/1/2022 7:23
14/12/2021,Samut Songkhram,3,12021,190842,91101,99741,186767,186640,127,104,52,19/1/2022 7:23
14/12/2021,Samut Sakhon,23,112030,586789,282683,304106,49065,48960,105,106,66,19/1/2022 7:23
14/12/2021,Saraburi,46,33893,643963,316201,327762,308153,307750,403,108,108,19/1/2022 7:23
14/12/2021,Sa kaeo,12,19690,561992,280673,281319,68672,68321,351,80,39,19/1/2022 7:23
14/12/2021,Sing Buri,5,3549,204526,97144,107382,38697,38585,112,,,19/1/2022 7:23
14/12/2021,Suphan Buri,12,16485,835360,402883,432477,346794,346794,0,,,19/1/2022 7:23
14/12/2021,Surat Thani,107,27617,1072464,527349,545115,132624,124431,8193,59,31,19/1/2022 7:23
14/12/2021,Surin,10,19095,1376230,684354,691876,76048,75971,77,,,19/1/2022 7:23
14/12/2021,Sukhothai,9,6463,585352,283429,301923,77889,76248,1641,,,19/1/2022 7:23
14/12/2021,Nong Khai,0,4483,516843,256268,260575,176894,176022,872,53,41,19/1/2022 7:23
14/12/2021,Nong Bua Lam Phu,3,4684,509001,253757,255244,23866,23805,61,,,19/1/2022 7:23
14/12/2021,Amnat Charoen,1,3097,376350,187122,189228,26300,26300,0,,,19/1/2022 7:23
14/12/2021,Udon Thani,19,25494,1566510,775357,791153,215933,215261,672,,,19/1/2022 7:23
14/12/2021,Uttaradit,18,4601,446148,217413,228735,74305,74146,159,,,19/1/2022 7:23
14/12/2021,Uthai Thani,1,3876,325116,158926,166190,46752,46752,0,,,19/1/2022 7:23
14/12/2021,Ubon Ratchathani,5,22738,1868519,932466,936053,211200,211160,40,76,40,19/1/2022 7:23
14/12/2021,Ang Thong,6,11622,274763,131399,143364,42587,42587,0,,,19/1/2022 7:23
14/12/2021,Chiang Rai,18,5806,1298425,630868,667557,362358,360119,2239,86,38,19/1/2022 7:23
14/12/2021,Chiang Mai,93,32787,1789385,864364,925021,817474,810928,6546,78,41,19/1/2022 7:23
14/12/2021,Phetchaburi,26,24264,482875,232927,249948,596099,595951,148,,,19/1/2022 7:23
14/12/2021,Phetchabun,26,12445,978372,482234,496138,196178,195552,626,,,19/1/2022 7:23
14/12/2021,Loei,17,4511,638732,319949,318783,143151,142378,773,94,54,19/1/2022 7:23
14/12/2021,Phrae,0,2036,434580,209403,225177,91286,90937,349,88,39,19/1/2022 7:23
14/12/2021,Mae Hong Son,30,2966,285916,144811,141105,114751,112339,2412,,,19/1/2022 7:23
14/12/2021,,0,173,,,,,,,,,19/1/2022 7:23
15/12/2021,Krabi,59,11401,479351,238092,241259,81255,79570,1685,,,19/1/2022 7:23
15/12/2021,Bangkok,637,463083,5527994,2592292,2935702,2543615,2383978,159637,129,62,19/1/2022 7:23
15/12/2021,Kanchanaburi,24,24441,894054,448312,445742,908851,907622,1229,59,47,19/1/2022 7:23
15/12/2021,Kalasin,6,10062,975570,481988,493582,44112,43792,320,,,19/1/2022 7:23
15/12/2021,Kamphaeng Phet,3,8372,712143,351539,360604,60392,60106,286,,,19/1/2022 7:23
15/12/2021,Khon Kaen,50,26626,1790863,879849,911014,356626,354735,1891,114,63,19/1/2022 7:23
15/12/2021,Chanthaburi,15,22514,536557,262257,274300,132403,132126,277,,,19/1/2022 7:23
15/12/2021,Chachoengsao,54,37835,724178,354834,369344,350064,349850,214,91,57,19/1/2022 7:23
15/12/2021,Chon Buri,173,112849,1583672,772463,811209,975534,964356,11178,98,71,19/1/2022 7:23
15/12/2021,Chai Nat,6,2890,320432,153962,166470,51161,51147,14,,,19/1/2022 7:23
15/12/2021,Chaiyaphum,3,12267,1122265,554299,567966,99618,99364,254,,,19/1/2022 7:23
15/12/2021,Chumphon,60,16081,509479,251405,258074,70890,70798,92,,,19/1/2022 7:23
15/12/2021,Trang,71,17242,639788,312693,327095,91461,91339,122,,,19/1/2022 7:23
15/12/2021,Trat,34,9189,228376,112941,115435,133130,130498,2632,,,19/1/2022 7:23
15/12/2021,Tak,60,25786,676583,341966,334617,109369,109331,38,,,19/1/2022 7:23
15/12/2021,Nakhon Nayok,12,11692,260433,128854,131579,170360,170245,115,,,19/1/2022 7:23
15/12/2021,Nakhon Pathom,49,36304,922171,442800,479371,216272,216000,272,125,64,19/1/2022 7:23
15/12/2021,Nakhon Phanom,3,5091,717040,357096,359944,101214,101189,25,,,19/1/2022 7:23
15/12/2021,Nakhon Ratchasima,51,35624,2634154,1293783,1340371,571339,566844,4495,113,57,19/1/2022 7:23
15/12/2021,Nakhon Si Thammarat,151,46123,1549344,764471,784873,138859,138776,83,,,19/1/2022 7:23
15/12/2021,Nakhon Sawan,65,17709,1035028,504657,530371,112947,112567,380,111,53,19/1/2022 7:23
15/12/2021,Nonthaburi,29,69052,1288637,599167,689470,160119,158826,1293,100, ,19/1/2022 7:23
15/12/2021,Narathiwat,33,42467,809660,400501,409159,5393,5393,0,52,20,19/1/2022 7:23
15/12/2021,Nan,4,2847,475875,237959,237916,132711,131256,1455,,,19/1/2022 7:23
15/12/2021,Bueng Kan,17,2591,421995,211494,210501,49966,49403,563,,,19/1/2022 7:23
15/12/2021,Buri Ram,24,17542,1579805,783531,796274,127140,126290,850,,,19/1/2022 7:23
15/12/2021,Pathum Thani,27,42844,1190060,563851,626209,105228,104299,929,99,63,19/1/2022 7:23
15/12/2021,Prachuap Khiri Khan,52,20047,553171,274049,279122,595142,593435,1707,,,19/1/2022 7:23
15/12/2021,Prachin Buri,76,26333,495325,244642,250683,101944,101780,164,101,63,19/1/2022 7:23
15/12/2021,Pattani,117,48160,729581,360348,369233,7237,7237,0,,,19/1/2022 7:23
15/12/2021,Phra Nakhon Si Ayutthaya,35,33425,820512,394024,426488,506314,497703,8611,95,76,19/1/2022 7:23
15/12/2021,Phayao,10,2696,464505,225943,238562,78112,77046,1066,91,33,19/1/2022 7:23
15/12/2021,Phang-nga,54,7236,268016,133785,134231,174747,140351,34396,,,19/1/2022 7:23
15/12/2021,Phatthalung,43,13181,522541,254425,268116,39244,39244,0,,,19/1/2022 7:23
15/12/2021,Phichit,3,5412,529395,258012,271383,47217,47125,92,,,19/1/2022 7:23
15/12/2021,Phitsanulok,67,8883,847384,414577,432807,202694,202078,616,,,19/1/2022 7:23
15/12/2021,Phuket,49,18883,418785,197874,220911,261943,167948,93995,74,40,19/1/2022 7:23
15/12/2021,Maha Sarakham,8,11272,948310,464976,483334,33099,33059,40,,,19/1/2022 7:23
15/12/2021,Mukdahan,4,2558,351484,175633,175851,96965,96923,42,,,19/1/2022 7:23
15/12/2021,Yala,45,48318,542314,269907,272407,48470,48470,0,59,24,19/1/2022 7:23
15/12/2021,Yasothon,2,6082,533394,265945,267449,38817,38817,0,,,19/1/2022 7:23
15/12/2021,Ranong,6,10027,194573,98136,96437,21868,21760,108,,,19/1/2022 7:23
15/12/2021,Rayong,25,46341,751343,368992,382351,442667,440059,2608,100,53,19/1/2022 7:23
15/12/2021,Ratchaburi,43,44694,868281,421921,446360,187297,186671,626,,,19/1/2022 7:23
15/12/2021,Roi Et,2,14413,1296013,641883,654130,44247,44214,33,,,19/1/2022 7:23
15/12/2021,Lop Buri,23,18644,739473,368733,370740,265330,265144,186,,,19/1/2022 7:23
15/12/2021,Lampang,22,3358,724678,352894,371784,147515,146727,788,92,37,19/1/2022 7:23
15/12/2021,Lamphun,12,4597,401139,192712,208427,95420,94339,1081,,,19/1/2022 7:23
15/12/2021,Si Sa Ket,20,19346,1457556,725426,732130,69970,69958,12,,,19/1/2022 7:23
15/12/2021,Sakon Nakhon,7,7919,1146286,569364,576922,123784,123753,31,,,19/1/2022 7:23
15/12/2021,Songkhla,149,66504,1431536,697256,734280,111186,110907,279,62,40,19/1/2022 7:23
15/12/2021,Satun,58,8537,324835,161640,163195,118953,118571,382,29,29,19/1/2022 7:23
15/12/2021,Samut Prakarn,142,133884,1356449,645884,710565,148306,128665,19641,,,19/1/2022 7:23
15/12/2021,Samut Songkhram,4,12025,190842,91101,99741,186767,186640,127,100,53,19/1/2022 7:23
15/12/2021,Samut Sakhon,20,112050,586789,282683,304106,49065,48960,105,120,70,19/1/2022 7:23
15/12/2021,Saraburi,47,33940,643963,316201,327762,308153,307750,403,121,118,19/1/2022 7:23
15/12/2021,Sa kaeo,36,19726,561992,280673,281319,68672,68321,351,78,41,19/1/2022 7:23
15/12/2021,Sing Buri,3,3552,204526,97144,107382,38697,38585,112,,,19/1/2022 7:23
15/12/2021,Suphan Buri,38,16523,835360,402883,432477,346794,346794,0,,,19/1/2022 7:23
15/12/2021,Surat Thani,97,27714,1072464,527349,545115,132624,124431,8193,76,37,19/1/2022 7:23
15/12/2021,Surin,9,19104,1376230,684354,691876,76048,75971,77,,,19/1/2022 7:23
15/12/2021,Sukhothai,26,6489,585352,283429,301923,77889,76248,1641,,,19/1/2022 7:23
15/12/2021,Nong Khai,2,4485,516843,256268,260575,176894,176022,872,62,38,19/1/2022 7:23
15/12/2021,Nong Bua Lam Phu,8,4692,509001,253757,255244,23866,23805,61,,,19/1/2022 7:23
15/12/2021,Amnat Charoen,2,3099,376350,187122,189228,26300,26300,0,,,19/1/2022 7:23
15/12/2021,Udon Thani,56,25550,1566510,775357,791153,215933,215261,672,,,19/1/2022 7:23
15/12/2021,Uttaradit,2,4603,446148,217413,228735,74305,74146,159,,,19/1/2022 7:23
15/12/2021,Uthai Thani,4,3880,325116,158926,166190,46752,46752,0,,,19/1/2022 7:23
15/12/2021,Ubon Ratchathani,8,22746,1868519,932466,936053,211200,211160,40,75,28,19/1/2022 7:23
15/12/2021,Ang Thong,3,11625,274763,131399,143364,42587,42587,0,,,19/1/2022 7:23
15/12/2021,Chiang Rai,13,5819,1298425,630868,667557,362358,360119,2239,94,36,19/1/2022 7:23
15/12/2021,Chiang Mai,90,32877,1789385,864364,925021,817474,810928,6546,83,38,19/1/2022 7:23
15/12/2021,Phetchaburi,29,24293,482875,232927,249948,596099,595951,148,,,19/1/2022 7:23
15/12/2021,Phetchabun,16,12461,978372,482234,496138,196178,195552,626,,,19/1/2022 7:23
15/12/2021,Loei,19,4530,638732,319949,318783,143151,142378,773,109,46,19/1/2022 7:23
15/12/2021,Phrae,4,2040,434580,209403,225177,91286,90937,349,96,37,19/1/2022 7:23
15/12/2021,Mae Hong Son,40,3006,285916,144811,141105,114751,112339,2412,,,19/1/2022 7:23
15/12/2021,,0,173,,,,,,,,,19/1/2022 7:23
16/12/2021,Krabi,56,11457,479351,238092,241259,81255,79570,1685,,,19/1/2022 7:23
16/12/2021,Bangkok,604,463687,5527994,2592292,2935702,2543615,2383978,159637,131,57,19/1/2022 7:23
16/12/2021,Kanchanaburi,21,24462,894054,448312,445742,908851,907622,1229,80,58,19/1/2022 7:23
16/12/2021,Kalasin,15,10077,975570,481988,493582,44112,43792,320,,,19/1/2022 7:23
16/12/2021,Kamphaeng Phet,9,8381,712143,351539,360604,60392,60106,286,,,19/1/2022 7:23
16/12/2021,Khon Kaen,99,26725,1790863,879849,911014,356626,354735,1891,128,54,19/1/2022 7:23
16/12/2021,Chanthaburi,23,22537,536557,262257,274300,132403,132126,277,,,19/1/2022 7:23
16/12/2021,Chachoengsao,55,37890,724178,354834,369344,350064,349850,214,117,58,19/1/2022 7:23
16/12/2021,Chon Buri,160,113009,1583672,772463,811209,975534,964356,11178,133,58,19/1/2022 7:23
16/12/2021,Chai Nat,3,2893,320432,153962,166470,51161,51147,14,,,19/1/2022 7:23
16/12/2021,Chaiyaphum,1,12268,1122265,554299,567966,99618,99364,254,,,19/1/2022 7:23
16/12/2021,Chumphon,31,16112,509479,251405,258074,70890,70798,92,,,19/1/2022 7:23
16/12/2021,Trang,59,17301,639788,312693,327095,91461,91339,122,,,19/1/2022 7:23
16/12/2021,Trat,10,9199,228376,112941,115435,133130,130498,2632,,,19/1/2022 7:23
16/12/2021,Tak,81,25867,676583,341966,334617,109369,109331,38,,,19/1/2022 7:23
16/12/2021,Nakhon Nayok,6,11698,260433,128854,131579,170360,170245,115,,,19/1/2022 7:23
16/12/2021,Nakhon Pathom,37,36341,922171,442800,479371,216272,216000,272,114,63,19/1/2022 7:23
16/12/2021,Nakhon Phanom,2,5093,717040,357096,359944,101214,101189,25,,,19/1/2022 7:23
16/12/2021,Nakhon Ratchasima,52,35676,2634154,1293783,1340371,571339,566844,4495,118,47,19/1/2022 7:23
16/12/2021,Nakhon Si Thammarat,290,46413,1549344,764471,784873,138859,138776,83,,,19/1/2022 7:23
16/12/2021,Nakhon Sawan,89,17798,1035028,504657,530371,112947,112567,380,95,53,19/1/2022 7:23
16/12/2021,Nonthaburi,51,69103,1288637,599167,689470,160119,158826,1293,111, ,19/1/2022 7:23
16/12/2021,Narathiwat,28,42495,809660,400501,409159,5393,5393,0,60,22,19/1/2022 7:23
16/12/2021,Nan,9,2856,475875,237959,237916,132711,131256,1455,,,19/1/2022 7:23
16/12/2021,Bueng Kan,33,2624,421995,211494,210501,49966,49403,563,,,19/1/2022 7:23
16/12/2021,Buri Ram,23,17565,1579805,783531,796274,127140,126290,850,,,19/1/2022 7:23
16/12/2021,Pathum Thani,35,42879,1190060,563851,626209,105228,104299,929,127,56,19/1/2022 7:23
16/12/2021,Prachuap Khiri Khan,51,20098,553171,274049,279122,595142,593435,1707,,,19/1/2022 7:23
16/12/2021,Prachin Buri,38,26371,495325,244642,250683,101944,101780,164,111,55,19/1/2022 7:23
16/12/2021,Pattani,73,48233,729581,360348,369233,7237,7237,0,,,19/1/2022 7:23
16/12/2021,Phra Nakhon Si Ayutthaya,90,33515,820512,394024,426488,506314,497703,8611,113,75,19/1/2022 7:23
16/12/2021,Phayao,5,2701,464505,225943,238562,78112,77046,1066,81,34,19/1/2022 7:23
16/12/2021,Phang-nga,67,7303,268016,133785,134231,174747,140351,34396,,,19/1/2022 7:23
16/12/2021,Phatthalung,60,13241,522541,254425,268116,39244,39244,0,,,19/1/2022 7:23
16/12/2021,Phichit,5,5417,529395,258012,271383,47217,47125,92,,,19/1/2022 7:23
16/12/2021,Phitsanulok,107,8990,847384,414577,432807,202694,202078,616,,,19/1/2022 7:23
16/12/2021,Phuket,60,18943,418785,197874,220911,261943,167948,93995,73,43,19/1/2022 7:23
16/12/2021,Maha Sarakham,11,11283,948310,464976,483334,33099,33059,40,,,19/1/2022 7:23
16/12/2021,Mukdahan,1,2559,351484,175633,175851,96965,96923,42,,,19/1/2022 7:23
16/12/2021,Yala,74,48392,542314,269907,272407,48470,48470,0,59,17,19/1/2022 7:23
16/12/2021,Yasothon,4,6086,533394,265945,267449,38817,38817,0,,,19/1/2022 7:23
16/12/2021,Ranong,4,10031,194573,98136,96437,21868,21760,108,,,19/1/2022 7:23
16/12/2021,Rayong,59,46400,751343,368992,382351,442667,440059,2608,115,53,19/1/2022 7:23
16/12/2021,Ratchaburi,49,44743,868281,421921,446360,187297,186671,626,,,19/1/2022 7:23
16/12/2021,Roi Et,5,14418,1296013,641883,654130,44247,44214,33,,,19/1/2022 7:23
16/12/2021,Lop Buri,31,18675,739473,368733,370740,265330,265144,186,,,19/1/2022 7:23
16/12/2021,Lampang,38,3396,724678,352894,371784,147515,146727,788,101,28,19/1/2022 7:23
16/12/2021,Lamphun,10,4607,401139,192712,208427,95420,94339,1081,,,19/1/2022 7:23
16/12/2021,Si Sa Ket,45,19391,1457556,725426,732130,69970,69958,12,,,19/1/2022 7:23
16/12/2021,Sakon Nakhon,7,7926,1146286,569364,576922,123784,123753,31,,,19/1/2022 7:23
16/12/2021,Songkhla,106,66610,1431536,697256,734280,111186,110907,279,79,27,19/1/2022 7:23
16/12/2021,Satun,44,8581,324835,161640,163195,118953,118571,382,41,31,19/1/2022 7:23
16/12/2021,Samut Prakarn,167,134051,1356449,645884,710565,148306,128665,19641,,,19/1/2022 7:23
16/12/2021,Samut Songkhram,9,12034,190842,91101,99741,186767,186640,127,102,55,19/1/2022 7:23
16/12/2021,Samut Sakhon,31,112081,586789,282683,304106,49065,48960,105,130,66,19/1/2022 7:23
16/12/2021,Saraburi,44,33984,643963,316201,327762,308153,307750,403,140,89,19/1/2022 7:23
16/12/2021,Sa kaeo,16,19742,561992,280673,281319,68672,68321,351,79,38,19/1/2022 7:23
16/12/2021,Sing Buri,9,3561,204526,97144,107382,38697,38585,112,,,19/1/2022 7:23
16/12/2021,Suphan Buri,28,16551,835360,402883,432477,346794,346794,0,,,19/1/2022 7:23
16/12/2021,Surat Thani,96,27810,1072464,527349,545115,132624,124431,8193,96,45,19/1/2022 7:23
16/12/2021,Surin,9,19113,1376230,684354,691876,76048,75971,77,,,19/1/2022 7:23
16/12/2021,Sukhothai,8,6497,585352,283429,301923,77889,76248,1641,,,19/1/2022 7:23
16/12/2021,Nong Khai,0,4485,516843,256268,260575,176894,176022,872,60,32,19/1/2022 7:23
16/12/2021,Nong Bua Lam Phu,4,4696,509001,253757,255244,23866,23805,61,,,19/1/2022 7:23
16/12/2021,Amnat Charoen,2,3101,376350,187122,189228,26300,26300,0,,,19/1/2022 7:23
16/12/2021,Udon Thani,89,25639,1566510,775357,791153,215933,215261,672,,,19/1/2022 7:23
16/12/2021,Uttaradit,8,4611,446148,217413,228735,74305,74146,159,,,19/1/2022 7:23
16/12/2021,Uthai Thani,0,3880,325116,158926,166190,46752,46752,0,,,19/1/2022 7:23
16/12/2021,Ubon Ratchathani,10,22756,1868519,932466,936053,211200,211160,40,55,28,19/1/2022 7:23
16/12/2021,Ang Thong,31,11656,274763,131399,143364,42587,42587,0,,,19/1/2022 7:23
16/12/2021,Chiang Rai,17,5836,1298425,630868,667557,362358,360119,2239,90,27,19/1/2022 7:23
16/12/2021,Chiang Mai,68,32945,1789385,864364,925021,817474,810928,6546,78,34,19/1/2022 7:23
16/12/2021,Phetchaburi,45,24338,482875,232927,249948,596099,595951,148,,,19/1/2022 7:23
16/12/2021,Phetchabun,22,12483,978372,482234,496138,196178,195552,626,,,19/1/2022 7:23
16/12/2021,Loei,12,4542,638732,319949,318783,143151,142378,773,89,42,19/1/2022 7:23
16/12/2021,Phrae,3,2043,434580,209403,225177,91286,90937,349,87,36,19/1/2022 7:23
16/12/2021,Mae Hong Son,30,3036,285916,144811,141105,114751,112339,2412,,,19/1/2022 7:23
16/12/2021,,0,173,,,,,,,,,19/1/2022 7:23
17/12/2021,Krabi,191,11648,479351,238092,241259,81255,79570,1685,,,19/1/2022 7:23
17/12/2021,Bangkok,588,464275,5527994,2592292,2935702,2543615,2383978,159637,117,48,19/1/2022 7:23
17/12/2021,Kanchanaburi,25,24487,894054,448312,445742,908851,907622,1229,97,64,19/1/2022 7:23
17/12/2021,Kalasin,18,10095,975570,481988,493582,44112,43792,320,,,19/1/2022 7:23
17/12/2021,Kamphaeng Phet,13,8394,712143,351539,360604,60392,60106,286,,,19/1/2022 7:23
17/12/2021,Khon Kaen,28,26753,1790863,879849,911014,356626,354735,1891,99,56,19/1/2022 7:23
17/12/2021,Chanthaburi,30,22567,536557,262257,274300,132403,132126,277,,,19/1/2022 7:23
17/12/2021,Chachoengsao,42,37932,724178,354834,369344,350064,349850,214,114,51,19/1/2022 7:23
17/12/2021,Chon Buri,168,113177,1583672,772463,811209,975534,964356,11178,106,41,19/1/2022 7:23
17/12/2021,Chai Nat,4,2897,320432,153962,166470,51161,51147,14,,,19/1/2022 7:23
17/12/2021,Chaiyaphum,1,12269,1122265,554299,567966,99618,99364,254,,,19/1/2022 7:23
17/12/2021,Chumphon,36,16148,509479,251405,258074,70890,70798,92,,,19/1/2022 7:23
17/12/2021,Trang,56,17357,639788,312693,327095,91461,91339,122,,,19/1/2022 7:23
17/12/2021,Trat,17,9216,228376,112941,115435,133130,130498,2632,,,19/1/2022 7:23
17/12/2021,Tak,63,25930,676583,341966,334617,109369,109331,38,,,19/1/2022 7:23
17/12/2021,Nakhon Nayok,6,11704,260433,128854,131579,170360,170245,115,,,19/1/2022 7:23
17/12/2021,Nakhon Pathom,30,36371,922171,442800,479371,216272,216000,272,118,54,19/1/2022 7:23
17/12/2021,Nakhon Phanom,13,5106,717040,357096,359944,101214,101189,25,,,19/1/2022 7:23
17/12/2021,Nakhon Ratchasima,53,35729,2634154,1293783,1340371,571339,566844,4495,97,57,19/1/2022 7:23
17/12/2021,Nakhon Si Thammarat,208,46621,1549344,764471,784873,138859,138776,83,,,19/1/2022 7:23
17/12/2021,Nakhon Sawan,39,17837,1035028,504657,530371,112947,112567,380,98,51,19/1/2022 7:23
17/12/2021,Nonthaburi,44,69147,1288637,599167,689470,160119,158826,1293,94, ,19/1/2022 7:23
17/12/2021,Narathiwat,49,42544,809660,400501,409159,5393,5393,0,53,35,19/1/2022 7:23
17/12/2021,Nan,8,2864,475875,237959,237916,132711,131256,1455,,,19/1/2022 7:23
17/12/2021,Bueng Kan,37,2661,421995,211494,210501,49966,49403,563,,,19/1/2022 7:23
17/12/2021,Buri Ram,31,17596,1579805,783531,796274,127140,126290,850,,,19/1/2022 7:23
17/12/2021,Pathum Thani,56,42935,1190060,563851,626209,105228,104299,929,106,52,19/1/2022 7:23
17/12/2021,Prachuap Khiri Khan,78,20176,553171,274049,279122,595142,593435,1707,,,19/1/2022 7:23
17/12/2021,Prachin Buri,45,26416,495325,244642,250683,101944,101780,164,97,54,19/1/2022 7:23
17/12/2021,Pattani,110,48343,729581,360348,369233,7237,7237,0,,,19/1/2022 7:23
17/12/2021,Phra Nakhon Si Ayutthaya,50,33565,820512,394024,426488,506314,497703,8611,93,68,19/1/2022 7:23
17/12/2021,Phayao,4,2705,464505,225943,238562,78112,77046,1066,79,36,19/1/2022 7:23
17/12/2021,Phang-nga,40,7343,268016,133785,134231,174747,140351,34396,,,19/1/2022 7:23
17/12/2021,Phatthalung,77,13318,522541,254425,268116,39244,39244,0,,,19/1/2022 7:23
17/12/2021,Phichit,7,5424,529395,258012,271383,47217,47125,92,,,19/1/2022 7:23
17/12/2021,Phitsanulok,55,9045,847384,414577,432807,202694,202078,616,,,19/1/2022 7:23
17/12/2021,Phuket,49,18992,418785,197874,220911,261943,167948,93995,81,38,19/1/2022 7:23
17/12/2021,Maha Sarakham,19,11302,948310,464976,483334,33099,33059,40,,,19/1/2022 7:23
17/12/2021,Mukdahan,2,2561,351484,175633,175851,96965,96923,42,,,19/1/2022 7:23
17/12/2021,Yala,51,48443,542314,269907,272407,48470,48470,0,49,26,19/1/2022 7:23
17/12/2021,Yasothon,2,6088,533394,265945,267449,38817,38817,0,,,19/1/2022 7:23
17/12/2021,Ranong,3,10034,194573,98136,96437,21868,21760,108,,,19/1/2022 7:23
17/12/2021,Rayong,63,46463,751343,368992,382351,442667,440059,2608,116,37,19/1/2022 7:23
17/12/2021,Ratchaburi,50,44793,868281,421921,446360,187297,186671,626,,,19/1/2022 7:23
17/12/2021,Roi Et,12,14430,1296013,641883,654130,44247,44214,33,,,19/1/2022 7:23
17/12/2021,Lop Buri,47,18722,739473,368733,370740,265330,265144,186,,,19/1/2022 7:23
17/12/2021,Lampang,25,3421,724678,352894,371784,147515,146727,788,76,33,19/1/2022 7:23
17/12/2021,Lamphun,33,4640,401139,192712,208427,95420,94339,1081,,,19/1/2022 7:23
17/12/2021,Si Sa Ket,12,19403,1457556,725426,732130,69970,69958,12,,,19/1/2022 7:23
17/12/2021,Sakon Nakhon,19,7945,1146286,569364,576922,123784,123753,31,,,19/1/2022 7:23
17/12/2021,Songkhla,138,66748,1431536,697256,734280,111186,110907,279,65,32,19/1/2022 7:23
17/12/2021,Satun,35,8616,324835,161640,163195,118953,118571,382,36,29,19/1/2022 7:23
17/12/2021,Samut Prakarn,130,134181,1356449,645884,710565,148306,128665,19641,,,19/1/2022 7:23
17/12/2021,Samut Songkhram,3,12037,190842,91101,99741,186767,186640,127,101,51,19/1/2022 7:23
17/12/2021,Samut Sakhon,34,112115,586789,282683,304106,49065,48960,105,118,56,19/1/2022 7:23
17/12/2021,Saraburi,49,34033,643963,316201,327762,308153,307750,403,108,78,19/1/2022 7:23
17/12/2021,Sa kaeo,25,19767,561992,280673,281319,68672,68321,351,70,39,19/1/2022 7:23
17/12/2021,Sing Buri,7,3568,204526,97144,107382,38697,38585,112,,,19/1/2022 7:23
17/12/2021,Suphan Buri,24,16575,835360,402883,432477,346794,346794,0,,,19/1/2022 7:23
17/12/2021,Surat Thani,89,27899,1072464,527349,545115,132624,124431,8193,83,40,19/1/2022 7:23
17/12/2021,Surin,3,19116,1376230,684354,691876,76048,75971,77,,,19/1/2022 7:23
17/12/2021,Sukhothai,6,6503,585352,283429,301923,77889,76248,1641,,,19/1/2022 7:23
17/12/2021,Nong Khai,2,4487,516843,256268,260575,176894,176022,872,45,39,19/1/2022 7:23
17/12/2021,Nong Bua Lam Phu,2,4698,509001,253757,255244,23866,23805,61,,,19/1/2022 7:23
17/12/2021,Amnat Charoen,0,3101,376350,187122,189228,26300,26300,0,,,19/1/2022 7:23
17/12/2021,Udon Thani,34,25673,1566510,775357,791153,215933,215261,672,,,19/1/2022 7:23
17/12/2021,Uttaradit,0,4611,446148,217413,228735,74305,74146,159,,,19/1/2022 7:23
17/12/2021,Uthai Thani,1,3881,325116,158926,166190,46752,46752,0,,,19/1/2022 7:23
17/12/2021,Ubon Ratchathani,27,22783,1868519,932466,936053,211200,211160,40,45,41,19/1/2022 7:23
17/12/2021,Ang Thong,29,11685,274763,131399,143364,42587,42587,0,,,19/1/2022 7:23
17/12/2021,Chiang Rai,17,5853,1298425,630868,667557,362358,360119,2239,76,32,19/1/2022 7:23
17/12/2021,Chiang Mai,65,33010,1789385,864364,925021,817474,810928,6546,72,37,19/1/2022 7:23
17/12/2021,Phetchaburi,23,24361,482875,232927,249948,596099,595951,148,,,19/1/2022 7:23
17/12/2021,Phetchabun,41,12524,978372,482234,496138,196178,195552,626,,,19/1/2022 7:23
17/12/2021,Loei,1,4543,638732,319949,318783,143151,142378,773,83,45,19/1/2022 7:23
17/12/2021,Phrae,1,2044,434580,209403,225177,91286,90937,349,89,41,19/1/2022 7:23
17/12/2021,Mae Hong Son,44,3080,285916,144811,141105,114751,112339,2412,,,19/1/2022 7:23
17/12/2021,,0,173,,,,,,,,,19/1/2022 7:23
18/12/2021,Krabi,33,11681,479351,238092,241259,81255,79570,1685,,,19/1/2022 7:23
18/12/2021,Bangkok,589,464864,5527994,2592292,2935702,2543615,2383978,159637,90,43,19/1/2022 7:23
18/12/2021,Kanchanaburi,24,24511,894054,448312,445742,908851,907622,1229,96,49,19/1/2022 7:23
18/12/2021,Kalasin,18,10113,975570,481988,493582,44112,43792,320,,,19/1/2022 7:23
18/12/2021,Kamphaeng Phet,11,8405,712143,351539,360604,60392,60106,286,,,19/1/2022 7:23
18/12/2021,Khon Kaen,42,26795,1790863,879849,911014,356626,354735,1891,109,54,19/1/2022 7:23
18/12/2021,Chanthaburi,23,22590,536557,262257,274300,132403,132126,277,,,19/1/2022 7:23
18/12/2021,Chachoengsao,52,37984,724178,354834,369344,350064,349850,214,73,48,19/1/2022 7:23
18/12/2021,Chon Buri,164,113341,1583672,772463,811209,975534,964356,11178,68,36,19/1/2022 7:23
18/12/2021,Chai Nat,3,2900,320432,153962,166470,51161,51147,14,,,19/1/2022 7:23
18/12/2021,Chaiyaphum,2,12271,1122265,554299,567966,99618,99364,254,,,19/1/2022 7:23
18/12/2021,Chumphon,81,16229,509479,251405,258074,70890,70798,92,,,19/1/2022 7:23
18/12/2021,Trang,65,17422,639788,312693,327095,91461,91339,122,,,19/1/2022 7:23
18/12/2021,Trat,15,9231,228376,112941,115435,133130,130498,2632,,,19/1/2022 7:23
18/12/2021,Tak,28,25958,676583,341966,334617,109369,109331,38,,,19/1/2022 7:23
18/12/2021,Nakhon Nayok,30,11734,260433,128854,131579,170360,170245,115,,,19/1/2022 7:23
18/12/2021,Nakhon Pathom,22,36393,922171,442800,479371,216272,216000,272,91,47,19/1/2022 7:23
18/12/2021,Nakhon Phanom,9,5115,717040,357096,359944,101214,101189,25,,,19/1/2022 7:23
18/12/2021,Nakhon Ratchasima,33,35762,2634154,1293783,1340371,571339,566844,4495,102,38,19/1/2022 7:23
18/12/2021,Nakhon Si Thammarat,184,46805,1549344,764471,784873,138859,138776,83,,,19/1/2022 7:23
18/12/2021,Nakhon Sawan,59,17896,1035028,504657,530371,112947,112567,380,92,50,19/1/2022 7:23
18/12/2021,Nonthaburi,37,69184,1288637,599167,689470,160119,158826,1293,71, ,19/1/2022 7:23
18/12/2021,Narathiwat,29,42573,809660,400501,409159,5393,5393,0,66,25,19/1/2022 7:23
18/12/2021,Nan,3,2867,475875,237959,237916,132711,131256,1455,,,19/1/2022 7:23
18/12/2021,Bueng Kan,12,2673,421995,211494,210501,49966,49403,563,,,19/1/2022 7:23
18/12/2021,Buri Ram,23,17619,1579805,783531,796274,127140,126290,850,,,19/1/2022 7:23
18/12/2021,Pathum Thani,56,42991,1190060,563851,626209,105228,104299,929,82,48,19/1/2022 7:23
18/12/2021,Prachuap Khiri Khan,42,20218,553171,274049,279122,595142,593435,1707,,,19/1/2022 7:23
18/12/2021,Prachin Buri,37,26453,495325,244642,250683,101944,101780,164,87,53,19/1/2022 7:23
18/12/2021,Pattani,79,48422,729581,360348,369233,7237,7237,0,,,19/1/2022 7:23
18/12/2021,Phra Nakhon Si Ayutthaya,49,33614,820512,394024,426488,506314,497703,8611,72,69,19/1/2022 7:23
18/12/2021,Phayao,6,2711,464505,225943,238562,78112,77046,1066,83,44,19/1/2022 7:23
18/12/2021,Phang-nga,46,7389,268016,133785,134231,174747,140351,34396,,,19/1/2022 7:23
18/12/2021,Phatthalung,65,13383,522541,254425,268116,39244,39244,0,,,19/1/2022 7:23
18/12/2021,Phichit,7,5431,529395,258012,271383,47217,47125,92,,,19/1/2022 7:23
18/12/2021,Phitsanulok,41,9086,847384,414577,432807,202694,202078,616,,,19/1/2022 7:23
18/12/2021,Phuket,50,19042,418785,197874,220911,261943,167948,93995,73,31,19/1/2022 7:23
18/12/2021,Maha Sarakham,7,11309,948310,464976,483334,33099,33059,40,,,19/1/2022 7:23
18/12/2021,Mukdahan,0,2561,351484,175633,175851,96965,96923,42,,,19/1/2022 7:23
18/12/2021,Yala,52,48495,542314,269907,272407,48470,48470,0,55,22,19/1/2022 7:23
18/12/2021,Yasothon,1,6089,533394,265945,267449,38817,38817,0,,,19/1/2022 7:23
18/12/2021,Ranong,1,10035,194573,98136,96437,21868,21760,108,,,19/1/2022 7:23
18/12/2021,Rayong,39,46502,751343,368992,382351,442667,440059,2608,74,29,19/1/2022 7:23
18/12/2021,Ratchaburi,49,44842,868281,421921,446360,187297,186671,626,,,19/1/2022 7:23
18/12/2021,Roi Et,10,14440,1296013,641883,654130,44247,44214,33,,,19/1/2022 7:23
18/12/2021,Lop Buri,37,18759,739473,368733,370740,265330,265144,186,,,19/1/2022 7:23
18/12/2021,Lampang,31,3452,724678,352894,371784,147515,146727,788,81,37,19/1/2022 7:23
18/12/2021,Lamphun,7,4647,401139,192712,208427,95420,94339,1081,,,19/1/2022 7:23
18/12/2021,Si Sa Ket,51,19454,1457556,725426,732130,69970,69958,12,,,19/1/2022 7:23
18/12/2021,Sakon Nakhon,18,7963,1146286,569364,576922,123784,123753,31,,,19/1/2022 7:23
18/12/2021,Songkhla,114,66862,1431536,697256,734280,111186,110907,279,61,32,19/1/2022 7:23
18/12/2021,Satun,20,8636,324835,161640,163195,118953,118571,382,36,27,19/1/2022 7:23
18/12/2021,Samut Prakarn,123,134304,1356449,645884,710565,148306,128665,19641,,,19/1/2022 7:23
18/12/2021,Samut Songkhram,11,12048,190842,91101,99741,186767,186640,127,93,50,19/1/2022 7:23
18/12/2021,Samut Sakhon,32,112147,586789,282683,304106,49065,48960,105,81,56,19/1/2022 7:23
18/12/2021,Saraburi,56,34089,643963,316201,327762,308153,307750,403,92,74,19/1/2022 7:23
18/12/2021,Sa kaeo,17,19784,561992,280673,281319,68672,68321,351,72,35,19/1/2022 7:23
18/12/2021,Sing Buri,3,3571,204526,97144,107382,38697,38585,112,,,19/1/2022 7:23
18/12/2021,Suphan Buri,23,16598,835360,402883,432477,346794,346794,0,,,19/1/2022 7:23
18/12/2021,Surat Thani,85,27984,1072464,527349,545115,132624,124431,8193,71,34,19/1/2022 7:23
18/12/2021,Surin,4,19120,1376230,684354,691876,76048,75971,77,,,19/1/2022 7:23
18/12/2021,Sukhothai,3,6506,585352,283429,301923,77889,76248,1641,,,19/1/2022 7:23
18/12/2021,Nong Khai,4,4491,516843,256268,260575,176894,176022,872,51,40,19/1/2022 7:23
18/12/2021,Nong Bua Lam Phu,4,4702,509001,253757,255244,23866,23805,61,,,19/1/2022 7:23
18/12/2021,Amnat Charoen,3,3104,376350,187122,189228,26300,26300,0,,,19/1/2022 7:23
18/12/2021,Udon Thani,46,25719,1566510,775357,791153,215933,215261,672,,,19/1/2022 7:23
18/12/2021,Uttaradit,1,4612,446148,217413,228735,74305,74146,159,,,19/1/2022 7:23
18/12/2021,Uthai Thani,0,3881,325116,158926,166190,46752,46752,0,,,19/1/2022 7:23
18/12/2021,Ubon Ratchathani,22,22805,1868519,932466,936053,211200,211160,40,69,34,19/1/2022 7:23
18/12/2021,Ang Thong,29,11714,274763,131399,143364,42587,42587,0,,,19/1/2022 7:23
18/12/2021,Chiang Rai,6,5859,1298425,630868,667557,362358,360119,2239,85,40,19/1/2022 7:23
18/12/2021,Chiang Mai,60,33070,1789385,864364,925021,817474,810928,6546,80,39,19/1/2022 7:23
18/12/2021,Phetchaburi,30,24391,482875,232927,249948,596099,595951,148,,,19/1/2022 7:23
18/12/2021,Phetchabun,33,12557,978372,482234,496138,196178,195552,626,,,19/1/2022 7:23
18/12/2021,Loei,7,4550,638732,319949,318783,143151,142378,773,92,46,19/1/2022 7:23
18/12/2021,Phrae,3,2047,434580,209403,225177,91286,90937,349,100,45,19/1/2022 7:23
18/12/2021,Mae Hong Son,21,3101,285916,144811,141105,114751,112339,2412,,,19/1/2022 7:23
18/12/2021,,0,173,,,,,,,,,19/1/2022 7:23
19/12/2021,Krabi,86,11767,479351,238092,241259,81255,79570,1685,,,19/1/2022 7:23
19/12/2021,Bangkok,430,465294,5527994,2592292,2935702,2543615,2383978,159637,87,61,19/1/2022 7:23
19/12/2021,Kanchanaburi,29,24540,894054,448312,445742,908851,907622,1229,79,59,19/1/2022 7:23
19/12/2021,Kalasin,2,10115,975570,481988,493582,44112,43792,320,,,19/1/2022 7:23
19/12/2021,Kamphaeng Phet,6,8411,712143,351539,360604,60392,60106,286,,,19/1/2022 7:23
19/12/2021,Khon Kaen,115,26910,1790863,879849,911014,356626,354735,1891,105,63,19/1/2022 7:23
19/12/2021,Chanthaburi,11,22601,536557,262257,274300,132403,132126,277,,,19/1/2022 7:23
19/12/2021,Chachoengsao,39,38023,724178,354834,369344,350064,349850,214,72,55,19/1/2022 7:23
19/12/2021,Chon Buri,198,113539,1583672,772463,811209,975534,964356,11178,65,90,19/1/2022 7:23
19/12/2021,Chai Nat,3,2903,320432,153962,166470,51161,51147,14,,,19/1/2022 7:23
19/12/2021,Chaiyaphum,6,12277,1122265,554299,567966,99618,99364,254,,,19/1/2022 7:23
19/12/2021,Chumphon,37,16266,509479,251405,258074,70890,70798,92,,,19/1/2022 7:23
19/12/2021,Trang,64,17486,639788,312693,327095,91461,91339,122,,,19/1/2022 7:23
19/12/2021,Trat,4,9235,228376,112941,115435,133130,130498,2632,,,19/1/2022 7:23
19/12/2021,Tak,36,25994,676583,341966,334617,109369,109331,38,,,19/1/2022 7:23
19/12/2021,Nakhon Nayok,33,11767,260433,128854,131579,170360,170245,115,,,19/1/2022 7:23
19/12/2021,Nakhon Pathom,12,36405,922171,442800,479371,216272,216000,272,80,64,19/1/2022 7:23
19/12/2021,Nakhon Phanom,8,5123,717040,357096,359944,101214,101189,25,,,19/1/2022 7:23
19/12/2021,Nakhon Ratchasima,29,35791,2634154,1293783,1340371,571339,566844,4495,81,54,19/1/2022 7:23
19/12/2021,Nakhon Si Thammarat,197,47002,1549344,764471,784873,138859,138776,83,,,19/1/2022 7:23
19/12/2021,Nakhon Sawan,53,17949,1035028,504657,530371,112947,112567,380,90,58,19/1/2022 7:23
19/12/2021,Nonthaburi,32,69216,1288637,599167,689470,160119,158826,1293,70, ,19/1/2022 7:23
19/12/2021,Narathiwat,32,42605,809660,400501,409159,5393,5393,0,63,25,19/1/2022 7:23
19/12/2021,Nan,8,2875,475875,237959,237916,132711,131256,1455,,,19/1/2022 7:23
19/12/2021,Bueng Kan,17,2690,421995,211494,210501,49966,49403,563,,,19/1/2022 7:23
19/12/2021,Buri Ram,5,17624,1579805,783531,796274,127140,126290,850,,,19/1/2022 7:23
19/12/2021,Pathum Thani,48,43039,1190060,563851,626209,105228,104299,929,81,63,19/1/2022 7:23
19/12/2021,Prachuap Khiri Khan,41,20259,553171,274049,279122,595142,593435,1707,,,19/1/2022 7:23
19/12/2021,Prachin Buri,38,26491,495325,244642,250683,101944,101780,164,86,63,19/1/2022 7:23
19/12/2021,Pattani,53,48475,729581,360348,369233,7237,7237,0,,,19/1/2022 7:23
19/12/2021,Phra Nakhon Si Ayutthaya,65,33679,820512,394024,426488,506314,497703,8611,80,80,19/1/2022 7:23
19/12/2021,Phayao,1,2712,464505,225943,238562,78112,77046,1066,102,43,19/1/2022 7:23
19/12/2021,Phang-nga,33,7422,268016,133785,134231,174747,140351,34396,,,19/1/2022 7:23
19/12/2021,Phatthalung,40,13423,522541,254425,268116,39244,39244,0,,,19/1/2022 7:23
19/12/2021,Phichit,3,5434,529395,258012,271383,47217,47125,92,,,19/1/2022 7:23
19/12/2021,Phitsanulok,22,9108,847384,414577,432807,202694,202078,616,,,19/1/2022 7:23
19/12/2021,Phuket,35,19077,418785,197874,220911,261943,167948,93995,54,38,19/1/2022 7:23
19/12/2021,Maha Sarakham,0,11309,948310,464976,483334,33099,33059,40,,,19/1/2022 7:23
19/12/2021,Mukdahan,0,2561,351484,175633,175851,96965,96923,42,,,19/1/2022 7:23
19/12/2021,Yala,34,48529,542314,269907,272407,48470,48470,0,55,26,19/1/2022 7:23
19/12/2021,Yasothon,1,6090,533394,265945,267449,38817,38817,0,,,19/1/2022 7:23
19/12/2021,Ranong,7,10042,194573,98136,96437,21868,21760,108,,,19/1/2022 7:23
19/12/2021,Rayong,46,46548,751343,368992,382351,442667,440059,2608,68,42,19/1/2022 7:23
19/12/2021,Ratchaburi,73,44915,868281,421921,446360,187297,186671,626,,,19/1/2022 7:23
19/12/2021,Roi Et,13,14453,1296013,641883,654130,44247,44214,33,,,19/1/2022 7:23
19/12/2021,Lop Buri,30,18789,739473,368733,370740,265330,265144,186,,,19/1/2022 7:23
19/12/2021,Lampang,15,3467,724678,352894,371784,147515,146727,788,95,37,19/1/2022 7:23
19/12/2021,Lamphun,13,4660,401139,192712,208427,95420,94339,1081,,,19/1/2022 7:23
19/12/2021,Si Sa Ket,42,19496,1457556,725426,732130,69970,69958,12,,,19/1/2022 7:23
19/12/2021,Sakon Nakhon,10,7973,1146286,569364,576922,123784,123753,31,,,19/1/2022 7:23
19/12/2021,Songkhla,97,66959,1431536,697256,734280,111186,110907,279,62,30,19/1/2022 7:23
19/12/2021,Satun,26,8662,324835,161640,163195,118953,118571,382,33,23,19/1/2022 7:23
19/12/2021,Samut Prakarn,136,134440,1356449,645884,710565,148306,128665,19641,,,19/1/2022 7:23
19/12/2021,Samut Songkhram,4,12052,190842,91101,99741,186767,186640,127,86,69,19/1/2022 7:23
19/12/2021,Samut Sakhon,37,112184,586789,282683,304106,49065,48960,105,82,66,19/1/2022 7:23
19/12/2021,Saraburi,62,34151,643963,316201,327762,308153,307750,403,92,112,19/1/2022 7:23
19/12/2021,Sa kaeo,19,19803,561992,280673,281319,68672,68321,351,65,44,19/1/2022 7:23
19/12/2021,Sing Buri,3,3574,204526,97144,107382,38697,38585,112,,,19/1/2022 7:23
19/12/2021,Suphan Buri,33,16631,835360,402883,432477,346794,346794,0,,,19/1/2022 7:23
19/12/2021,Surat Thani,77,28061,1072464,527349,545115,132624,124431,8193,53,27,19/1/2022 7:23
19/12/2021,Surin,5,19125,1376230,684354,691876,76048,75971,77,,,19/1/2022 7:23
19/12/2021,Sukhothai,3,6509,585352,283429,301923,77889,76248,1641,,,19/1/2022 7:23
19/12/2021,Nong Khai,7,4498,516843,256268,260575,176894,176022,872,65,37,19/1/2022 7:23
19/12/2021,Nong Bua Lam Phu,5,4707,509001,253757,255244,23866,23805,61,,,19/1/2022 7:23
19/12/2021,Amnat Charoen,0,3104,376350,187122,189228,26300,26300,0,,,19/1/2022 7:23
19/12/2021,Udon Thani,24,25743,1566510,775357,791153,215933,215261,672,,,19/1/2022 7:23
19/12/2021,Uttaradit,2,4614,446148,217413,228735,74305,74146,159,,,19/1/2022 7:23
19/12/2021,Uthai Thani,3,3884,325116,158926,166190,46752,46752,0,,,19/1/2022 7:23
19/12/2021,Ubon Ratchathani,9,22814,1868519,932466,936053,211200,211160,40,66,44,19/1/2022 7:23
19/12/2021,Ang Thong,25,11739,274763,131399,143364,42587,42587,0,,,19/1/2022 7:23
19/12/2021,Chiang Rai,15,5874,1298425,630868,667557,362358,360119,2239,99,41,19/1/2022 7:23
19/12/2021,Chiang Mai,58,33128,1789385,864364,925021,817474,810928,6546,90,44,19/1/2022 7:23
19/12/2021,Phetchaburi,39,24430,482875,232927,249948,596099,595951,148,,,19/1/2022 7:23
19/12/2021,Phetchabun,13,12570,978372,482234,496138,196178,195552,626,,,19/1/2022 7:23
19/12/2021,Loei,4,4554,638732,319949,318783,143151,142378,773,97,50,19/1/2022 7:23
19/12/2021,Phrae,4,2051,434580,209403,225177,91286,90937,349,106,42,19/1/2022 7:23
19/12/2021,Mae Hong Son,34,3135,285916,144811,141105,114751,112339,2412,,,19/1/2022 7:23
19/12/2021,,0,173,,,,,,,,,19/1/2022 7:23
20/12/2021,Krabi,72,11839,479351,238092,241259,81255,79570,1685,,,19/1/2022 7:23
20/12/2021,Bangkok,420,465714,5527994,2592292,2935702,2543615,2383978,159637,128,75,19/1/2022 7:23
20/12/2021,Kanchanaburi,24,24564,894054,448312,445742,908851,907622,1229,117,65,19/1/2022 7:23
20/12/2021,Kalasin,3,10118,975570,481988,493582,44112,43792,320,,,19/1/2022 7:23
20/12/2021,Kamphaeng Phet,1,8412,712143,351539,360604,60392,60106,286,,,19/1/2022 7:23
20/12/2021,Khon Kaen,34,26944,1790863,879849,911014,356626,354735,1891,129,70,19/1/2022 7:23
20/12/2021,Chanthaburi,23,22624,536557,262257,274300,132403,132126,277,,,19/1/2022 7:23
20/12/2021,Chachoengsao,27,38050,724178,354834,369344,350064,349850,214,108,66,19/1/2022 7:23
20/12/2021,Chon Buri,135,113674,1583672,772463,811209,975534,964356,11178,126,67,19/1/2022 7:23
20/12/2021,Chai Nat,1,2904,320432,153962,166470,51161,51147,14,,,19/1/2022 7:23
20/12/2021,Chaiyaphum,2,12279,1122265,554299,567966,99618,99364,254,,,19/1/2022 7:23
20/12/2021,Chumphon,16,16282,509479,251405,258074,70890,70798,92,,,19/1/2022 7:23
20/12/2021,Trang,58,17544,639788,312693,327095,91461,91339,122,,,19/1/2022 7:23
20/12/2021,Trat,3,9238,228376,112941,115435,133130,130498,2632,,,19/1/2022 7:23
20/12/2021,Tak,25,26019,676583,341966,334617,109369,109331,38,,,19/1/2022 7:23
20/12/2021,Nakhon Nayok,2,11769,260433,128854,131579,170360,170245,115,,,19/1/2022 7:23
20/12/2021,Nakhon Pathom,43,36448,922171,442800,479371,216272,216000,272,125,72,19/1/2022 7:23
20/12/2021,Nakhon Phanom,4,5127,717040,357096,359944,101214,101189,25,,,19/1/2022 7:23
20/12/2021,Nakhon Ratchasima,38,35829,2634154,1293783,1340371,571339,566844,4495,112,67,19/1/2022 7:23
20/12/2021,Nakhon Si Thammarat,175,47177,1549344,764471,784873,138859,138776,83,,,19/1/2022 7:23
20/12/2021,Nakhon Sawan,55,18004,1035028,504657,530371,112947,112567,380,118,60,19/1/2022 7:23
20/12/2021,Nonthaburi,22,69238,1288637,599167,689470,160119,158826,1293,101, ,19/1/2022 7:23
20/12/2021,Narathiwat,36,42641,809660,400501,409159,5393,5393,0,59,30,19/1/2022 7:23
20/12/2021,Nan,12,2887,475875,237959,237916,132711,131256,1455,,,19/1/2022 7:23
20/12/2021,Bueng Kan,12,2702,421995,211494,210501,49966,49403,563,,,19/1/2022 7:23
20/12/2021,Buri Ram,3,17627,1579805,783531,796274,127140,126290,850,,,19/1/2022 7:23
20/12/2021,Pathum Thani,35,43074,1190060,563851,626209,105228,104299,929,119,73,19/1/2022 7:23
20/12/2021,Prachuap Khiri Khan,42,20301,553171,274049,279122,595142,593435,1707,,,19/1/2022 7:23
20/12/2021,Prachin Buri,31,26522,495325,244642,250683,101944,101780,164,121,65,19/1/2022 7:23
20/12/2021,Pattani,37,48512,729581,360348,369233,7237,7237,0,,,19/1/2022 7:23
20/12/2021,Phra Nakhon Si Ayutthaya,49,33728,820512,394024,426488,506314,497703,8611,108,86,19/1/2022 7:23
20/12/2021,Phayao,1,2713,464505,225943,238562,78112,77046,1066,102,45,19/1/2022 7:23
20/12/2021,Phang-nga,22,7444,268016,133785,134231,174747,140351,34396,,,19/1/2022 7:23
20/12/2021,Phatthalung,67,13490,522541,254425,268116,39244,39244,0,,,19/1/2022 7:23
20/12/2021,Phichit,0,5434,529395,258012,271383,47217,47125,92,,,19/1/2022 7:23
20/12/2021,Phitsanulok,38,9146,847384,414577,432807,202694,202078,616,,,19/1/2022 7:23
20/12/2021,Phuket,51,19128,418785,197874,220911,261943,167948,93995,66,34,19/1/2022 7:23
20/12/2021,Maha Sarakham,2,11311,948310,464976,483334,33099,33059,40,,,19/1/2022 7:23
20/12/2021,Mukdahan,1,2562,351484,175633,175851,96965,96923,42,,,19/1/2022 7:23
20/12/2021,Yala,19,48548,542314,269907,272407,48470,48470,0,49,31,19/1/2022 7:23
20/12/2021,Yasothon,7,6097,533394,265945,267449,38817,38817,0,,,19/1/2022 7:23
20/12/2021,Ranong,1,10043,194573,98136,96437,21868,21760,108,,,19/1/2022 7:23
20/12/2021,Rayong,53,46601,751343,368992,382351,442667,440059,2608,90,63,19/1/2022 7:23
20/12/2021,Ratchaburi,45,44960,868281,421921,446360,187297,186671,626,,,19/1/2022 7:23
20/12/2021,Roi Et,6,14459,1296013,641883,654130,44247,44214,33,,,19/1/2022 7:23
20/12/2021,Lop Buri,37,18826,739473,368733,370740,265330,265144,186,,,19/1/2022 7:23
20/12/2021,Lampang,12,3479,724678,352894,371784,147515,146727,788,103,38,19/1/2022 7:23
20/12/2021,Lamphun,2,4662,401139,192712,208427,95420,94339,1081,,,19/1/2022 7:23
20/12/2021,Si Sa Ket,23,19519,1457556,725426,732130,69970,69958,12,,,19/1/2022 7:23
20/12/2021,Sakon Nakhon,10,7983,1146286,569364,576922,123784,123753,31,,,19/1/2022 7:23
20/12/2021,Songkhla,88,67047,1431536,697256,734280,111186,110907,279,56,30,19/1/2022 7:23
20/12/2021,Satun,26,8688,324835,161640,163195,118953,118571,382,32,21,19/1/2022 7:23
20/12/2021,Samut Prakarn,146,134586,1356449,645884,710565,148306,128665,19641,,,19/1/2022 7:23
20/12/2021,Samut Songkhram,1,12053,190842,91101,99741,186767,186640,127,133,66,19/1/2022 7:23
20/12/2021,Samut Sakhon,35,112219,586789,282683,304106,49065,48960,105,115,72,19/1/2022 7:23
20/12/2021,Saraburi,47,34198,643963,316201,327762,308153,307750,403,140,125,19/1/2022 7:23
20/12/2021,Sa kaeo,5,19808,561992,280673,281319,68672,68321,351,92,61,19/1/2022 7:23
20/12/2021,Sing Buri,2,3576,204526,97144,107382,38697,38585,112,,,19/1/2022 7:23
20/12/2021,Suphan Buri,10,16641,835360,402883,432477,346794,346794,0,,,19/1/2022 7:23
20/12/2021,Surat Thani,75,28136,1072464,527349,545115,132624,124431,8193,56,32,19/1/2022 7:23
20/12/2021,Surin,7,19132,1376230,684354,691876,76048,75971,77,,,19/1/2022 7:23
20/12/2021,Sukhothai,6,6515,585352,283429,301923,77889,76248,1641,,,19/1/2022 7:23
20/12/2021,Nong Khai,3,4501,516843,256268,260575,176894,176022,872,59,17,19/1/2022 7:23
20/12/2021,Nong Bua Lam Phu,1,4708,509001,253757,255244,23866,23805,61,,,19/1/2022 7:23
20/12/2021,Amnat Charoen,0,3104,376350,187122,189228,26300,26300,0,,,19/1/2022 7:23
20/12/2021,Udon Thani,16,25759,1566510,775357,791153,215933,215261,672,,,19/1/2022 7:23
20/12/2021,Uttaradit,4,4618,446148,217413,228735,74305,74146,159,,,19/1/2022 7:23
20/12/2021,Uthai Thani,0,3884,325116,158926,166190,46752,46752,0,,,19/1/2022 7:23
20/12/2021,Ubon Ratchathani,26,22840,1868519,932466,936053,211200,211160,40,86,57,19/1/2022 7:23
20/12/2021,Ang Thong,25,11764,274763,131399,143364,42587,42587,0,,,19/1/2022 7:23
20/12/2021,Chiang Rai,17,5891,1298425,630868,667557,362358,360119,2239,100,44,19/1/2022 7:23
20/12/2021,Chiang Mai,78,33206,1789385,864364,925021,817474,810928,6546,94,48,19/1/2022 7:23
20/12/2021,Phetchaburi,13,24443,482875,232927,249948,596099,595951,148,,,19/1/2022 7:23
20/12/2021,Phetchabun,30,12600,978372,482234,496138,196178,195552,626,,,19/1/2022 7:23
20/12/2021,Loei,1,4555,638732,319949,318783,143151,142378,773,98,50,19/1/2022 7:23
20/12/2021,Phrae,4,2055,434580,209403,225177,91286,90937,349,107,41,19/1/2022 7:23
20/12/2021,Mae Hong Son,22,3157,285916,144811,141105,114751,112339,2412,,,19/1/2022 7:23
20/12/2021,,0,173,,,,,,,,,19/1/2022 7:23
21/12/2021,Krabi,61,11900,479351,238092,241259,81255,79570,1685,,,19/1/2022 7:23
21/12/2021,Bangkok,578,466292,5527994,2592292,2935702,2543615,2383978,159637,159,79,19/1/2022 7:23
21/12/2021,Kanchanaburi,27,24591,894054,448312,445742,908851,907622,1229,126,64,19/1/2022 7:23
21/12/2021,Kalasin,6,10124,975570,481988,493582,44112,43792,320,,,19/1/2022 7:23
21/12/2021,Kamphaeng Phet,1,8413,712143,351539,360604,60392,60106,286,,,19/1/2022 7:23
21/12/2021,Khon Kaen,49,26993,1790863,879849,911014,356626,354735,1891,141,67,19/1/2022 7:23
21/12/2021,Chanthaburi,13,22637,536557,262257,274300,132403,132126,277,,,19/1/2022 7:23
21/12/2021,Chachoengsao,39,38089,724178,354834,369344,350064,349850,214,132,69,19/1/2022 7:23
21/12/2021,Chon Buri,176,113850,1583672,772463,811209,975534,964356,11178,127,86,19/1/2022 7:23
21/12/2021,Chai Nat,11,2915,320432,153962,166470,51161,51147,14,,,19/1/2022 7:23
21/12/2021,Chaiyaphum,2,12281,1122265,554299,567966,99618,99364,254,,,19/1/2022 7:23
21/12/2021,Chumphon,16,16298,509479,251405,258074,70890,70798,92,,,19/1/2022 7:23
21/12/2021,Trang,63,17607,639788,312693,327095,91461,91339,122,,,19/1/2022 7:23
21/12/2021,Trat,4,9242,228376,112941,115435,133130,130498,2632,,,19/1/2022 7:23
21/12/2021,Tak,32,26051,676583,341966,334617,109369,109331,38,,,19/1/2022 7:23
21/12/2021,Nakhon Nayok,12,11781,260433,128854,131579,170360,170245,115,,,19/1/2022 7:23
21/12/2021,Nakhon Pathom,22,36470,922171,442800,479371,216272,216000,272,134,71,19/1/2022 7:23
21/12/2021,Nakhon Phanom,4,5131,717040,357096,359944,101214,101189,25,,,19/1/2022 7:23
21/12/2021,Nakhon Ratchasima,36,35865,2634154,1293783,1340371,571339,566844,4495,138,61,19/1/2022 7:23
21/12/2021,Nakhon Si Thammarat,114,47291,1549344,764471,784873,138859,138776,83,,,19/1/2022 7:23
21/12/2021,Nakhon Sawan,53,18057,1035028,504657,530371,112947,112567,380,118,61,19/1/2022 7:23
21/12/2021,Nonthaburi,24,69262,1288637,599167,689470,160119,158826,1293,138, ,19/1/2022 7:23
21/12/2021,Narathiwat,28,42669,809660,400501,409159,5393,5393,0,69,19,19/1/2022 7:23
21/12/2021,Nan,12,2899,475875,237959,237916,132711,131256,1455,,,19/1/2022 7:23
21/12/2021,Bueng Kan,5,2707,421995,211494,210501,49966,49403,563,,,19/1/2022 7:23
21/12/2021,Buri Ram,4,17631,1579805,783531,796274,127140,126290,850,,,19/1/2022 7:23
21/12/2021,Pathum Thani,22,43096,1190060,563851,626209,105228,104299,929,148,73,19/1/2022 7:23
21/12/2021,Prachuap Khiri Khan,27,20328,553171,274049,279122,595142,593435,1707,,,19/1/2022 7:23
21/12/2021,Prachin Buri,14,26536,495325,244642,250683,101944,101780,164,133,80,19/1/2022 7:23
21/12/2021,Pattani,32,48544,729581,360348,369233,7237,7237,0,,,19/1/2022 7:23
21/12/2021,Phra Nakhon Si Ayutthaya,43,33771,820512,394024,426488,506314,497703,8611,124,100,19/1/2022 7:23
21/12/2021,Phayao,3,2716,464505,225943,238562,78112,77046,1066,106,51,19/1/2022 7:23
21/12/2021,Phang-nga,22,7466,268016,133785,134231,174747,140351,34396,,,19/1/2022 7:23
21/12/2021,Phatthalung,28,13518,522541,254425,268116,39244,39244,0,,,19/1/2022 7:23
21/12/2021,Phichit,4,5438,529395,258012,271383,47217,47125,92,,,19/1/2022 7:23
21/12/2021,Phitsanulok,53,9199,847384,414577,432807,202694,202078,616,,,19/1/2022 7:23
21/12/2021,Phuket,49,19177,418785,197874,220911,261943,167948,93995,79,51,19/1/2022 7:23
21/12/2021,Maha Sarakham,1,11312,948310,464976,483334,33099,33059,40,,,19/1/2022 7:23
21/12/2021,Mukdahan,1,2563,351484,175633,175851,96965,96923,42,,,19/1/2022 7:23
21/12/2021,Yala,26,48574,542314,269907,272407,48470,48470,0,59,24,19/1/2022 7:23
21/12/2021,Yasothon,4,6101,533394,265945,267449,38817,38817,0,,,19/1/2022 7:23
21/12/2021,Ranong,0,10043,194573,98136,96437,21868,21760,108,,,19/1/2022 7:23
21/12/2021,Rayong,38,46639,751343,368992,382351,442667,440059,2608,136,60,19/1/2022 7:23
21/12/2021,Ratchaburi,66,45026,868281,421921,446360,187297,186671,626,,,19/1/2022 7:23
21/12/2021,Roi Et,5,14464,1296013,641883,654130,44247,44214,33,,,19/1/2022 7:23
21/12/2021,Lop Buri,46,18872,739473,368733,370740,265330,265144,186,,,19/1/2022 7:23
21/12/2021,Lampang,5,3484,724678,352894,371784,147515,146727,788,100,91,19/1/2022 7:23
21/12/2021,Lamphun,10,4672,401139,192712,208427,95420,94339,1081,,,19/1/2022 7:23
21/12/2021,Si Sa Ket,24,19543,1457556,725426,732130,69970,69958,12,,,19/1/2022 7:23
21/12/2021,Sakon Nakhon,2,7985,1146286,569364,576922,123784,123753,31,,,19/1/2022 7:23
21/12/2021,Songkhla,85,67132,1431536,697256,734280,111186,110907,279,62,27,19/1/2022 7:23
21/12/2021,Satun,24,8712,324835,161640,163195,118953,118571,382,29,22,19/1/2022 7:23
21/12/2021,Samut Prakarn,104,134690,1356449,645884,710565,148306,128665,19641,,,19/1/2022 7:23
21/12/2021,Samut Songkhram,3,12056,190842,91101,99741,186767,186640,127,136,65,19/1/2022 7:23
21/12/2021,Samut Sakhon,17,112236,586789,282683,304106,49065,48960,105,137,77,19/1/2022 7:23
21/12/2021,Saraburi,44,34242,643963,316201,327762,308153,307750,403,154,132,19/1/2022 7:23
21/12/2021,Sa kaeo,4,19812,561992,280673,281319,68672,68321,351,126,57,19/1/2022 7:23
21/12/2021,Sing Buri,1,3577,204526,97144,107382,38697,38585,112,,,19/1/2022 7:23
21/12/2021,Suphan Buri,14,16655,835360,402883,432477,346794,346794,0,,,19/1/2022 7:23
21/12/2021,Surat Thani,66,28202,1072464,527349,545115,132624,124431,8193,99,45,19/1/2022 7:23
21/12/2021,Surin,6,19138,1376230,684354,691876,76048,75971,77,,,19/1/2022 7:23
21/12/2021,Sukhothai,6,6521,585352,283429,301923,77889,76248,1641,,,19/1/2022 7:23
21/12/2021,Nong Khai,4,4505,516843,256268,260575,176894,176022,872,44,18,19/1/2022 7:23
21/12/2021,Nong Bua Lam Phu,1,4709,509001,253757,255244,23866,23805,61,,,19/1/2022 7:23
21/12/2021,Amnat Charoen,1,3105,376350,187122,189228,26300,26300,0,,,19/1/2022 7:23
21/12/2021,Udon Thani,14,25773,1566510,775357,791153,215933,215261,672,,,19/1/2022 7:23
21/12/2021,Uttaradit,2,4620,446148,217413,228735,74305,74146,159,,,19/1/2022 7:23
21/12/2021,Uthai Thani,1,3885,325116,158926,166190,46752,46752,0,,,19/1/2022 7:23
21/12/2021,Ubon Ratchathani,38,22878,1868519,932466,936053,211200,211160,40,116,38,19/1/2022 7:23
21/12/2021,Ang Thong,6,11770,274763,131399,143364,42587,42587,0,,,19/1/2022 7:23
21/12/2021,Chiang Rai,9,5900,1298425,630868,667557,362358,360119,2239,105,42,19/1/2022 7:23
21/12/2021,Chiang Mai,65,33271,1789385,864364,925021,817474,810928,6546,101,47,19/1/2022 7:23
21/12/2021,Phetchaburi,7,24450,482875,232927,249948,596099,595951,148,,,19/1/2022 7:23
21/12/2021,Phetchabun,5,12605,978372,482234,496138,196178,195552,626,,,19/1/2022 7:23
21/12/2021,Loei,8,4563,638732,319949,318783,143151,142378,773,103,49,19/1/2022 7:23
21/12/2021,Phrae,2,2057,434580,209403,225177,91286,90937,349,103,42,19/1/2022 7:23
21/12/2021,Mae Hong Son,22,3179,285916,144811,141105,114751,112339,2412,,,19/1/2022 7:23
21/12/2021,,0,173,,,,,,,,,19/1/2022 7:23
22/12/2021,Krabi,58,11958,479351,238092,241259,81255,79570,1685,,,19/1/2022 7:23
22/12/2021,Bangkok,444,466736,5527994,2592292,2935702,2543615,2383978,159637,166,74,19/1/2022 7:23
22/12/2021,Kanchanaburi,25,24616,894054,448312,445742,908851,907622,1229,117,65,19/1/2022 7:23
22/12/2021,Kalasin,8,10132,975570,481988,493582,44112,43792,320,,,19/1/2022 7:23
22/12/2021,Kamphaeng Phet,2,8415,712143,351539,360604,60392,60106,286,,,19/1/2022 7:23
22/12/2021,Khon Kaen,71,27064,1790863,879849,911014,356626,354735,1891,134,59,19/1/2022 7:23
22/12/2021,Chanthaburi,21,22658,536557,262257,274300,132403,132126,277,,,19/1/2022 7:23
22/12/2021,Chachoengsao,55,38144,724178,354834,369344,350064,349850,214,130,58,19/1/2022 7:23
22/12/2021,Chon Buri,153,114003,1583672,772463,811209,975534,964356,11178,155,82,19/1/2022 7:23
22/12/2021,Chai Nat,16,2931,320432,153962,166470,51161,51147,14,,,19/1/2022 7:23
22/12/2021,Chaiyaphum,0,12281,1122265,554299,567966,99618,99364,254,,,19/1/2022 7:23
22/12/2021,Chumphon,40,16338,509479,251405,258074,70890,70798,92,,,19/1/2022 7:23
22/12/2021,Trang,54,17661,639788,312693,327095,91461,91339,122,,,19/1/2022 7:23
22/12/2021,Trat,13,9255,228376,112941,115435,133130,130498,2632,,,19/1/2022 7:23
22/12/2021,Tak,70,26121,676583,341966,334617,109369,109331,38,,,19/1/2022 7:23
22/12/2021,Nakhon Nayok,15,11796,260433,128854,131579,170360,170245,115,,,19/1/2022 7:23
22/12/2021,Nakhon Pathom,5,36475,922171,442800,479371,216272,216000,272,135,75,19/1/2022 7:23
22/12/2021,Nakhon Phanom,1,5132,717040,357096,359944,101214,101189,25,,,19/1/2022 7:23
22/12/2021,Nakhon Ratchasima,46,35911,2634154,1293783,1340371,571339,566844,4495,129,57,19/1/2022 7:23
22/12/2021,Nakhon Si Thammarat,71,47362,1549344,764471,784873,138859,138776,83,,,19/1/2022 7:23
22/12/2021,Nakhon Sawan,68,18125,1035028,504657,530371,112947,112567,380,117,64,19/1/2022 7:23
22/12/2021,Nonthaburi,40,69302,1288637,599167,689470,160119,158826,1293,136, ,19/1/2022 7:23
22/12/2021,Narathiwat,22,42691,809660,400501,409159,5393,5393,0,55,19,19/1/2022 7:23
22/12/2021,Nan,2,2901,475875,237959,237916,132711,131256,1455,,,19/1/2022 7:23
22/12/2021,Bueng Kan,5,2712,421995,211494,210501,49966,49403,563,,,19/1/2022 7:23
22/12/2021,Buri Ram,6,17637,1579805,783531,796274,127140,126290,850,,,19/1/2022 7:23
22/12/2021,Pathum Thani,40,43136,1190060,563851,626209,105228,104299,929,148,70,19/1/2022 7:23
22/12/2021,Prachuap Khiri Khan,56,20384,553171,274049,279122,595142,593435,1707,,,19/1/2022 7:23
22/12/2021,Prachin Buri,42,26578,495325,244642,250683,101944,101780,164,141,61,19/1/2022 7:23
22/12/2021,Pattani,68,48612,729581,360348,369233,7237,7237,0,,,19/1/2022 7:23
22/12/2021,Phra Nakhon Si Ayutthaya,15,33786,820512,394024,426488,506314,497703,8611,138,94,19/1/2022 7:23
22/12/2021,Phayao,2,2718,464505,225943,238562,78112,77046,1066,117,49,19/1/2022 7:23
22/12/2021,Phang-nga,38,7504,268016,133785,134231,174747,140351,34396,,,19/1/2022 7:23
22/12/2021,Phatthalung,28,13546,522541,254425,268116,39244,39244,0,,,19/1/2022 7:23
22/12/2021,Phichit,3,5441,529395,258012,271383,47217,47125,92,,,19/1/2022 7:23
22/12/2021,Phitsanulok,52,9251,847384,414577,432807,202694,202078,616,,,19/1/2022 7:23
22/12/2021,Phuket,35,19212,418785,197874,220911,261943,167948,93995,101,45,19/1/2022 7:23
22/12/2021,Maha Sarakham,18,11330,948310,464976,483334,33099,33059,40,,,19/1/2022 7:23
22/12/2021,Mukdahan,1,2564,351484,175633,175851,96965,96923,42,,,19/1/2022 7:23
22/12/2021,Yala,28,48602,542314,269907,272407,48470,48470,0,59,28,19/1/2022 7:23
22/12/2021,Yasothon,5,6106,533394,265945,267449,38817,38817,0,,,19/1/2022 7:23
22/12/2021,Ranong,4,10047,194573,98136,96437,21868,21760,108,,,19/1/2022 7:23
22/12/2021,Rayong,26,46665,751343,368992,382351,442667,440059,2608,140,57,19/1/2022 7:23
22/12/2021,Ratchaburi,74,45100,868281,421921,446360,187297,186671,626,,,19/1/2022 7:23
22/12/2021,Roi Et,7,14471,1296013,641883,654130,44247,44214,33,,,19/1/2022 7:23
22/12/2021,Lop Buri,1,18873,739473,368733,370740,265330,265144,186,,,19/1/2022 7:23
22/12/2021,Lampang,14,3498,724678,352894,371784,147515,146727,788,108,39,19/1/2022 7:23
22/12/2021,Lamphun,10,4682,401139,192712,208427,95420,94339,1081,,,19/1/2022 7:23
22/12/2021,Si Sa Ket,36,19579,1457556,725426,732130,69970,69958,12,,,19/1/2022 7:23
22/12/2021,Sakon Nakhon,5,7990,1146286,569364,576922,123784,123753,31,,,19/1/2022 7:23
22/12/2021,Songkhla,57,67189,1431536,697256,734280,111186,110907,279,55,33,19/1/2022 7:23
22/12/2021,Satun,23,8735,324835,161640,163195,118953,118571,382,34,26,19/1/2022 7:23
22/12/2021,Samut Prakarn,132,134822,1356449,645884,710565,148306,128665,19641,,,19/1/2022 7:23
22/12/2021,Samut Songkhram,4,12060,190842,91101,99741,186767,186640,127,131,56,19/1/2022 7:23
22/12/2021,Samut Sakhon,21,112257,586789,282683,304106,49065,48960,105,147,82,19/1/2022 7:23
22/12/2021,Saraburi,54,34296,643963,316201,327762,308153,307750,403,156,133,19/1/2022 7:23
22/12/2021,Sa kaeo,35,19847,561992,280673,281319,68672,68321,351,116,53,19/1/2022 7:23
22/12/2021,Sing Buri,2,3579,204526,97144,107382,38697,38585,112,,,19/1/2022 7:23
22/12/2021,Suphan Buri,15,16670,835360,402883,432477,346794,346794,0,,,19/1/2022 7:23
22/12/2021,Surat Thani,51,28253,1072464,527349,545115,132624,124431,8193,89,39,19/1/2022 7:23
22/12/2021,Surin,6,19144,1376230,684354,691876,76048,75971,77,,,19/1/2022 7:23
22/12/2021,Sukhothai,1,6522,585352,283429,301923,77889,76248,1641,,,19/1/2022 7:23
22/12/2021,Nong Khai,3,4508,516843,256268,260575,176894,176022,872,47,22,19/1/2022 7:23
22/12/2021,Nong Bua Lam Phu,0,4709,509001,253757,255244,23866,23805,61,,,19/1/2022 7:23
22/12/2021,Amnat Charoen,1,3106,376350,187122,189228,26300,26300,0,,,19/1/2022 7:23
22/12/2021,Udon Thani,18,25791,1566510,775357,791153,215933,215261,672,,,19/1/2022 7:23
22/12/2021,Uttaradit,1,4621,446148,217413,228735,74305,74146,159,,,19/1/2022 7:23
22/12/2021,Uthai Thani,7,3892,325116,158926,166190,46752,46752,0,,,19/1/2022 7:23
22/12/2021,Ubon Ratchathani,6,22884,1868519,932466,936053,211200,211160,40,74,33,19/1/2022 7:23
22/12/2021,Ang Thong,3,11773,274763,131399,143364,42587,42587,0,,,19/1/2022 7:23
22/12/2021,Chiang Rai,26,5926,1298425,630868,667557,362358,360119,2239,99,41,19/1/2022 7:23
22/12/2021,Chiang Mai,56,33327,1789385,864364,925021,817474,810928,6546,95,47,19/1/2022 7:23
22/12/2021,Phetchaburi,15,24465,482875,232927,249948,596099,595951,148,,,19/1/2022 7:23
22/12/2021,Phetchabun,12,12617,978372,482234,496138,196178,195552,626,,,19/1/2022 7:23
22/12/2021,Loei,4,4567,638732,319949,318783,143151,142378,773,101,48,19/1/2022 7:23
22/12/2021,Phrae,2,2059,434580,209403,225177,91286,90937,349,99,44,19/1/2022 7:23
22/12/2021,Mae Hong Son,58,3237,285916,144811,141105,114751,112339,2412,,,19/1/2022 7:23
22/12/2021,,0,173,,,,,,,,,19/1/2022 7:23
23/12/2021,Krabi,49,12007,479351,238092,241259,81255,79570,1685,,,19/1/2022 7:23
23/12/2021,Bangkok,472,467208,5527994,2592292,2935702,2543615,2383978,159637,146,65,19/1/2022 7:23
23/12/2021,Kanchanaburi,26,24642,894054,448312,445742,908851,907622,1229,114,63,19/1/2022 7:23
23/12/2021,Kalasin,6,10138,975570,481988,493582,44112,43792,320,,,19/1/2022 7:23
23/12/2021,Kamphaeng Phet,4,8419,712143,351539,360604,60392,60106,286,,,19/1/2022 7:23
23/12/2021,Khon Kaen,48,27112,1790863,879849,911014,356626,354735,1891,114,64,19/1/2022 7:23
23/12/2021,Chanthaburi,11,22669,536557,262257,274300,132403,132126,277,,,19/1/2022 7:23
23/12/2021,Chachoengsao,32,38176,724178,354834,369344,350064,349850,214,119,49,19/1/2022 7:23
23/12/2021,Chon Buri,184,114187,1583672,772463,811209,975534,964356,11178,150,64,19/1/2022 7:23
23/12/2021,Chai Nat,10,2941,320432,153962,166470,51161,51147,14,,,19/1/2022 7:23
23/12/2021,Chaiyaphum,1,12282,1122265,554299,567966,99618,99364,254,,,19/1/2022 7:23
23/12/2021,Chumphon,20,16358,509479,251405,258074,70890,70798,92,,,19/1/2022 7:23
23/12/2021,Trang,51,17712,639788,312693,327095,91461,91339,122,,,19/1/2022 7:23
23/12/2021,Trat,8,9263,228376,112941,115435,133130,130498,2632,,,19/1/2022 7:23
23/12/2021,Tak,42,26163,676583,341966,334617,109369,109331,38,,,19/1/2022 7:23
23/12/2021,Nakhon Nayok,2,11798,260433,128854,131579,170360,170245,115,,,19/1/2022 7:23
23/12/2021,Nakhon Pathom,41,36516,922171,442800,479371,216272,216000,272,142,69,19/1/2022 7:23
23/12/2021,Nakhon Phanom,3,5135,717040,357096,359944,101214,101189,25,,,19/1/2022 7:23
23/12/2021,Nakhon Ratchasima,38,35949,2634154,1293783,1340371,571339,566844,4495,118,45,19/1/2022 7:23
23/12/2021,Nakhon Si Thammarat,227,47589,1549344,764471,784873,138859,138776,83,,,19/1/2022 7:23
23/12/2021,Nakhon Sawan,49,18174,1035028,504657,530371,112947,112567,380,128,72,19/1/2022 7:23
23/12/2021,Nonthaburi,51,69353,1288637,599167,689470,160119,158826,1293,119, ,19/1/2022 7:23
23/12/2021,Narathiwat,22,42713,809660,400501,409159,5393,5393,0,56,20,19/1/2022 7:23
23/12/2021,Nan,2,2903,475875,237959,237916,132711,131256,1455,,,19/1/2022 7:23
23/12/2021,Bueng Kan,95,2807,421995,211494,210501,49966,49403,563,,,19/1/2022 7:23
23/12/2021,Buri Ram,9,17646,1579805,783531,796274,127140,126290,850,,,19/1/2022 7:23
23/12/2021,Pathum Thani,39,43175,1190060,563851,626209,105228,104299,929,133,61,19/1/2022 7:23
23/12/2021,Prachuap Khiri Khan,29,20413,553171,274049,279122,595142,593435,1707,,,19/1/2022 7:23
23/12/2021,Prachin Buri,61,26639,495325,244642,250683,101944,101780,164,113,51,19/1/2022 7:23
23/12/2021,Pattani,65,48677,729581,360348,369233,7237,7237,0,,,19/1/2022 7:23
23/12/2021,Phra Nakhon Si Ayutthaya,32,33818,820512,394024,426488,506314,497703,8611,132,86,19/1/2022 7:23
23/12/2021,Phayao,0,2718,464505,225943,238562,78112,77046,1066,102,49,19/1/2022 7:23
23/12/2021,Phang-nga,37,7541,268016,133785,134231,174747,140351,34396,,,19/1/2022 7:23
23/12/2021,Phatthalung,62,13608,522541,254425,268116,39244,39244,0,,,19/1/2022 7:23
23/12/2021,Phichit,0,5441,529395,258012,271383,47217,47125,92,,,19/1/2022 7:23
23/12/2021,Phitsanulok,58,9309,847384,414577,432807,202694,202078,616,,,19/1/2022 7:23
23/12/2021,Phuket,38,19250,418785,197874,220911,261943,167948,93995,83,38,19/1/2022 7:23
23/12/2021,Maha Sarakham,5,11335,948310,464976,483334,33099,33059,40,,,19/1/2022 7:23
23/12/2021,Mukdahan,0,2564,351484,175633,175851,96965,96923,42,,,19/1/2022 7:23
23/12/2021,Yala,39,48641,542314,269907,272407,48470,48470,0,65,25,19/1/2022 7:23
23/12/2021,Yasothon,2,6108,533394,265945,267449,38817,38817,0,,,19/1/2022 7:23
23/12/2021,Ranong,1,10048,194573,98136,96437,21868,21760,108,,,19/1/2022 7:23
23/12/2021,Rayong,62,46727,751343,368992,382351,442667,440059,2608,141,35,19/1/2022 7:23
23/12/2021,Ratchaburi,27,45127,868281,421921,446360,187297,186671,626,,,19/1/2022 7:23
23/12/2021,Roi Et,14,14485,1296013,641883,654130,44247,44214,33,,,19/1/2022 7:23
23/12/2021,Lop Buri,20,18893,739473,368733,370740,265330,265144,186,,,19/1/2022 7:23
23/12/2021,Lampang,16,3514,724678,352894,371784,147515,146727,788,87,42,19/1/2022 7:23
23/12/2021,Lamphun,7,4689,401139,192712,208427,95420,94339,1081,,,19/1/2022 7:23
23/12/2021,Si Sa Ket,84,19663,1457556,725426,732130,69970,69958,12,,,19/1/2022 7:23
23/12/2021,Sakon Nakhon,4,7994,1146286,569364,576922,123784,123753,31,,,19/1/2022 7:23
23/12/2021,Songkhla,92,67281,1431536,697256,734280,111186,110907,279,66,28,19/1/2022 7:23
23/12/2021,Satun,22,8757,324835,161640,163195,118953,118571,382,37,28,19/1/2022 7:23
23/12/2021,Samut Prakarn,173,134995,1356449,645884,710565,148306,128665,19641,,,19/1/2022 7:23
23/12/2021,Samut Songkhram,5,12065,190842,91101,99741,186767,186640,127,116,51,19/1/2022 7:23
23/12/2021,Samut Sakhon,14,112271,586789,282683,304106,49065,48960,105,155,80,19/1/2022 7:23
23/12/2021,Saraburi,55,34351,643963,316201,327762,308153,307750,403,141,144,19/1/2022 7:23
23/12/2021,Sa kaeo,12,19859,561992,280673,281319,68672,68321,351,99,36,19/1/2022 7:23
23/12/2021,Sing Buri,2,3581,204526,97144,107382,38697,38585,112,,,19/1/2022 7:23
23/12/2021,Suphan Buri,29,16699,835360,402883,432477,346794,346794,0,,,19/1/2022 7:23
23/12/2021,Surat Thani,67,28320,1072464,527349,545115,132624,124431,8193,93,43,19/1/2022 7:23
23/12/2021,Surin,10,19154,1376230,684354,691876,76048,75971,77,,,19/1/2022 7:23
23/12/2021,Sukhothai,2,6524,585352,283429,301923,77889,76248,1641,,,19/1/2022 7:23
23/12/2021,Nong Khai,2,4510,516843,256268,260575,176894,176022,872,40,41,19/1/2022 7:23
23/12/2021,Nong Bua Lam Phu,1,4710,509001,253757,255244,23866,23805,61,,,19/1/2022 7:23
23/12/2021,Amnat Charoen,2,3108,376350,187122,189228,26300,26300,0,,,19/1/2022 7:23
23/12/2021,Udon Thani,43,25834,1566510,775357,791153,215933,215261,672,,,19/1/2022 7:23
23/12/2021,Uttaradit,1,4622,446148,217413,228735,74305,74146,159,,,19/1/2022 7:23
23/12/2021,Uthai Thani,5,3897,325116,158926,166190,46752,46752,0,,,19/1/2022 7:23
23/12/2021,Ubon Ratchathani,18,22902,1868519,932466,936053,211200,211160,40,63,44,19/1/2022 7:23
23/12/2021,Ang Thong,12,11785,274763,131399,143364,42587,42587,0,,,19/1/2022 7:23
23/12/2021,Chiang Rai,9,5935,1298425,630868,667557,362358,360119,2239,99,43,19/1/2022 7:23
23/12/2021,Chiang Mai,69,33396,1789385,864364,925021,817474,810928,6546,97,49,19/1/2022 7:23
23/12/2021,Phetchaburi,18,24483,482875,232927,249948,596099,595951,148,,,19/1/2022 7:23
23/12/2021,Phetchabun,34,12651,978372,482234,496138,196178,195552,626,,,19/1/2022 7:23
23/12/2021,Loei,5,4572,638732,319949,318783,143151,142378,773,98,53,19/1/2022 7:23
23/12/2021,Phrae,2,2061,434580,209403,225177,91286,90937,349,103,48,19/1/2022 7:23
23/12/2021,Mae Hong Son,31,3268,285916,144811,141105,114751,112339,2412,,,19/1/2022 7:23
23/12/2021,,0,173,,,,,,,,,19/1/2022 7:23
24/12/2021,Krabi,44,12051,479351,238092,241259,81255,79570,1685,,,19/1/2022 7:23
24/12/2021,Bangkok,447,467655,5527994,2592292,2935702,2543615,2383978,159637,131,39,19/1/2022 7:23
24/12/2021,Kanchanaburi,19,24661,894054,448312,445742,908851,907622,1229,132,61,19/1/2022 7:23
24/12/2021,Kalasin,29,10167,975570,481988,493582,44112,43792,320,,,19/1/2022 7:23
24/12/2021,Kamphaeng Phet,1,8420,712143,351539,360604,60392,60106,286,,,19/1/2022 7:23
24/12/2021,Khon Kaen,73,27185,1790863,879849,911014,356626,354735,1891,132,54,19/1/2022 7:23
24/12/2021,Chanthaburi,14,22683,536557,262257,274300,132403,132126,277,,,19/1/2022 7:23
24/12/2021,Chachoengsao,39,38215,724178,354834,369344,350064,349850,214,87,39,19/1/2022 7:23
24/12/2021,Chon Buri,181,114368,1583672,772463,811209,975534,964356,11178,122,46,19/1/2022 7:23
24/12/2021,Chai Nat,6,2947,320432,153962,166470,51161,51147,14,,,19/1/2022 7:23
24/12/2021,Chaiyaphum,0,12282,1122265,554299,567966,99618,99364,254,,,19/1/2022 7:23
24/12/2021,Chumphon,58,16416,509479,251405,258074,70890,70798,92,,,19/1/2022 7:23
24/12/2021,Trang,53,17765,639788,312693,327095,91461,91339,122,,,19/1/2022 7:23
24/12/2021,Trat,51,9314,228376,112941,115435,133130,130498,2632,,,19/1/2022 7:23
24/12/2021,Tak,44,26207,676583,341966,334617,109369,109331,38,,,19/1/2022 7:23
24/12/2021,Nakhon Nayok,9,11807,260433,128854,131579,170360,170245,115,,,19/1/2022 7:23
24/12/2021,Nakhon Pathom,19,36535,922171,442800,479371,216272,216000,272,140,42,19/1/2022 7:23
24/12/2021,Nakhon Phanom,7,5142,717040,357096,359944,101214,101189,25,,,19/1/2022 7:23
24/12/2021,Nakhon Ratchasima,38,35987,2634154,1293783,1340371,571339,566844,4495,96,37,19/1/2022 7:23
24/12/2021,Nakhon Si Thammarat,144,47733,1549344,764471,784873,138859,138776,83,,,19/1/2022 7:23
24/12/2021,Nakhon Sawan,46,18220,1035028,504657,530371,112947,112567,380,134,65,19/1/2022 7:23
24/12/2021,Nonthaburi,43,69396,1288637,599167,689470,160119,158826,1293,99, ,19/1/2022 7:23
24/12/2021,Narathiwat,18,42731,809660,400501,409159,5393,5393,0,57,28,19/1/2022 7:23
24/12/2021,Nan,3,2906,475875,237959,237916,132711,131256,1455,,,19/1/2022 7:23
24/12/2021,Bueng Kan,22,2829,421995,211494,210501,49966,49403,563,,,19/1/2022 7:23
24/12/2021,Buri Ram,7,17653,1579805,783531,796274,127140,126290,850,,,19/1/2022 7:23
24/12/2021,Pathum Thani,41,43216,1190060,563851,626209,105228,104299,929,114,39,19/1/2022 7:23
24/12/2021,Prachuap Khiri Khan,37,20450,553171,274049,279122,595142,593435,1707,,,19/1/2022 7:23
24/12/2021,Prachin Buri,51,26690,495325,244642,250683,101944,101780,164,91,37,19/1/2022 7:23
24/12/2021,Pattani,60,48737,729581,360348,369233,7237,7237,0,,,19/1/2022 7:23
24/12/2021,Phra Nakhon Si Ayutthaya,55,33873,820512,394024,426488,506314,497703,8611,109,63,19/1/2022 7:23
24/12/2021,Phayao,1,2719,464505,225943,238562,78112,77046,1066,106,53,19/1/2022 7:23
24/12/2021,Phang-nga,39,7580,268016,133785,134231,174747,140351,34396,,,19/1/2022 7:23
24/12/2021,Phatthalung,59,13667,522541,254425,268116,39244,39244,0,,,19/1/2022 7:23
24/12/2021,Phichit,0,5441,529395,258012,271383,47217,47125,92,,,19/1/2022 7:23
24/12/2021,Phitsanulok,59,9368,847384,414577,432807,202694,202078,616,,,19/1/2022 7:23
24/12/2021,Phuket,32,19282,418785,197874,220911,261943,167948,93995,73,24,19/1/2022 7:23
24/12/2021,Maha Sarakham,3,11338,948310,464976,483334,33099,33059,40,,,19/1/2022 7:23
24/12/2021,Mukdahan,1,2565,351484,175633,175851,96965,96923,42,,,19/1/2022 7:23
24/12/2021,Yala,45,48686,542314,269907,272407,48470,48470,0,64,25,19/1/2022 7:23
24/12/2021,Yasothon,3,6111,533394,265945,267449,38817,38817,0,,,19/1/2022 7:23
24/12/2021,Ranong,3,10051,194573,98136,96437,21868,21760,108,,,19/1/2022 7:23
24/12/2021,Rayong,43,46770,751343,368992,382351,442667,440059,2608,84,27,19/1/2022 7:23
24/12/2021,Ratchaburi,60,45187,868281,421921,446360,187297,186671,626,,,19/1/2022 7:23
24/12/2021,Roi Et,9,14494,1296013,641883,654130,44247,44214,33,,,19/1/2022 7:23
24/12/2021,Lop Buri,34,18927,739473,368733,370740,265330,265144,186,,,19/1/2022 7:23
24/12/2021,Lampang,11,3525,724678,352894,371784,147515,146727,788,105,46,19/1/2022 7:23
24/12/2021,Lamphun,2,4691,401139,192712,208427,95420,94339,1081,,,19/1/2022 7:23
24/12/2021,Si Sa Ket,39,19702,1457556,725426,732130,69970,69958,12,,,19/1/2022 7:23
24/12/2021,Sakon Nakhon,5,7999,1146286,569364,576922,123784,123753,31,,,19/1/2022 7:23
24/12/2021,Songkhla,89,67370,1431536,697256,734280,111186,110907,279,58,27,19/1/2022 7:23
24/12/2021,Satun,20,8777,324835,161640,163195,118953,118571,382,56,21,19/1/2022 7:23
24/12/2021,Samut Prakarn,93,135088,1356449,645884,710565,148306,128665,19641,,,19/1/2022 7:23
24/12/2021,Samut Songkhram,5,12070,190842,91101,99741,186767,186640,127,115,25,19/1/2022 7:23
24/12/2021,Samut Sakhon,23,112294,586789,282683,304106,49065,48960,105,143,35,19/1/2022 7:23
24/12/2021,Saraburi,47,34398,643963,316201,327762,308153,307750,403,151,101,19/1/2022 7:23
24/12/2021,Sa kaeo,10,19869,561992,280673,281319,68672,68321,351,68,29,19/1/2022 7:23
24/12/2021,Sing Buri,3,3584,204526,97144,107382,38697,38585,112,,,19/1/2022 7:23
24/12/2021,Suphan Buri,11,16710,835360,402883,432477,346794,346794,0,,,19/1/2022 7:23
24/12/2021,Surat Thani,45,28365,1072464,527349,545115,132624,124431,8193,77,33,19/1/2022 7:23
24/12/2021,Surin,4,19158,1376230,684354,691876,76048,75971,77,,,19/1/2022 7:23
24/12/2021,Sukhothai,5,6529,585352,283429,301923,77889,76248,1641,,,19/1/2022 7:23
24/12/2021,Nong Khai,1,4511,516843,256268,260575,176894,176022,872,61,38,19/1/2022 7:23
24/12/2021,Nong Bua Lam Phu,1,4711,509001,253757,255244,23866,23805,61,,,19/1/2022 7:23
24/12/2021,Amnat Charoen,2,3110,376350,187122,189228,26300,26300,0,,,19/1/2022 7:23
24/12/2021,Udon Thani,39,25873,1566510,775357,791153,215933,215261,672,,,19/1/2022 7:23
24/12/2021,Uttaradit,1,4623,446148,217413,228735,74305,74146,159,,,19/1/2022 7:23
24/12/2021,Uthai Thani,3,3900,325116,158926,166190,46752,46752,0,,,19/1/2022 7:23
24/12/2021,Ubon Ratchathani,11,22913,1868519,932466,936053,211200,211160,40,79,21,19/1/2022 7:23
24/12/2021,Ang Thong,18,11803,274763,131399,143364,42587,42587,0,,,19/1/2022 7:23
24/12/2021,Chiang Rai,9,5944,1298425,630868,667557,362358,360119,2239,102,42,19/1/2022 7:23
24/12/2021,Chiang Mai,57,33453,1789385,864364,925021,817474,810928,6546,99,50,19/1/2022 7:23
24/12/2021,Phetchaburi,20,24503,482875,232927,249948,596099,595951,148,,,19/1/2022 7:23
24/12/2021,Phetchabun,17,12668,978372,482234,496138,196178,195552,626,,,19/1/2022 7:23
24/12/2021,Loei,3,4575,638732,319949,318783,143151,142378,773,106,53,19/1/2022 7:23
24/12/2021,Phrae,6,2067,434580,209403,225177,91286,90937,349,111,48,19/1/2022 7:23
24/12/2021,Mae Hong Son,21,3289,285916,144811,141105,114751,112339,2412,,,19/1/2022 7:23
24/12/2021,,0,173,,,,,,,,,19/1/2022 7:23
25/12/2021,Krabi,43,12094,479351,238092,241259,81255,79570,1685,,,19/1/2022 7:23
25/12/2021,Bangkok,505,468160,5527994,2592292,2935702,2543615,2383978,159637,78,37,19/1/2022 7:23
25/12/2021,Kanchanaburi,25,24686,894054,448312,445742,908851,907622,1229,119,47,19/1/2022 7:23
25/12/2021,Kalasin,61,10228,975570,481988,493582,44112,43792,320,,,19/1/2022 7:23
25/12/2021,Kamphaeng Phet,2,8422,712143,351539,360604,60392,60106,286,,,19/1/2022 7:23
25/12/2021,Khon Kaen,64,27249,1790863,879849,911014,356626,354735,1891,101,43,19/1/2022 7:23
25/12/2021,Chanthaburi,11,22694,536557,262257,274300,132403,132126,277,,,19/1/2022 7:23
25/12/2021,Chachoengsao,45,38260,724178,354834,369344,350064,349850,214,64,43,19/1/2022 7:23
25/12/2021,Chon Buri,195,114563,1583672,772463,811209,975534,964356,11178,75,38,19/1/2022 7:23
25/12/2021,Chai Nat,7,2954,320432,153962,166470,51161,51147,14,,,19/1/2022 7:23
25/12/2021,Chaiyaphum,1,12283,1122265,554299,567966,99618,99364,254,,,19/1/2022 7:23
25/12/2021,Chumphon,43,16459,509479,251405,258074,70890,70798,92,,,19/1/2022 7:23
25/12/2021,Trang,59,17824,639788,312693,327095,91461,91339,122,,,19/1/2022 7:23
25/12/2021,Trat,25,9339,228376,112941,115435,133130,130498,2632,,,19/1/2022 7:23
25/12/2021,Tak,26,26233,676583,341966,334617,109369,109331,38,,,19/1/2022 7:23
25/12/2021,Nakhon Nayok,20,11827,260433,128854,131579,170360,170245,115,,,19/1/2022 7:23
25/12/2021,Nakhon Pathom,16,36551,922171,442800,479371,216272,216000,272,81,32,19/1/2022 7:23
25/12/2021,Nakhon Phanom,8,5150,717040,357096,359944,101214,101189,25,,,19/1/2022 7:23
25/12/2021,Nakhon Ratchasima,44,36031,2634154,1293783,1340371,571339,566844,4495,79,30,19/1/2022 7:23
25/12/2021,Nakhon Si Thammarat,182,47915,1549344,764471,784873,138859,138776,83,,,19/1/2022 7:23
25/12/2021,Nakhon Sawan,31,18251,1035028,504657,530371,112947,112567,380,121,36,19/1/2022 7:23
25/12/2021,Nonthaburi,32,69428,1288637,599167,689470,160119,158826,1293,59, ,19/1/2022 7:23
25/12/2021,Narathiwat,18,42749,809660,400501,409159,5393,5393,0,67,26,19/1/2022 7:23
25/12/2021,Nan,16,2922,475875,237959,237916,132711,131256,1455,,,19/1/2022 7:23
25/12/2021,Bueng Kan,18,2847,421995,211494,210501,49966,49403,563,,,19/1/2022 7:23
25/12/2021,Buri Ram,4,17657,1579805,783531,796274,127140,126290,850,,,19/1/2022 7:23
25/12/2021,Pathum Thani,46,43262,1190060,563851,626209,105228,104299,929,76,34,19/1/2022 7:23
25/12/2021,Prachuap Khiri Khan,41,20491,553171,274049,279122,595142,593435,1707,,,19/1/2022 7:23
25/12/2021,Prachin Buri,39,26729,495325,244642,250683,101944,101780,164,74,57,19/1/2022 7:23
25/12/2021,Pattani,37,48774,729581,360348,369233,7237,7237,0,,,19/1/2022 7:23
25/12/2021,Phra Nakhon Si Ayutthaya,27,33900,820512,394024,426488,506314,497703,8611,81,61,19/1/2022 7:23
25/12/2021,Phayao,3,2722,464505,225943,238562,78112,77046,1066,119,41,19/1/2022 7:23
25/12/2021,Phang-nga,41,7621,268016,133785,134231,174747,140351,34396,,,19/1/2022 7:23
25/12/2021,Phatthalung,44,13711,522541,254425,268116,39244,39244,0,,,19/1/2022 7:23
25/12/2021,Phichit,0,5441,529395,258012,271383,47217,47125,92,,,19/1/2022 7:23
25/12/2021,Phitsanulok,42,9410,847384,414577,432807,202694,202078,616,,,19/1/2022 7:23
25/12/2021,Phuket,41,19323,418785,197874,220911,261943,167948,93995,45,31,19/1/2022 7:23
25/12/2021,Maha Sarakham,5,11343,948310,464976,483334,33099,33059,40,,,19/1/2022 7:23
25/12/2021,Mukdahan,0,2565,351484,175633,175851,96965,96923,42,,,19/1/2022 7:23
25/12/2021,Yala,29,48715,542314,269907,272407,48470,48470,0,60,29,19/1/2022 7:23
25/12/2021,Yasothon,3,6114,533394,265945,267449,38817,38817,0,,,19/1/2022 7:23
25/12/2021,Ranong,3,10054,194573,98136,96437,21868,21760,108,,,19/1/2022 7:23
25/12/2021,Rayong,46,46816,751343,368992,382351,442667,440059,2608,66,25,19/1/2022 7:23
25/12/2021,Ratchaburi,36,45223,868281,421921,446360,187297,186671,626,,,19/1/2022 7:23
25/12/2021,Roi Et,21,14515,1296013,641883,654130,44247,44214,33,,,19/1/2022 7:23
25/12/2021,Lop Buri,39,18966,739473,368733,370740,265330,265144,186,,,19/1/2022 7:23
25/12/2021,Lampang,26,3551,724678,352894,371784,147515,146727,788,115,36,19/1/2022 7:23
25/12/2021,Lamphun,12,4703,401139,192712,208427,95420,94339,1081,,,19/1/2022 7:23
25/12/2021,Si Sa Ket,39,19741,1457556,725426,732130,69970,69958,12,,,19/1/2022 7:23
25/12/2021,Sakon Nakhon,6,8005,1146286,569364,576922,123784,123753,31,,,19/1/2022 7:23
25/12/2021,Songkhla,73,67443,1431536,697256,734280,111186,110907,279,54,27,19/1/2022 7:23
25/12/2021,Satun,29,8806,324835,161640,163195,118953,118571,382,38,22,19/1/2022 7:23
25/12/2021,Samut Prakarn,119,135207,1356449,645884,710565,148306,128665,19641,,,19/1/2022 7:23
25/12/2021,Samut Songkhram,4,12074,190842,91101,99741,186767,186640,127,61,21,19/1/2022 7:23
25/12/2021,Samut Sakhon,28,112322,586789,282683,304106,49065,48960,105,77,29,19/1/2022 7:23
25/12/2021,Saraburi,44,34442,643963,316201,327762,308153,307750,403,116,66,19/1/2022 7:23
25/12/2021,Sa kaeo,5,19874,561992,280673,281319,68672,68321,351,57,31,19/1/2022 7:23
25/12/2021,Sing Buri,1,3585,204526,97144,107382,38697,38585,112,,,19/1/2022 7:23
25/12/2021,Suphan Buri,5,16715,835360,402883,432477,346794,346794,0,,,19/1/2022 7:23
25/12/2021,Surat Thani,64,28429,1072464,527349,545115,132624,124431,8193,43,20,19/1/2022 7:23
25/12/2021,Surin,1,19159,1376230,684354,691876,76048,75971,77,,,19/1/2022 7:23
25/12/2021,Sukhothai,0,6529,585352,283429,301923,77889,76248,1641,,,19/1/2022 7:23
25/12/2021,Nong Khai,3,4514,516843,256268,260575,176894,176022,872,61,33,19/1/2022 7:23
25/12/2021,Nong Bua Lam Phu,8,4719,509001,253757,255244,23866,23805,61,,,19/1/2022 7:23
25/12/2021,Amnat Charoen,1,3111,376350,187122,189228,26300,26300,0,,,19/1/2022 7:23
25/12/2021,Udon Thani,53,25926,1566510,775357,791153,215933,215261,672,,,19/1/2022 7:23
25/12/2021,Uttaradit,0,4623,446148,217413,228735,74305,74146,159,,,19/1/2022 7:23
25/12/2021,Uthai Thani,6,3906,325116,158926,166190,46752,46752,0,,,19/1/2022 7:23
25/12/2021,Ubon Ratchathani,8,22921,1868519,932466,936053,211200,211160,40,52,14,19/1/2022 7:23
25/12/2021,Ang Thong,11,11814,274763,131399,143364,42587,42587,0,,,19/1/2022 7:23
25/12/2021,Chiang Rai,19,5963,1298425,630868,667557,362358,360119,2239,101,41,19/1/2022 7:23
25/12/2021,Chiang Mai,67,33520,1789385,864364,925021,817474,810928,6546,107,51,19/1/2022 7:23
25/12/2021,Phetchaburi,19,24522,482875,232927,249948,596099,595951,148,,,19/1/2022 7:23
25/12/2021,Phetchabun,45,12713,978372,482234,496138,196178,195552,626,,,19/1/2022 7:23
25/12/2021,Loei,9,4584,638732,319949,318783,143151,142378,773,111,37,19/1/2022 7:23
25/12/2021,Phrae,2,2069,434580,209403,225177,91286,90937,349,111,39,19/1/2022 7:23
25/12/2021,Mae Hong Son,15,3304,285916,144811,141105,114751,112339,2412,,,19/1/2022 7:23
25/12/2021,,0,173,,,,,,,,,19/1/2022 7:23
26/12/2021,Krabi,41,12135,479351,238092,241259,81255,79570,1685,,,19/1/2022 7:23
26/12/2021,Bangkok,436,468596,5527994,2592292,2935702,2543615,2383978,159637,74,49,19/1/2022 7:23
26/12/2021,Kanchanaburi,29,24715,894054,448312,445742,908851,907622,1229,82,45,19/1/2022 7:23
26/12/2021,Kalasin,57,10285,975570,481988,493582,44112,43792,320,,,19/1/2022 7:23
26/12/2021,Kamphaeng Phet,10,8432,712143,351539,360604,60392,60106,286,,,19/1/2022 7:23
26/12/2021,Khon Kaen,44,27293,1790863,879849,911014,356626,354735,1891,76,41,19/1/2022 7:23
26/12/2021,Chanthaburi,19,22713,536557,262257,274300,132403,132126,277,,,19/1/2022 7:23
26/12/2021,Chachoengsao,48,38308,724178,354834,369344,350064,349850,214,73,46,19/1/2022 7:23
26/12/2021,Chon Buri,183,114746,1583672,772463,811209,975534,964356,11178,68,45,19/1/2022 7:23
26/12/2021,Chai Nat,1,2955,320432,153962,166470,51161,51147,14,,,19/1/2022 7:23
26/12/2021,Chaiyaphum,1,12284,1122265,554299,567966,99618,99364,254,,,19/1/2022 7:23
26/12/2021,Chumphon,49,16508,509479,251405,258074,70890,70798,92,,,19/1/2022 7:23
26/12/2021,Trang,54,17878,639788,312693,327095,91461,91339,122,,,19/1/2022 7:23
26/12/2021,Trat,9,9348,228376,112941,115435,133130,130498,2632,,,19/1/2022 7:23
26/12/2021,Tak,40,26273,676583,341966,334617,109369,109331,38,,,19/1/2022 7:23
26/12/2021,Nakhon Nayok,19,11846,260433,128854,131579,170360,170245,115,,,19/1/2022 7:23
26/12/2021,Nakhon Pathom,16,36567,922171,442800,479371,216272,216000,272,65,48,19/1/2022 7:23
26/12/2021,Nakhon Phanom,7,5157,717040,357096,359944,101214,101189,25,,,19/1/2022 7:23
26/12/2021,Nakhon Ratchasima,33,36064,2634154,1293783,1340371,571339,566844,4495,67,26,19/1/2022 7:23
26/12/2021,Nakhon Si Thammarat,144,48059,1549344,764471,784873,138859,138776,83,,,19/1/2022 7:23
26/12/2021,Nakhon Sawan,22,18273,1035028,504657,530371,112947,112567,380,59,44,19/1/2022 7:23
26/12/2021,Nonthaburi,49,69477,1288637,599167,689470,160119,158826,1293,56, ,19/1/2022 7:23
26/12/2021,Narathiwat,17,42766,809660,400501,409159,5393,5393,0,63,31,19/1/2022 7:23
26/12/2021,Nan,6,2928,475875,237959,237916,132711,131256,1455,,,19/1/2022 7:23
26/12/2021,Bueng Kan,7,2854,421995,211494,210501,49966,49403,563,,,19/1/2022 7:23
26/12/2021,Buri Ram,12,17669,1579805,783531,796274,127140,126290,850,,,19/1/2022 7:23
26/12/2021,Pathum Thani,54,43316,1190060,563851,626209,105228,104299,929,62,44,19/1/2022 7:23
26/12/2021,Prachuap Khiri Khan,73,20564,553171,274049,279122,595142,593435,1707,,,19/1/2022 7:23
26/12/2021,Prachin Buri,35,26764,495325,244642,250683,101944,101780,164,99,41,19/1/2022 7:23
26/12/2021,Pattani,35,48809,729581,360348,369233,7237,7237,0,,,19/1/2022 7:23
26/12/2021,Phra Nakhon Si Ayutthaya,45,33945,820512,394024,426488,506314,497703,8611,65,59,19/1/2022 7:23
26/12/2021,Phayao,7,2729,464505,225943,238562,78112,77046,1066,97,32,19/1/2022 7:23
26/12/2021,Phang-nga,33,7654,268016,133785,134231,174747,140351,34396,,,19/1/2022 7:23
26/12/2021,Phatthalung,47,13758,522541,254425,268116,39244,39244,0,,,19/1/2022 7:23
26/12/2021,Phichit,2,5443,529395,258012,271383,47217,47125,92,,,19/1/2022 7:23
26/12/2021,Phitsanulok,25,9435,847384,414577,432807,202694,202078,616,,,19/1/2022 7:23
26/12/2021,Phuket,47,19370,418785,197874,220911,261943,167948,93995,51,31,19/1/2022 7:23
26/12/2021,Maha Sarakham,16,11359,948310,464976,483334,33099,33059,40,,,19/1/2022 7:23
26/12/2021,Mukdahan,4,2569,351484,175633,175851,96965,96923,42,,,19/1/2022 7:23
26/12/2021,Yala,35,48750,542314,269907,272407,48470,48470,0,64, ,19/1/2022 7:23
26/12/2021,Yasothon,0,6114,533394,265945,267449,38817,38817,0,,,19/1/2022 7:23
26/12/2021,Ranong,7,10061,194573,98136,96437,21868,21760,108,,,19/1/2022 7:23
26/12/2021,Rayong,33,46849,751343,368992,382351,442667,440059,2608,59,35,19/1/2022 7:23
26/12/2021,Ratchaburi,27,45250,868281,421921,446360,187297,186671,626,,,19/1/2022 7:23
26/12/2021,Roi Et,44,14559,1296013,641883,654130,44247,44214,33,,,19/1/2022 7:23
26/12/2021,Lop Buri,22,18988,739473,368733,370740,265330,265144,186,,,19/1/2022 7:23
26/12/2021,Lampang,28,3579,724678,352894,371784,147515,146727,788,93,28,19/1/2022 7:23
26/12/2021,Lamphun,17,4720,401139,192712,208427,95420,94339,1081,,,19/1/2022 7:23
26/12/2021,Si Sa Ket,17,19758,1457556,725426,732130,69970,69958,12,,,19/1/2022 7:23
26/12/2021,Sakon Nakhon,0,8005,1146286,569364,576922,123784,123753,31,,,19/1/2022 7:23
26/12/2021,Songkhla,49,67492,1431536,697256,734280,111186,110907,279,52,31,19/1/2022 7:23
26/12/2021,Satun,29,8835,324835,161640,163195,118953,118571,382,33,20,19/1/2022 7:23
26/12/2021,Samut Prakarn,87,135294,1356449,645884,710565,148306,128665,19641,,,19/1/2022 7:23
26/12/2021,Samut Songkhram,6,12080,190842,91101,99741,186767,186640,127,50,40,19/1/2022 7:23
26/12/2021,Samut Sakhon,20,112342,586789,282683,304106,49065,48960,105,69,49,19/1/2022 7:23
26/12/2021,Saraburi,32,34474,643963,316201,327762,308153,307750,403,72,67,19/1/2022 7:23
26/12/2021,Sa kaeo,10,19884,561992,280673,281319,68672,68321,351,64,27,19/1/2022 7:23
26/12/2021,Sing Buri,0,3585,204526,97144,107382,38697,38585,112,,,19/1/2022 7:23
26/12/2021,Suphan Buri,11,16726,835360,402883,432477,346794,346794,0,,,19/1/2022 7:23
26/12/2021,Surat Thani,60,28489,1072464,527349,545115,132624,124431,8193,46,21,19/1/2022 7:23
26/12/2021,Surin,5,19164,1376230,684354,691876,76048,75971,77,,,19/1/2022 7:23
26/12/2021,Sukhothai,4,6533,585352,283429,301923,77889,76248,1641,,,19/1/2022 7:23
26/12/2021,Nong Khai,2,4516,516843,256268,260575,176894,176022,872,41,31,19/1/2022 7:23
26/12/2021,Nong Bua Lam Phu,1,4720,509001,253757,255244,23866,23805,61,,,19/1/2022 7:23
26/12/2021,Amnat Charoen,0,3111,376350,187122,189228,26300,26300,0,,,19/1/2022 7:23
26/12/2021,Udon Thani,15,25941,1566510,775357,791153,215933,215261,672,,,19/1/2022 7:23
26/12/2021,Uttaradit,4,4627,446148,217413,228735,74305,74146,159,,,19/1/2022 7:23
26/12/2021,Uthai Thani,0,3906,325116,158926,166190,46752,46752,0,,,19/1/2022 7:23
26/12/2021,Ubon Ratchathani,18,22939,1868519,932466,936053,211200,211160,40,29,12,19/1/2022 7:23
26/12/2021,Ang Thong,9,11823,274763,131399,143364,42587,42587,0,,,19/1/2022 7:23
26/12/2021,Chiang Rai,10,5973,1298425,630868,667557,362358,360119,2239,103,32,19/1/2022 7:23
26/12/2021,Chiang Mai,66,33586,1789385,864364,925021,817474,810928,6546,107,46,19/1/2022 7:23
26/12/2021,Phetchaburi,12,24534,482875,232927,249948,596099,595951,148,,,19/1/2022 7:23
26/12/2021,Phetchabun,31,12744,978372,482234,496138,196178,195552,626,,,19/1/2022 7:23
26/12/2021,Loei,13,4597,638732,319949,318783,143151,142378,773,77,36,19/1/2022 7:23
26/12/2021,Phrae,1,2070,434580,209403,225177,91286,90937,349,96,26,19/1/2022 7:23
26/12/2021,Mae Hong Son,31,3335,285916,144811,141105,114751,112339,2412,,,19/1/2022 7:23
26/12/2021,,0,173,,,,,,,,,19/1/2022 7:23
27/12/2021,Krabi,40,12175,479351,238092,241259,81255,79570,1685,,,19/1/2022 7:23
27/12/2021,Bangkok,453,469049,5527994,2592292,2935702,2543615,2383978,159637,89,35,19/1/2022 7:23
27/12/2021,Kanchanaburi,30,24745,894054,448312,445742,908851,907622,1229,70,43,19/1/2022 7:23
27/12/2021,Kalasin,43,10328,975570,481988,493582,44112,43792,320,,,19/1/2022 7:23
27/12/2021,Kamphaeng Phet,13,8445,712143,351539,360604,60392,60106,286,,,19/1/2022 7:23
27/12/2021,Khon Kaen,96,27389,1790863,879849,911014,356626,354735,1891,68,40,19/1/2022 7:23
27/12/2021,Chanthaburi,5,22718,536557,262257,274300,132403,132126,277,,,19/1/2022 7:23
27/12/2021,Chachoengsao,54,38362,724178,354834,369344,350064,349850,214,78,37,19/1/2022 7:23
27/12/2021,Chon Buri,144,114890,1583672,772463,811209,975534,964356,11178,67,34,19/1/2022 7:23
27/12/2021,Chai Nat,3,2958,320432,153962,166470,51161,51147,14,,,19/1/2022 7:23
27/12/2021,Chaiyaphum,4,12288,1122265,554299,567966,99618,99364,254,,,19/1/2022 7:23
27/12/2021,Chumphon,31,16539,509479,251405,258074,70890,70798,92,,,19/1/2022 7:23
27/12/2021,Trang,56,17934,639788,312693,327095,91461,91339,122,,,19/1/2022 7:23
27/12/2021,Trat,1,9349,228376,112941,115435,133130,130498,2632,,,19/1/2022 7:23
27/12/2021,Tak,16,26289,676583,341966,334617,109369,109331,38,,,19/1/2022 7:23
27/12/2021,Nakhon Nayok,10,11856,260433,128854,131579,170360,170245,115,,,19/1/2022 7:23
27/12/2021,Nakhon Pathom,11,36578,922171,442800,479371,216272,216000,272,91,38,19/1/2022 7:23
27/12/2021,Nakhon Phanom,3,5160,717040,357096,359944,101214,101189,25,,,19/1/2022 7:23
27/12/2021,Nakhon Ratchasima,26,36090,2634154,1293783,1340371,571339,566844,4495,52,23,19/1/2022 7:23
27/12/2021,Nakhon Si Thammarat,150,48209,1549344,764471,784873,138859,138776,83,,,19/1/2022 7:23
27/12/2021,Nakhon Sawan,30,18303,1035028,504657,530371,112947,112567,380,74,38,19/1/2022 7:23
27/12/2021,Nonthaburi,36,69513,1288637,599167,689470,160119,158826,1293,71, ,19/1/2022 7:23
27/12/2021,Narathiwat,17,42783,809660,400501,409159,5393,5393,0,71,33,19/1/2022 7:23
27/12/2021,Nan,11,2939,475875,237959,237916,132711,131256,1455,,,19/1/2022 7:23
27/12/2021,Bueng Kan,5,2859,421995,211494,210501,49966,49403,563,,,19/1/2022 7:23
27/12/2021,Buri Ram,13,17682,1579805,783531,796274,127140,126290,850,,,19/1/2022 7:23
27/12/2021,Pathum Thani,44,43360,1190060,563851,626209,105228,104299,929,73,38,19/1/2022 7:23
27/12/2021,Prachuap Khiri Khan,32,20596,553171,274049,279122,595142,593435,1707,,,19/1/2022 7:23
27/12/2021,Prachin Buri,19,26783,495325,244642,250683,101944,101780,164,65,38,19/1/2022 7:23
27/12/2021,Pattani,35,48844,729581,360348,369233,7237,7237,0,,,19/1/2022 7:23
27/12/2021,Phra Nakhon Si Ayutthaya,35,33980,820512,394024,426488,506314,497703,8611,57,53,19/1/2022 7:23
27/12/2021,Phayao,13,2742,464505,225943,238562,78112,77046,1066,80,32,19/1/2022 7:23
27/12/2021,Phang-nga,25,7679,268016,133785,134231,174747,140351,34396,,,19/1/2022 7:23
27/12/2021,Phatthalung,51,13809,522541,254425,268116,39244,39244,0,,,19/1/2022 7:23
27/12/2021,Phichit,3,5446,529395,258012,271383,47217,47125,92,,,19/1/2022 7:23
27/12/2021,Phitsanulok,37,9472,847384,414577,432807,202694,202078,616,,,19/1/2022 7:23
27/12/2021,Phuket,80,19450,418785,197874,220911,261943,167948,93995,55,29,19/1/2022 7:23
27/12/2021,Maha Sarakham,13,11372,948310,464976,483334,33099,33059,40,,,19/1/2022 7:23
27/12/2021,Mukdahan,7,2576,351484,175633,175851,96965,96923,42,,,19/1/2022 7:23
27/12/2021,Yala,30,48780,542314,269907,272407,48470,48470,0,68,34,19/1/2022 7:23
27/12/2021,Yasothon,6,6120,533394,265945,267449,38817,38817,0,,,19/1/2022 7:23
27/12/2021,Ranong,1,10062,194573,98136,96437,21868,21760,108,,,19/1/2022 7:23
27/12/2021,Rayong,47,46896,751343,368992,382351,442667,440059,2608,78,27,19/1/2022 7:23
27/12/2021,Ratchaburi,32,45282,868281,421921,446360,187297,186671,626,,,19/1/2022 7:23
27/12/2021,Roi Et,29,14588,1296013,641883,654130,44247,44214,33,,,19/1/2022 7:23
27/12/2021,Lop Buri,40,19028,739473,368733,370740,265330,265144,186,,,19/1/2022 7:23
27/12/2021,Lampang,7,3586,724678,352894,371784,147515,146727,788,74,26,19/1/2022 7:23
27/12/2021,Lamphun,5,4725,401139,192712,208427,95420,94339,1081,,,19/1/2022 7:23
27/12/2021,Si Sa Ket,26,19784,1457556,725426,732130,69970,69958,12,,,19/1/2022 7:23
27/12/2021,Sakon Nakhon,4,8009,1146286,569364,576922,123784,123753,31,,,19/1/2022 7:23
27/12/2021,Songkhla,53,67545,1431536,697256,734280,111186,110907,279,62,30,19/1/2022 7:23
27/12/2021,Satun,27,8862,324835,161640,163195,118953,118571,382,29,22,19/1/2022 7:23
27/12/2021,Samut Prakarn,99,135393,1356449,645884,710565,148306,128665,19641,,,19/1/2022 7:23
27/12/2021,Samut Songkhram,3,12083,190842,91101,99741,186767,186640,127,75,39,19/1/2022 7:23
27/12/2021,Samut Sakhon,29,112371,586789,282683,304106,49065,48960,105,98,41,19/1/2022 7:23
27/12/2021,Saraburi,39,34513,643963,316201,327762,308153,307750,403,75,63,19/1/2022 7:23
27/12/2021,Sa kaeo,5,19889,561992,280673,281319,68672,68321,351,53,22,19/1/2022 7:23
27/12/2021,Sing Buri,0,3585,204526,97144,107382,38697,38585,112,,,19/1/2022 7:23
27/12/2021,Suphan Buri,9,16735,835360,402883,432477,346794,346794,0,,,19/1/2022 7:23
27/12/2021,Surat Thani,53,28542,1072464,527349,545115,132624,124431,8193,60,26,19/1/2022 7:23
27/12/2021,Surin,9,19173,1376230,684354,691876,76048,75971,77,,,19/1/2022 7:23
27/12/2021,Sukhothai,3,6536,585352,283429,301923,77889,76248,1641,,,19/1/2022 7:23
27/12/2021,Nong Khai,2,4518,516843,256268,260575,176894,176022,872,20,30,19/1/2022 7:23
27/12/2021,Nong Bua Lam Phu,3,4723,509001,253757,255244,23866,23805,61,,,19/1/2022 7:23
27/12/2021,Amnat Charoen,0,3111,376350,187122,189228,26300,26300,0,,,19/1/2022 7:23
27/12/2021,Udon Thani,19,25960,1566510,775357,791153,215933,215261,672,,,19/1/2022 7:23
27/12/2021,Uttaradit,1,4628,446148,217413,228735,74305,74146,159,,,19/1/2022 7:23
27/12/2021,Uthai Thani,1,3907,325116,158926,166190,46752,46752,0,,,19/1/2022 7:23
27/12/2021,Ubon Ratchathani,34,22973,1868519,932466,936053,211200,211160,40,15,12,19/1/2022 7:23
27/12/2021,Ang Thong,9,11832,274763,131399,143364,42587,42587,0,,,19/1/2022 7:23
27/12/2021,Chiang Rai,6,5979,1298425,630868,667557,362358,360119,2239,81,30,19/1/2022 7:23
27/12/2021,Chiang Mai,57,33643,1789385,864364,925021,817474,810928,6546,90,40,19/1/2022 7:23
27/12/2021,Phetchaburi,6,24540,482875,232927,249948,596099,595951,148,,,19/1/2022 7:23
27/12/2021,Phetchabun,19,12763,978372,482234,496138,196178,195552,626,,,19/1/2022 7:23
27/12/2021,Loei,3,4600,638732,319949,318783,143151,142378,773,65,30,19/1/2022 7:23
27/12/2021,Phrae,6,2076,434580,209403,225177,91286,90937,349,72,27,19/1/2022 7:23
27/12/2021,Mae Hong Son,20,3355,285916,144811,141105,114751,112339,2412,,,19/1/2022 7:23
27/12/2021,,0,173,,,,,,,,,19/1/2022 7:23
28/12/2021,Krabi,39,12214,479351,238092,241259,81255,79570,1685,,,19/1/2022 7:23
28/12/2021,Bangkok,433,469482,5527994,2592292,2935702,2543615,2383978,159637,62,35,19/1/2022 7:23
28/12/2021,Kanchanaburi,29,24774,894054,448312,445742,908851,907622,1229,70,49,19/1/2022 7:23
28/12/2021,Kalasin,54,10382,975570,481988,493582,44112,43792,320,,,19/1/2022 7:23
28/12/2021,Kamphaeng Phet,15,8460,712143,351539,360604,60392,60106,286,,,19/1/2022 7:23
28/12/2021,Khon Kaen,32,27421,1790863,879849,911014,356626,354735,1891,66,37,19/1/2022 7:23
28/12/2021,Chanthaburi,5,22723,536557,262257,274300,132403,132126,277,,,19/1/2022 7:23
28/12/2021,Chachoengsao,33,38395,724178,354834,369344,350064,349850,214,51,37,19/1/2022 7:23
28/12/2021,Chon Buri,217,115107,1583672,772463,811209,975534,964356,11178,52,39,19/1/2022 7:23
28/12/2021,Chai Nat,4,2962,320432,153962,166470,51161,51147,14,,,19/1/2022 7:23
28/12/2021,Chaiyaphum,6,12294,1122265,554299,567966,99618,99364,254,,,19/1/2022 7:23
28/12/2021,Chumphon,23,16562,509479,251405,258074,70890,70798,92,,,19/1/2022 7:23
28/12/2021,Trang,52,17986,639788,312693,327095,91461,91339,122,,,19/1/2022 7:23
28/12/2021,Trat,2,9351,228376,112941,115435,133130,130498,2632,,,19/1/2022 7:23
28/12/2021,Tak,18,26307,676583,341966,334617,109369,109331,38,,,19/1/2022 7:23
28/12/2021,Nakhon Nayok,7,11863,260433,128854,131579,170360,170245,115,,,19/1/2022 7:23
28/12/2021,Nakhon Pathom,17,36595,922171,442800,479371,216272,216000,272,53,35,19/1/2022 7:23
28/12/2021,Nakhon Phanom,1,5161,717040,357096,359944,101214,101189,25,,,19/1/2022 7:23
28/12/2021,Nakhon Ratchasima,49,36139,2634154,1293783,1340371,571339,566844,4495,54,25,19/1/2022 7:23
28/12/2021,Nakhon Si Thammarat,143,48352,1549344,764471,784873,138859,138776,83,,,19/1/2022 7:23
28/12/2021,Nakhon Sawan,15,18318,1035028,504657,530371,112947,112567,380,58,51,19/1/2022 7:23
28/12/2021,Nonthaburi,19,69532,1288637,599167,689470,160119,158826,1293,51, ,19/1/2022 7:23
28/12/2021,Narathiwat,4,42787,809660,400501,409159,5393,5393,0,77,27,19/1/2022 7:23
28/12/2021,Nan,17,2956,475875,237959,237916,132711,131256,1455,,,19/1/2022 7:23
28/12/2021,Bueng Kan,12,2871,421995,211494,210501,49966,49403,563,,,19/1/2022 7:23
28/12/2021,Buri Ram,14,17696,1579805,783531,796274,127140,126290,850,,,19/1/2022 7:23
28/12/2021,Pathum Thani,26,43386,1190060,563851,626209,105228,104299,929,53,37,19/1/2022 7:23
28/12/2021,Prachuap Khiri Khan,38,20634,553171,274049,279122,595142,593435,1707,,,19/1/2022 7:23
28/12/2021,Prachin Buri,25,26808,495325,244642,250683,101944,101780,164,55,39,19/1/2022 7:23
28/12/2021,Pattani,19,48863,729581,360348,369233,7237,7237,0,,,19/1/2022 7:23
28/12/2021,Phra Nakhon Si Ayutthaya,24,34004,820512,394024,426488,506314,497703,8611,48,56,19/1/2022 7:23
28/12/2021,Phayao,14,2756,464505,225943,238562,78112,77046,1066,74,28,19/1/2022 7:23
28/12/2021,Phang-nga,32,7711,268016,133785,134231,174747,140351,34396,,,19/1/2022 7:23
28/12/2021,Phatthalung,48,13857,522541,254425,268116,39244,39244,0,,,19/1/2022 7:23
28/12/2021,Phichit,2,5448,529395,258012,271383,47217,47125,92,,,19/1/2022 7:23
28/12/2021,Phitsanulok,50,9522,847384,414577,432807,202694,202078,616,,,19/1/2022 7:23
28/12/2021,Phuket,59,19509,418785,197874,220911,261943,167948,93995,57,27,19/1/2022 7:23
28/12/2021,Maha Sarakham,41,11413,948310,464976,483334,33099,33059,40,,,19/1/2022 7:23
28/12/2021,Mukdahan,14,2590,351484,175633,175851,96965,96923,42,,,19/1/2022 7:23
28/12/2021,Yala,16,48796,542314,269907,272407,48470,48470,0,69,26,19/1/2022 7:23
28/12/2021,Yasothon,5,6125,533394,265945,267449,38817,38817,0,,,19/1/2022 7:23
28/12/2021,Ranong,1,10063,194573,98136,96437,21868,21760,108,,,19/1/2022 7:23
28/12/2021,Rayong,29,46925,751343,368992,382351,442667,440059,2608,62,23,19/1/2022 7:23
28/12/2021,Ratchaburi,27,45309,868281,421921,446360,187297,186671,626,,,19/1/2022 7:23
28/12/2021,Roi Et,31,14619,1296013,641883,654130,44247,44214,33,,,19/1/2022 7:23
28/12/2021,Lop Buri,28,19056,739473,368733,370740,265330,265144,186,,,19/1/2022 7:23
28/12/2021,Lampang,26,3612,724678,352894,371784,147515,146727,788,69,27,19/1/2022 7:23
28/12/2021,Lamphun,2,4727,401139,192712,208427,95420,94339,1081,,,19/1/2022 7:23
28/12/2021,Si Sa Ket,13,19797,1457556,725426,732130,69970,69958,12,,,19/1/2022 7:23
28/12/2021,Sakon Nakhon,6,8015,1146286,569364,576922,123784,123753,31,,,19/1/2022 7:23
28/12/2021,Songkhla,32,67577,1431536,697256,734280,111186,110907,279,62,23,19/1/2022 7:23
28/12/2021,Satun,26,8888,324835,161640,163195,118953,118571,382,35,21,19/1/2022 7:23
28/12/2021,Samut Prakarn,90,135483,1356449,645884,710565,148306,128665,19641,,,19/1/2022 7:23
28/12/2021,Samut Songkhram,4,12087,190842,91101,99741,186767,186640,127,65,34,19/1/2022 7:23
28/12/2021,Samut Sakhon,13,112384,586789,282683,304106,49065,48960,105,67,34,19/1/2022 7:23
28/12/2021,Saraburi,34,34547,643963,316201,327762,308153,307750,403,51,55,19/1/2022 7:23
28/12/2021,Sa kaeo,0,19889,561992,280673,281319,68672,68321,351,37,23,19/1/2022 7:23
28/12/2021,Sing Buri,2,3587,204526,97144,107382,38697,38585,112,,,19/1/2022 7:23
28/12/2021,Suphan Buri,5,16740,835360,402883,432477,346794,346794,0,,,19/1/2022 7:23
28/12/2021,Surat Thani,36,28578,1072464,527349,545115,132624,124431,8193,51,24,19/1/2022 7:23
28/12/2021,Surin,5,19178,1376230,684354,691876,76048,75971,77,,,19/1/2022 7:23
28/12/2021,Sukhothai,1,6537,585352,283429,301923,77889,76248,1641,,,19/1/2022 7:23
28/12/2021,Nong Khai,5,4523,516843,256268,260575,176894,176022,872,32,34,19/1/2022 7:23
28/12/2021,Nong Bua Lam Phu,1,4724,509001,253757,255244,23866,23805,61,,,19/1/2022 7:23
28/12/2021,Amnat Charoen,1,3112,376350,187122,189228,26300,26300,0,,,19/1/2022 7:23
28/12/2021,Udon Thani,58,26018,1566510,775357,791153,215933,215261,672,,,19/1/2022 7:23
28/12/2021,Uttaradit,2,4630,446148,217413,228735,74305,74146,159,,,19/1/2022 7:23
28/12/2021,Uthai Thani,0,3907,325116,158926,166190,46752,46752,0,,,19/1/2022 7:23
28/12/2021,Ubon Ratchathani,44,23017,1868519,932466,936053,211200,211160,40,19,13,19/1/2022 7:23
28/12/2021,Ang Thong,3,11835,274763,131399,143364,42587,42587,0,,,19/1/2022 7:23
28/12/2021,Chiang Rai,7,5986,1298425,630868,667557,362358,360119,2239,72,25,19/1/2022 7:23
28/12/2021,Chiang Mai,67,33710,1789385,864364,925021,817474,810928,6546,80,35,19/1/2022 7:23
28/12/2021,Phetchaburi,9,24549,482875,232927,249948,596099,595951,148,,,19/1/2022 7:23
28/12/2021,Phetchabun,8,12771,978372,482234,496138,196178,195552,626,,,19/1/2022 7:23
28/12/2021,Loei,5,4605,638732,319949,318783,143151,142378,773,53,36,19/1/2022 7:23
28/12/2021,Phrae,0,2076,434580,209403,225177,91286,90937,349,70,32,19/1/2022 7:23
28/12/2021,Mae Hong Son,11,3366,285916,144811,141105,114751,112339,2412,,,19/1/2022 7:23
28/12/2021,,0,173,,,,,,,,,19/1/2022 7:23
29/12/2021,Krabi,37,12251,479351,238092,241259,81255,79570,1685,,,19/1/2022 7:23
29/12/2021,Bangkok,407,469889,5527994,2592292,2935702,2543615,2383978,159637,64,35,19/1/2022 7:23
29/12/2021,Kanchanaburi,28,24802,894054,448312,445742,908851,907622,1229,72,39,19/1/2022 7:23
29/12/2021,Kalasin,65,10447,975570,481988,493582,44112,43792,320,,,19/1/2022 7:23
29/12/2021,Kamphaeng Phet,12,8472,712143,351539,360604,60392,60106,286,,,19/1/2022 7:23
29/12/2021,Khon Kaen,68,27489,1790863,879849,911014,356626,354735,1891,63,38,19/1/2022 7:23
29/12/2021,Chanthaburi,6,22729,536557,262257,274300,132403,132126,277,,,19/1/2022 7:23
29/12/2021,Chachoengsao,30,38425,724178,354834,369344,350064,349850,214,56,39,19/1/2022 7:23
29/12/2021,Chon Buri,203,115310,1583672,772463,811209,975534,964356,11178,57,36,19/1/2022 7:23
29/12/2021,Chai Nat,5,2967,320432,153962,166470,51161,51147,14,,,19/1/2022 7:23
29/12/2021,Chaiyaphum,2,12296,1122265,554299,567966,99618,99364,254,,,19/1/2022 7:23
29/12/2021,Chumphon,40,16602,509479,251405,258074,70890,70798,92,,,19/1/2022 7:23
29/12/2021,Trang,47,18033,639788,312693,327095,91461,91339,122,,,19/1/2022 7:23
29/12/2021,Trat,25,9376,228376,112941,115435,133130,130498,2632,,,19/1/2022 7:23
29/12/2021,Tak,42,26349,676583,341966,334617,109369,109331,38,,,19/1/2022 7:23
29/12/2021,Nakhon Nayok,19,11882,260433,128854,131579,170360,170245,115,,,19/1/2022 7:23
29/12/2021,Nakhon Pathom,18,36613,922171,442800,479371,216272,216000,272,58,32,19/1/2022 7:23
29/12/2021,Nakhon Phanom,2,5163,717040,357096,359944,101214,101189,25,,,19/1/2022 7:23
29/12/2021,Nakhon Ratchasima,58,36197,2634154,1293783,1340371,571339,566844,4495,56,23,19/1/2022 7:23
29/12/2021,Nakhon Si Thammarat,63,48415,1549344,764471,784873,138859,138776,83,,,19/1/2022 7:23
29/12/2021,Nakhon Sawan,26,18344,1035028,504657,530371,112947,112567,380,84,36,19/1/2022 7:23
29/12/2021,Nonthaburi,30,69562,1288637,599167,689470,160119,158826,1293,52, ,19/1/2022 7:23
29/12/2021,Narathiwat,18,42805,809660,400501,409159,5393,5393,0,63,29,19/1/2022 7:23
29/12/2021,Nan,16,2972,475875,237959,237916,132711,131256,1455,,,19/1/2022 7:23
29/12/2021,Bueng Kan,10,2881,421995,211494,210501,49966,49403,563,,,19/1/2022 7:23
29/12/2021,Buri Ram,24,17720,1579805,783531,796274,127140,126290,850,,,19/1/2022 7:23
29/12/2021,Pathum Thani,34,43420,1190060,563851,626209,105228,104299,929,62,34,19/1/2022 7:23
29/12/2021,Prachuap Khiri Khan,41,20675,553171,274049,279122,595142,593435,1707,,,19/1/2022 7:23
29/12/2021,Prachin Buri,44,26852,495325,244642,250683,101944,101780,164,60,36,19/1/2022 7:23
29/12/2021,Pattani,25,48888,729581,360348,369233,7237,7237,0,,,19/1/2022 7:23
29/12/2021,Phra Nakhon Si Ayutthaya,31,34035,820512,394024,426488,506314,497703,8611,57,54,19/1/2022 7:23
29/12/2021,Phayao,13,2769,464505,225943,238562,78112,77046,1066,67,32,19/1/2022 7:23
29/12/2021,Phang-nga,38,7749,268016,133785,134231,174747,140351,34396,,,19/1/2022 7:23
29/12/2021,Phatthalung,37,13894,522541,254425,268116,39244,39244,0,,,19/1/2022 7:23
29/12/2021,Phichit,0,5448,529395,258012,271383,47217,47125,92,,,19/1/2022 7:23
29/12/2021,Phitsanulok,52,9574,847384,414577,432807,202694,202078,616,,,19/1/2022 7:23
29/12/2021,Phuket,64,19573,418785,197874,220911,261943,167948,93995,46,22,19/1/2022 7:23
29/12/2021,Maha Sarakham,47,11460,948310,464976,483334,33099,33059,40,,,19/1/2022 7:23
29/12/2021,Mukdahan,11,2601,351484,175633,175851,96965,96923,42,,,19/1/2022 7:23
29/12/2021,Yala,27,48823,542314,269907,272407,48470,48470,0,56,23,19/1/2022 7:23
29/12/2021,Yasothon,5,6130,533394,265945,267449,38817,38817,0,,,19/1/2022 7:23
29/12/2021,Ranong,4,10067,194573,98136,96437,21868,21760,108,,,19/1/2022 7:23
29/12/2021,Rayong,17,46942,751343,368992,382351,442667,440059,2608,53,21,19/1/2022 7:23
29/12/2021,Ratchaburi,34,45343,868281,421921,446360,187297,186671,626,,,19/1/2022 7:23
29/12/2021,Roi Et,32,14651,1296013,641883,654130,44247,44214,33,,,19/1/2022 7:23
29/12/2021,Lop Buri,9,19065,739473,368733,370740,265330,265144,186,,,19/1/2022 7:23
29/12/2021,Lampang,36,3648,724678,352894,371784,147515,146727,788,75,26,19/1/2022 7:23
29/12/2021,Lamphun,9,4736,401139,192712,208427,95420,94339,1081,,,19/1/2022 7:23
29/12/2021,Si Sa Ket,22,19819,1457556,725426,732130,69970,69958,12,,,19/1/2022 7:23
29/12/2021,Sakon Nakhon,14,8029,1146286,569364,576922,123784,123753,31,,,19/1/2022 7:23
29/12/2021,Songkhla,63,67640,1431536,697256,734280,111186,110907,279,42,30,19/1/2022 7:23
29/12/2021,Satun,35,8923,324835,161640,163195,118953,118571,382,24,22,19/1/2022 7:23
29/12/2021,Samut Prakarn,90,135573,1356449,645884,710565,148306,128665,19641,,,19/1/2022 7:23
29/12/2021,Samut Songkhram,2,12089,190842,91101,99741,186767,186640,127,59,32,19/1/2022 7:23
29/12/2021,Samut Sakhon,27,112411,586789,282683,304106,49065,48960,105,69,28,19/1/2022 7:23
29/12/2021,Saraburi,27,34574,643963,316201,327762,308153,307750,403,65,43,19/1/2022 7:23
29/12/2021,Sa kaeo,11,19900,561992,280673,281319,68672,68321,351,44,24,19/1/2022 7:23
29/12/2021,Sing Buri,1,3588,204526,97144,107382,38697,38585,112,,,19/1/2022 7:23
29/12/2021,Suphan Buri,15,16755,835360,402883,432477,346794,346794,0,,,19/1/2022 7:23
29/12/2021,Surat Thani,33,28611,1072464,527349,545115,132624,124431,8193,40,19,19/1/2022 7:23
29/12/2021,Surin,9,19187,1376230,684354,691876,76048,75971,77,,,19/1/2022 7:23
29/12/2021,Sukhothai,3,6540,585352,283429,301923,77889,76248,1641,,,19/1/2022 7:23
29/12/2021,Nong Khai,4,4527,516843,256268,260575,176894,176022,872,38,26,19/1/2022 7:23
29/12/2021,Nong Bua Lam Phu,0,4724,509001,253757,255244,23866,23805,61,,,19/1/2022 7:23
29/12/2021,Amnat Charoen,1,3113,376350,187122,189228,26300,26300,0,,,19/1/2022 7:23
29/12/2021,Udon Thani,50,26068,1566510,775357,791153,215933,215261,672,,,19/1/2022 7:23
29/12/2021,Uttaradit,5,4635,446148,217413,228735,74305,74146,159,,,19/1/2022 7:23
29/12/2021,Uthai Thani,4,3911,325116,158926,166190,46752,46752,0,,,19/1/2022 7:23
29/12/2021,Ubon Ratchathani,74,23091,1868519,932466,936053,211200,211160,40,22,14,19/1/2022 7:23
29/12/2021,Ang Thong,1,11836,274763,131399,143364,42587,42587,0,,,19/1/2022 7:23
29/12/2021,Chiang Rai,21,6007,1298425,630868,667557,362358,360119,2239,65,24,19/1/2022 7:23
29/12/2021,Chiang Mai,56,33766,1789385,864364,925021,817474,810928,6546,69,33,19/1/2022 7:23
29/12/2021,Phetchaburi,13,24562,482875,232927,249948,596099,595951,148,,,19/1/2022 7:23
29/12/2021,Phetchabun,37,12808,978372,482234,496138,196178,195552,626,,,19/1/2022 7:23
29/12/2021,Loei,5,4610,638732,319949,318783,143151,142378,773,69,30,19/1/2022 7:23
29/12/2021,Phrae,8,2084,434580,209403,225177,91286,90937,349,78,30,19/1/2022 7:23
29/12/2021,Mae Hong Son,33,3399,285916,144811,141105,114751,112339,2412,,,19/1/2022 7:23
29/12/2021,,0,173,,,,,,,,,19/1/2022 7:23
30/12/2021,Krabi,45,12296,479351,238092,241259,81255,79570,1685,,,19/1/2022 7:23
30/12/2021,Bangkok,496,470385,5527994,2592292,2935702,2543615,2383978,159637,70,37,19/1/2022 7:23
30/12/2021,Kanchanaburi,29,24831,894054,448312,445742,908851,907622,1229,59,63,19/1/2022 7:23
30/12/2021,Kalasin,63,10510,975570,481988,493582,44112,43792,320,,,19/1/2022 7:23
30/12/2021,Kamphaeng Phet,15,8487,712143,351539,360604,60392,60106,286,,,19/1/2022 7:23
30/12/2021,Khon Kaen,80,27569,1790863,879849,911014,356626,354735,1891,63,38,19/1/2022 7:23
30/12/2021,Chanthaburi,19,22748,536557,262257,274300,132403,132126,277,,,19/1/2022 7:23
30/12/2021,Chachoengsao,52,38477,724178,354834,369344,350064,349850,214,61,36,19/1/2022 7:23
30/12/2021,Chon Buri,310,115620,1583672,772463,811209,975534,964356,11178,55,35,19/1/2022 7:23
30/12/2021,Chai Nat,1,2968,320432,153962,166470,51161,51147,14,,,19/1/2022 7:23
30/12/2021,Chaiyaphum,10,12306,1122265,554299,567966,99618,99364,254,,,19/1/2022 7:23
30/12/2021,Chumphon,17,16619,509479,251405,258074,70890,70798,92,,,19/1/2022 7:23
30/12/2021,Trang,46,18079,639788,312693,327095,91461,91339,122,,,19/1/2022 7:23
30/12/2021,Trat,3,9379,228376,112941,115435,133130,130498,2632,,,19/1/2022 7:23
30/12/2021,Tak,33,26382,676583,341966,334617,109369,109331,38,,,19/1/2022 7:23
30/12/2021,Nakhon Nayok,9,11891,260433,128854,131579,170360,170245,115,,,19/1/2022 7:23
30/12/2021,Nakhon Pathom,16,36629,922171,442800,479371,216272,216000,272,60,43,19/1/2022 7:23
30/12/2021,Nakhon Phanom,9,5172,717040,357096,359944,101214,101189,25,,,19/1/2022 7:23
30/12/2021,Nakhon Ratchasima,34,36231,2634154,1293783,1340371,571339,566844,4495,50,24,19/1/2022 7:23
30/12/2021,Nakhon Si Thammarat,134,48549,1549344,764471,784873,138859,138776,83,,,19/1/2022 7:23
30/12/2021,Nakhon Sawan,30,18374,1035028,504657,530371,112947,112567,380,59,34,19/1/2022 7:23
30/12/2021,Nonthaburi,58,69620,1288637,599167,689470,160119,158826,1293,56, ,19/1/2022 7:23
30/12/2021,Narathiwat,17,42822,809660,400501,409159,5393,5393,0,56,40,19/1/2022 7:23
30/12/2021,Nan,9,2981,475875,237959,237916,132711,131256,1455,,,19/1/2022 7:23
30/12/2021,Bueng Kan,8,2889,421995,211494,210501,49966,49403,563,,,19/1/2022 7:23
30/12/2021,Buri Ram,11,17731,1579805,783531,796274,127140,126290,850,,,19/1/2022 7:23
30/12/2021,Pathum Thani,43,43463,1190060,563851,626209,105228,104299,929,58,34,19/1/2022 7:23
30/12/2021,Prachuap Khiri Khan,26,20701,553171,274049,279122,595142,593435,1707,,,19/1/2022 7:23
30/12/2021,Prachin Buri,22,26874,495325,244642,250683,101944,101780,164,64,36,19/1/2022 7:23
30/12/2021,Pattani,49,48937,729581,360348,369233,7237,7237,0,,,19/1/2022 7:23
30/12/2021,Phra Nakhon Si Ayutthaya,39,34074,820512,394024,426488,506314,497703,8611,48,52,19/1/2022 7:23
30/12/2021,Phayao,11,2780,464505,225943,238562,78112,77046,1066,72,28,19/1/2022 7:23
30/12/2021,Phang-nga,35,7784,268016,133785,134231,174747,140351,34396,,,19/1/2022 7:23
30/12/2021,Phatthalung,55,13949,522541,254425,268116,39244,39244,0,,,19/1/2022 7:23
30/12/2021,Phichit,1,5449,529395,258012,271383,47217,47125,92,,,19/1/2022 7:23
30/12/2021,Phitsanulok,40,9614,847384,414577,432807,202694,202078,616,,,19/1/2022 7:23
30/12/2021,Phuket,74,19647,418785,197874,220911,261943,167948,93995,37,30,19/1/2022 7:23
30/12/2021,Maha Sarakham,83,11543,948310,464976,483334,33099,33059,40,,,19/1/2022 7:23
30/12/2021,Mukdahan,25,2626,351484,175633,175851,96965,96923,42,,,19/1/2022 7:23
30/12/2021,Yala,20,48843,542314,269907,272407,48470,48470,0,51,27,19/1/2022 7:23
30/12/2021,Yasothon,8,6138,533394,265945,267449,38817,38817,0,,,19/1/2022 7:23
30/12/2021,Ranong,0,10067,194573,98136,96437,21868,21760,108,,,19/1/2022 7:23
30/12/2021,Rayong,43,46985,751343,368992,382351,442667,440059,2608,48,24,19/1/2022 7:23
30/12/2021,Ratchaburi,26,45369,868281,421921,446360,187297,186671,626,,,19/1/2022 7:23
30/12/2021,Roi Et,62,14713,1296013,641883,654130,44247,44214,33,,,19/1/2022 7:23
30/12/2021,Lop Buri,36,19101,739473,368733,370740,265330,265144,186,,,19/1/2022 7:23
30/12/2021,Lampang,8,3656,724678,352894,371784,147515,146727,788,74,26,19/1/2022 7:23
30/12/2021,Lamphun,6,4742,401139,192712,208427,95420,94339,1081,,,19/1/2022 7:23
30/12/2021,Si Sa Ket,17,19836,1457556,725426,732130,69970,69958,12,,,19/1/2022 7:23
30/12/2021,Sakon Nakhon,16,8045,1146286,569364,576922,123784,123753,31,,,19/1/2022 7:23
30/12/2021,Songkhla,54,67694,1431536,697256,734280,111186,110907,279,52,35,19/1/2022 7:23
30/12/2021,Satun,26,8949,324835,161640,163195,118953,118571,382,25,28,19/1/2022 7:23
30/12/2021,Samut Prakarn,96,135669,1356449,645884,710565,148306,128665,19641,,,19/1/2022 7:23
30/12/2021,Samut Songkhram,5,12094,190842,91101,99741,186767,186640,127,61,33,19/1/2022 7:23
30/12/2021,Samut Sakhon,18,112429,586789,282683,304106,49065,48960,105,61,31,19/1/2022 7:23
30/12/2021,Saraburi,39,34613,643963,316201,327762,308153,307750,403,52,42,19/1/2022 7:23
30/12/2021,Sa kaeo,14,19914,561992,280673,281319,68672,68321,351,44,24,19/1/2022 7:23
30/12/2021,Sing Buri,1,3589,204526,97144,107382,38697,38585,112,,,19/1/2022 7:23
30/12/2021,Suphan Buri,11,16766,835360,402883,432477,346794,346794,0,,,19/1/2022 7:23
30/12/2021,Surat Thani,55,28666,1072464,527349,545115,132624,124431,8193,35,18,19/1/2022 7:23
30/12/2021,Surin,8,19195,1376230,684354,691876,76048,75971,77,,,19/1/2022 7:23
30/12/2021,Sukhothai,4,6544,585352,283429,301923,77889,76248,1641,,,19/1/2022 7:23
30/12/2021,Nong Khai,8,4535,516843,256268,260575,176894,176022,872,23,28,19/1/2022 7:23
30/12/2021,Nong Bua Lam Phu,5,4729,509001,253757,255244,23866,23805,61,,,19/1/2022 7:23
30/12/2021,Amnat Charoen,4,3117,376350,187122,189228,26300,26300,0,,,19/1/2022 7:23
30/12/2021,Udon Thani,80,26148,1566510,775357,791153,215933,215261,672,,,19/1/2022 7:23
30/12/2021,Uttaradit,0,4635,446148,217413,228735,74305,74146,159,,,19/1/2022 7:23
30/12/2021,Uthai Thani,4,3915,325116,158926,166190,46752,46752,0,,,19/1/2022 7:23
30/12/2021,Ubon Ratchathani,126,23217,1868519,932466,936053,211200,211160,40,29,17,19/1/2022 7:23
30/12/2021,Ang Thong,5,11841,274763,131399,143364,42587,42587,0,,,19/1/2022 7:23
30/12/2021,Chiang Rai,17,6024,1298425,630868,667557,362358,360119,2239,62,30,19/1/2022 7:23
30/12/2021,Chiang Mai,68,33834,1789385,864364,925021,817474,810928,6546,69,31,19/1/2022 7:23
30/12/2021,Phetchaburi,22,24584,482875,232927,249948,596099,595951,148,,,19/1/2022 7:23
30/12/2021,Phetchabun,47,12855,978372,482234,496138,196178,195552,626,,,19/1/2022 7:23
30/12/2021,Loei,8,4618,638732,319949,318783,143151,142378,773,60,25,19/1/2022 7:23
30/12/2021,Phrae,3,2087,434580,209403,225177,91286,90937,349,76,31,19/1/2022 7:23
30/12/2021,Mae Hong Son,10,3409,285916,144811,141105,114751,112339,2412, ,21,19/1/2022 7:23
30/12/2021,,0,173,,,,,,,,,19/1/2022 7:23
31/12/2021,Krabi,37,12333,479351,238092,241259,81255,79570,1685,,,19/1/2022 7:23
31/12/2021,Bangkok,460,470845,5527994,2592292,2935702,2543615,2383978,159637,69,34,19/1/2022 7:23
31/12/2021,Kanchanaburi,27,24858,894054,448312,445742,908851,907622,1229,68,67,19/1/2022 7:23
31/12/2021,Kalasin,48,10558,975570,481988,493582,44112,43792,320,,,19/1/2022 7:23
31/12/2021,Kamphaeng Phet,13,8500,712143,351539,360604,60392,60106,286,,,19/1/2022 7:23
31/12/2021,Khon Kaen,91,27660,1790863,879849,911014,356626,354735,1891,58,37,19/1/2022 7:23
31/12/2021,Chanthaburi,22,22770,536557,262257,274300,132403,132126,277,,,19/1/2022 7:23
31/12/2021,Chachoengsao,36,38513,724178,354834,369344,350064,349850,214,54,38,19/1/2022 7:23
31/12/2021,Chon Buri,322,115942,1583672,772463,811209,975534,964356,11178,53,36,19/1/2022 7:23
31/12/2021,Chai Nat,2,2970,320432,153962,166470,51161,51147,14,,,19/1/2022 7:23
31/12/2021,Chaiyaphum,11,12317,1122265,554299,567966,99618,99364,254,,,19/1/2022 7:23
31/12/2021,Chumphon,24,16643,509479,251405,258074,70890,70798,92,,,19/1/2022 7:23
31/12/2021,Trang,45,18124,639788,312693,327095,91461,91339,122,,,19/1/2022 7:23
31/12/2021,Trat,25,9404,228376,112941,115435,133130,130498,2632,,,19/1/2022 7:23
31/12/2021,Tak,24,26406,676583,341966,334617,109369,109331,38,,,19/1/2022 7:23
31/12/2021,Nakhon Nayok,4,11895,260433,128854,131579,170360,170245,115,,,19/1/2022 7:23
31/12/2021,Nakhon Pathom,36,36665,922171,442800,479371,216272,216000,272,86,47,19/1/2022 7:23
31/12/2021,Nakhon Phanom,5,5177,717040,357096,359944,101214,101189,25,,,19/1/2022 7:23
31/12/2021,Nakhon Ratchasima,49,36280,2634154,1293783,1340371,571339,566844,4495,54,25,19/1/2022 7:23
31/12/2021,Nakhon Si Thammarat,103,48652,1549344,764471,784873,138859,138776,83,,,19/1/2022 7:23
31/12/2021,Nakhon Sawan,29,18403,1035028,504657,530371,112947,112567,380,59,33,19/1/2022 7:23
31/12/2021,Nonthaburi,40,69660,1288637,599167,689470,160119,158826,1293,56, ,19/1/2022 7:23
31/12/2021,Narathiwat,8,42830,809660,400501,409159,5393,5393,0,67,37,19/1/2022 7:23
31/12/2021,Nan,8,2989,475875,237959,237916,132711,131256,1455,,,19/1/2022 7:23
31/12/2021,Bueng Kan,11,2900,421995,211494,210501,49966,49403,563,,,19/1/2022 7:23
31/12/2021,Buri Ram,35,17766,1579805,783531,796274,127140,126290,850,,,19/1/2022 7:23
31/12/2021,Pathum Thani,47,43510,1190060,563851,626209,105228,104299,929,58,36,19/1/2022 7:23
31/12/2021,Prachuap Khiri Khan,44,20745,553171,274049,279122,595142,593435,1707,,,19/1/2022 7:23
31/12/2021,Prachin Buri,28,26902,495325,244642,250683,101944,101780,164,60,37,19/1/2022 7:23
31/12/2021,Pattani,24,48961,729581,360348,369233,7237,7237,0,,,19/1/2022 7:23
31/12/2021,Phra Nakhon Si Ayutthaya,24,34098,820512,394024,426488,506314,497703,8611,47,51,19/1/2022 7:23
31/12/2021,Phayao,8,2788,464505,225943,238562,78112,77046,1066,70,28,19/1/2022 7:23
31/12/2021,Phang-nga,39,7823,268016,133785,134231,174747,140351,34396,,,19/1/2022 7:23
31/12/2021,Phatthalung,56,14005,522541,254425,268116,39244,39244,0,,,19/1/2022 7:23
31/12/2021,Phichit,2,5451,529395,258012,271383,47217,47125,92,,,19/1/2022 7:23
31/12/2021,Phitsanulok,130,9744,847384,414577,432807,202694,202078,616,,,19/1/2022 7:23
31/12/2021,Phuket,110,19757,418785,197874,220911,261943,167948,93995,50,34,19/1/2022 7:23
31/12/2021,Maha Sarakham,35,11578,948310,464976,483334,33099,33059,40,,,19/1/2022 7:23
31/12/2021,Mukdahan,7,2633,351484,175633,175851,96965,96923,42,,,19/1/2022 7:23
31/12/2021,Yala,21,48864,542314,269907,272407,48470,48470,0,58,30,19/1/2022 7:23
31/12/2021,Yasothon,9,6147,533394,265945,267449,38817,38817,0,,,19/1/2022 7:23
31/12/2021,Ranong,4,10071,194573,98136,96437,21868,21760,108,,,19/1/2022 7:23
31/12/2021,Rayong,44,47029,751343,368992,382351,442667,440059,2608,64,28,19/1/2022 7:23
31/12/2021,Ratchaburi,28,45397,868281,421921,446360,187297,186671,626,,,19/1/2022 7:23
31/12/2021,Roi Et,46,14759,1296013,641883,654130,44247,44214,33,,,19/1/2022 7:23
31/12/2021,Lop Buri,25,19126,739473,368733,370740,265330,265144,186,,,19/1/2022 7:23
31/12/2021,Lampang,21,3677,724678,352894,371784,147515,146727,788,75,23,19/1/2022 7:23
31/12/2021,Lamphun,7,4749,401139,192712,208427,95420,94339,1081,,,19/1/2022 7:23
31/12/2021,Si Sa Ket,7,19843,1457556,725426,732130,69970,69958,12,,,19/1/2022 7:23
31/12/2021,Sakon Nakhon,3,8048,1146286,569364,576922,123784,123753,31,,,19/1/2022 7:23
31/12/2021,Songkhla,60,67754,1431536,697256,734280,111186,110907,279,56,34,19/1/2022 7:23
31/12/2021,Satun,32,8981,324835,161640,163195,118953,118571,382,34,35,19/1/2022 7:23
31/12/2021,Samut Prakarn,126,135795,1356449,645884,710565,148306,128665,19641,,,19/1/2022 7:23
31/12/2021,Samut Songkhram,6,12100,190842,91101,99741,186767,186640,127,69,36,19/1/2022 7:23
31/12/2021,Samut Sakhon,23,112452,586789,282683,304106,49065,48960,105,61,31,19/1/2022 7:23
31/12/2021,Saraburi,36,34649,643963,316201,327762,308153,307750,403,53,39,19/1/2022 7:23
31/12/2021,Sa kaeo,9,19923,561992,280673,281319,68672,68321,351,47,28,19/1/2022 7:23
31/12/2021,Sing Buri,1,3590,204526,97144,107382,38697,38585,112,,,19/1/2022 7:23
31/12/2021,Suphan Buri,7,16773,835360,402883,432477,346794,346794,0,,,19/1/2022 7:23
31/12/2021,Surat Thani,36,28702,1072464,527349,545115,132624,124431,8193,43,23,19/1/2022 7:23
31/12/2021,Surin,16,19211,1376230,684354,691876,76048,75971,77,,,19/1/2022 7:23
31/12/2021,Sukhothai,0,6544,585352,283429,301923,77889,76248,1641,,,19/1/2022 7:23
31/12/2021,Nong Khai,6,4541,516843,256268,260575,176894,176022,872,25,25,19/1/2022 7:23
31/12/2021,Nong Bua Lam Phu,6,4735,509001,253757,255244,23866,23805,61,,,19/1/2022 7:23
31/12/2021,Amnat Charoen,21,3138,376350,187122,189228,26300,26300,0,,,19/1/2022 7:23
31/12/2021,Udon Thani,104,26252,1566510,775357,791153,215933,215261,672,,,19/1/2022 7:23
31/12/2021,Uttaradit,1,4636,446148,217413,228735,74305,74146,159,,,19/1/2022 7:23
31/12/2021,Uthai Thani,5,3920,325116,158926,166190,46752,46752,0,,,19/1/2022 7:23
31/12/2021,Ubon Ratchathani,150,23367,1868519,932466,936053,211200,211160,40,45,19,19/1/2022 7:23
31/12/2021,Ang Thong,0,11841,274763,131399,143364,42587,42587,0,,,19/1/2022 7:23
31/12/2021,Chiang Rai,22,6046,1298425,630868,667557,362358,360119,2239,77,32,19/1/2022 7:23
31/12/2021,Chiang Mai,65,33899,1789385,864364,925021,817474,810928,6546,70,39,19/1/2022 7:23
31/12/2021,Phetchaburi,17,24601,482875,232927,249948,596099,595951,148,,,19/1/2022 7:23
31/12/2021,Phetchabun,46,12901,978372,482234,496138,196178,195552,626,,,19/1/2022 7:23
31/12/2021,Loei,8,4626,638732,319949,318783,143151,142378,773,51,27,19/1/2022 7:23
31/12/2021,Phrae,2,2089,434580,209403,225177,91286,90937,349,77,31,19/1/2022 7:23
31/12/2021,Mae Hong Son,22,3431,285916,144811,141105,114751,112339,2412,64,30,19/1/2022 7:23
